,category,timestamp,value_date,logging_payment_timestamp,payment_timestamp,account_number,amount_payment,balance_account,entry_type,payment_type,BIC,reference_code_paymetn,IBAN,counterparty_account_id
0,Tulot,2019-01-01 00:00:00.000000000,2019-01-01,2019-01-01,2019-01-01,1.0,22.09,59.55,0.0,506.0,           ,1.0,1.0,177.0
1,Ruoka_paivittaistavarakauppa,2019-01-01 13:54:23.551401869,2019-01-01,2019-01-02,2019-01-01,1.0,-9.47,50.08,0.0,162.0,           ,1.0,1.0,116.0
2,Ruoka_paivittaistavarakauppa,2019-01-02 03:48:47.102803738,2019-01-02,2019-01-02,2019-01-02,1.0,-16.77,33.31,0.0,162.0,           ,1.0,1.0,137.0
3,Ruoka_paivittaistavarakauppa,2019-01-02 17:43:10.654205607,2019-01-02,2019-01-02,2019-01-02,1.0,-0.89,32.42,0.0,162.0,           ,1.0,1.0,33.0
4,Ruoka_paivittaistavarakauppa,2019-01-03 07:37:34.205607476,2019-01-03,2019-01-03,2019-01-03,1.0,-5.93,26.49,0.0,162.0,           ,1.0,1.0,125.0
5,Liikkuminen,2019-01-03 21:31:57.757009345,2019-01-03,2019-01-03,2019-01-03,1.0,-5.62,20.87,0.0,162.0,           ,1.0,1.0,50.0
6,Ruoka_paivittaistavarakauppa,2019-01-04 01:20:44.859813083,2019-01-04,2019-01-04,2019-01-04,1.0,-0.87,20.0,0.0,162.0,           ,1.0,1.0,137.0
7,Tulot,2019-01-04 11:26:21.308411214,2019-01-04,2019-01-04,2019-01-04,1.0,281.35,301.35,710.0,588.0,           ,0.0,1.0,222.0
8,Kulttuuri_viihde,2019-01-04 15:15:08.411214952,2019-01-04,2019-01-04,2019-01-04,1.0,-3.65,297.7,0.0,162.0,           ,1.0,1.0,38.0
9,Ruoka_paivittaistavarakauppa,2019-01-07 05:09:31.962616821,2019-01-07,2019-01-07,2019-01-07,1.0,-34.13,263.57,0.0,162.0,           ,1.0,1.0,97.0
10,Tulot,2019-01-07 08:58:19.065420559,2019-01-07,2019-01-07,2019-01-07,1.0,5.36,268.93,710.0,588.0,           ,0.0,1.0,222.0
11,Muut,2019-01-07 19:03:55.514018690,2019-01-07,2019-01-07,2019-01-07,1.0,-14.77,254.16,0.0,162.0,           ,1.0,1.0,49.0
12,Muut,2019-01-07 22:52:42.616822428,2019-01-07,2019-01-08,2019-01-07,1.0,-13.58,240.58,0.0,162.0,           ,1.0,1.0,134.0
13,Ruoka_paivittaistavarakauppa,2019-01-08 12:47:06.168224297,2019-01-08,2019-01-08,2019-01-08,1.0,-33.19,207.39,0.0,162.0,           ,1.0,1.0,127.0
14,Tulot,2019-01-10 00:13:27.476635511,2019-01-10,2019-01-10,2019-01-10,1.0,1.05,208.44,710.0,588.0,           ,0.0,1.0,221.0
15,Asuminen,2019-01-10 02:41:29.719626166,2019-01-10,2019-01-10,2019-01-10,1.0,-51.88,156.56,706.0,129.0,NDEAFIHH   ,0.0,0.0,199.0
16,Tulot,2019-01-10 16:35:53.271028035,2019-01-10,2019-01-10,2019-01-10,1.0,2.63,159.19,710.0,588.0,           ,0.0,1.0,223.0
17,Luokittelemattomat,2019-01-11 06:30:16.822429904,2019-01-11,2019-01-11,2019-01-11,1.0,-58.44,100.75,0.0,162.0,           ,1.0,1.0,74.0
18,Matkailu,2019-01-11 10:19:03.925233642,2019-01-11,2019-01-11,2019-01-11,1.0,-15.64,85.11,706.0,129.0,NDEAFIHH   ,0.0,0.0,202.0
19,Ruoka_paivittaistavarakauppa,2019-01-11 14:07:51.028037380,2019-01-11,2019-01-11,2019-01-11,1.0,-8.09,77.02,0.0,162.0,           ,1.0,1.0,45.0
20,Luottojen_maksut,2019-01-11 20:24:40.373831773,2019-01-11,2019-01-11,2019-01-11,1.0,-105.08,-28.06,706.0,129.0,OKOYFIHH   ,0.0,0.0,205.0
21,Ruoka_paivittaistavarakauppa,2019-01-14 04:02:14.579439249,2019-01-14,2019-01-14,2019-01-14,1.0,-6.04,-34.1,0.0,162.0,           ,1.0,1.0,117.0
22,Saastot_sijoitukset,2019-01-14 07:51:01.682242987,2019-01-14,2019-01-14,2019-01-14,1.0,-15.84,-49.94,0.0,162.0,           ,1.0,1.0,33.0
23,Ravintolat_kahvilat,2019-01-14 17:56:38.130841118,2019-01-14,2019-01-15,2019-01-14,1.0,-1.08,-51.02,0.0,162.0,           ,1.0,1.0,65.0
24,Vakuutukset,2019-01-14 21:45:25.233644856,2019-01-14,2019-01-14,2019-01-14,1.0,-69.5,-120.52,706.0,129.0,OKOYFIHH   ,0.0,0.0,201.0
25,Luokittelemattomat,2019-01-15 11:39:48.785046725,2019-01-15,2019-01-15,2019-01-15,1.0,-12.83,-133.35,706.0,129.0,OKOYFIHH   ,0.0,0.0,201.0
26,Ruoka_paivittaistavarakauppa,2019-01-15 19:17:22.990654201,2019-01-15,2019-01-15,2019-01-15,1.0,-3.8,-137.15,0.0,162.0,           ,1.0,1.0,90.0
27,Matkailu,2019-01-16 01:34:12.336448594,2019-01-16,2019-01-16,2019-01-16,1.0,-7.57,-144.72,706.0,129.0,NDEAFIHH   ,0.0,0.0,200.0
28,Ravintolat_kahvilat,2019-01-16 15:28:35.887850463,2019-01-16,2019-01-16,2019-01-16,1.0,-17.69,-162.41,0.0,162.0,           ,1.0,1.0,91.0
29,Ruoka_paivittaistavarakauppa,2019-01-17 13:00:33.644859808,2019-01-17,2019-01-17,2019-01-17,1.0,-4.63,-167.04,0.0,162.0,           ,1.0,1.0,107.0
30,Tulot,2019-01-18 05:22:59.439252332,2019-01-18,2019-01-18,2019-01-18,1.0,84.27,-82.77,710.0,588.0,           ,0.0,1.0,225.0
31,Ravintolat_kahvilat,2019-01-18 09:11:46.542056070,2019-01-18,2019-01-18,2019-01-21,1.0,-22.55,-105.32,0.0,162.0,           ,1.0,1.0,68.0
32,Muut,2019-01-18 23:06:10.093457939,2019-01-18,2019-01-18,2019-01-18,1.0,-17.52,-122.84,0.0,162.0,           ,1.0,1.0,86.0
33,Ruoka_paivittaistavarakauppa,2019-01-21 06:43:44.299065415,2019-01-21,2019-01-21,2019-01-21,1.0,-3.0,-125.84,0.0,162.0,           ,1.0,1.0,85.0
34,Terveys,2019-01-21 14:21:18.504672891,2019-01-21,2019-01-22,2019-01-21,1.0,0.82,-125.02,710.0,588.0,           ,0.0,1.0,221.0
35,Ruoka_paivittaistavarakauppa,2019-01-21 16:49:20.747663546,2019-01-21,2019-01-21,2019-01-21,1.0,-11.08,-136.1,0.0,162.0,           ,1.0,1.0,122.0
36,Liikkuminen,2019-01-21 20:38:07.850467284,2019-01-21,2019-01-21,2019-01-21,1.0,-2.02,-138.12,0.0,162.0,           ,1.0,1.0,33.0
37,Matkailu,2019-01-22 00:26:54.953271022,2019-01-22,2019-01-24,2019-01-22,1.0,-9.84,-147.96,0.0,163.0,           ,1.0,1.0,167.0
38,Ruoka_paivittaistavarakauppa,2019-01-22 02:54:57.196261677,2019-01-22,2019-01-22,2019-01-22,1.0,-7.4,-155.36,0.0,162.0,           ,1.0,1.0,94.0
39,Luokittelemattomat,2019-01-22 10:32:31.401869153,2019-01-22,2019-01-22,2019-01-22,1.0,-122.42,-277.78,0.0,106.0,OKOYFIHH   ,1.0,0.0,29.0
40,Harrastukset,2019-01-24 04:15:42.056074760,2019-01-24,2019-01-24,2019-01-24,1.0,-16.86,-294.64,0.0,106.0,OKOYFIHH   ,0.0,0.0,19.0
41,Ruoka_paivittaistavarakauppa,2019-01-24 08:04:29.158878498,2019-01-24,2019-01-24,2019-01-24,1.0,-2.34,-296.98,0.0,162.0,           ,1.0,1.0,116.0
42,Ravintolat_kahvilat,2019-01-24 21:58:52.710280367,2019-01-24,2019-01-24,2019-01-24,1.0,-2.24,-299.22,0.0,162.0,           ,1.0,1.0,117.0
43,Ravintolat_kahvilat,2019-01-25 18:10:05.607476629,2019-01-25,2019-01-25,2019-01-25,1.0,-0.93,-300.15,0.0,162.0,           ,1.0,1.0,121.0
44,Tulot,2019-01-26 15:42:03.364485974,2019-01-26,2019-01-26,2019-01-26,1.0,227.27,-72.88,0.0,506.0,           ,1.0,1.0,177.0
45,Kulttuuri_viihde,2019-01-28 01:47:39.813084105,2019-01-28,2019-01-28,2019-01-28,1.0,-2.83,-75.71,0.0,162.0,           ,1.0,1.0,128.0
46,Ruoka_paivittaistavarakauppa,2019-01-28 05:36:26.915887843,2019-01-28,2019-01-28,2019-01-28,1.0,-1.62,-77.33,0.0,162.0,           ,1.0,1.0,80.0
47,Ruoka_paivittaistavarakauppa,2019-01-28 11:53:16.261682236,2019-01-28,2019-01-30,2019-01-28,1.0,-1.63,-78.96,0.0,162.0,           ,1.0,1.0,84.0
48,Matkailu,2019-01-28 19:30:50.467289712,2019-01-28,2019-01-28,2019-01-28,1.0,-0.45,-79.41,0.0,162.0,           ,1.0,1.0,114.0
49,Vakuutukset,2019-01-28 23:19:37.570093450,2019-01-28,2019-01-28,2019-01-28,1.0,-429.43,-508.84,706.0,106.0,OKOYFIHH   ,0.0,0.0,193.0
50,Hyvinvointijakauneus,2019-01-30 09:25:14.018691581,2019-01-30,2019-01-30,2019-01-30,1.0,-21.03,-529.87,706.0,106.0,NDEAFIHH   ,0.0,0.0,189.0
51,Tulot,2019-01-30 13:14:01.121495319,2019-01-30,2019-01-30,2019-01-30,1.0,29.71,-500.16,710.0,588.0,           ,0.0,1.0,221.0
52,Liikkuminen,2019-01-31 03:08:24.672897188,2019-01-31,2019-01-31,2019-01-31,1.0,-8.27,-508.43,706.0,129.0,OKOYFIHH   ,0.0,0.0,198.0
53,Lemmikit,2019-01-31 17:02:48.224299057,2019-01-31,2019-01-31,2019-01-31,1.0,-10.51,-518.94,0.0,162.0,           ,1.0,1.0,80.0
54,Tulot,2019-02-04 10:17:08.571428571,2019-02-04,2019-02-04,2019-02-04,1.0,180.73,-338.21,710.0,588.0,           ,0.0,1.0,221.0
55,Muut,2019-02-05 03:25:42.857142857,2019-02-05,2019-02-05,2019-02-05,1.0,-0.26,-338.47,0.0,162.0,           ,1.0,1.0,158.0
56,Ruoka_paivittaistavarakauppa,2019-02-05 06:51:25.714285714,2019-02-05,2019-02-05,2019-02-05,1.0,-5.8,-344.27,0.0,162.0,           ,1.0,1.0,101.0
57,Ruoka_paivittaistavarakauppa,2019-02-05 13:42:51.428571428,2019-02-05,2019-02-05,2019-02-05,1.0,-8.14,-352.41,0.0,162.0,           ,1.0,1.0,35.0
58,Ravintolat_kahvilat,2019-02-05 17:08:34.285714285,2019-02-05,2019-02-06,2019-02-05,1.0,-0.47,-352.88,0.0,162.0,           ,1.0,1.0,105.0
59,Ruoka_paivittaistavarakauppa,2019-02-07 20:34:17.142857142,2019-02-07,2019-02-08,2019-02-07,1.0,-3.84,-356.72,0.0,162.0,           ,1.0,1.0,87.0
60,Luottojen_maksut,2019-02-07 23:59:59.999999999,2019-02-07,2019-02-07,2019-02-07,1.0,-8.17,-364.89,0.0,106.0,OKOYFIHH   ,0.0,0.0,24.0
61,Kulttuuri_viihde,2019-02-08 03:25:42.857142856,2019-02-08,2019-02-08,2019-02-08,1.0,-4.46,-369.35,0.0,162.0,           ,1.0,1.0,79.0
62,Luokittelemattomat,2019-02-12 10:17:08.571428570,2019-02-12,2019-02-12,2019-02-12,1.0,-38.82,-408.17,706.0,106.0,NDEAFIHH   ,1.0,0.0,193.0
63,Ruoka_paivittaistavarakauppa,2019-02-12 13:42:51.428571427,2019-02-12,2019-02-12,2019-02-12,1.0,-3.79,-411.96,0.0,162.0,           ,1.0,1.0,110.0
64,Muut,2019-02-13 06:51:25.714285713,2019-02-13,2019-02-13,2019-02-13,1.0,-77.9,-489.86,0.0,163.0,           ,1.0,1.0,167.0
65,Ruoka_paivittaistavarakauppa,2019-02-14 17:08:34.285714284,2019-02-14,2019-02-14,2019-02-14,1.0,-7.07,-496.93,0.0,162.0,           ,1.0,1.0,39.0
66,Tulot,2019-02-14 23:59:59.999999998,2019-02-14,2019-02-14,2019-02-14,1.0,141.17,-355.76,710.0,588.0,           ,0.0,1.0,223.0
67,Luottojen_maksut,2019-02-15 20:34:17.142857141,2019-02-15,2019-02-15,2019-02-15,1.0,-23.33,-379.09,706.0,129.0,NDEAFIHH   ,0.0,0.0,200.0
68,Luokittelemattomat,2019-02-18 03:25:42.857142855,2019-02-18,2019-02-18,2019-02-18,1.0,-6.41,-385.5,0.0,162.0,           ,1.0,1.0,85.0
69,Ruoka_paivittaistavarakauppa,2019-02-19 06:51:25.714285712,2019-02-19,2019-02-19,2019-02-19,1.0,-4.93,-390.43,0.0,162.0,           ,1.0,1.0,119.0
70,Hyvinvointijakauneus,2019-02-21 10:17:08.571428569,2019-02-21,2019-02-21,2019-02-21,1.0,-18.73,-409.16,0.0,162.0,           ,1.0,1.0,124.0
71,Ruoka_paivittaistavarakauppa,2019-02-21 17:08:34.285714283,2019-02-21,2019-02-21,2019-02-21,1.0,-11.31,-420.47,0.0,162.0,           ,1.0,1.0,94.0
72,Ruoka_paivittaistavarakauppa,2019-02-22 13:42:51.428571426,2019-02-22,2019-02-22,2019-02-22,1.0,-3.03,-423.5,0.0,162.0,           ,1.0,1.0,158.0
73,Ruoka_paivittaistavarakauppa,2019-02-22 20:34:17.142857140,2019-02-22,2019-02-22,2019-02-22,1.0,-2.04,-425.54,0.0,162.0,           ,1.0,1.0,138.0
74,Ruoka_paivittaistavarakauppa,2019-02-25 23:59:59.999999997,2019-02-25,2019-02-25,2019-02-25,1.0,-5.12,-430.66,0.0,162.0,           ,1.0,1.0,54.0
75,Muut,2019-02-26 03:25:42.857142854,2019-02-26,2019-02-26,2019-02-26,1.0,-19.75,-450.41,0.0,163.0,           ,1.0,1.0,167.0
76,Hyvinvointijakauneus,2019-02-27 06:51:25.714285711,2019-02-27,2019-02-27,2019-02-27,1.0,-9.21,-459.62,0.0,162.0,           ,1.0,1.0,80.0
77,Ruoka_paivittaistavarakauppa,2019-02-27 10:17:08.571428568,2019-02-27,2019-02-27,2019-02-27,1.0,-2.41,-462.03,0.0,162.0,           ,1.0,1.0,58.0
78,Tulot,2019-03-01 02:06:18.947368421,2019-03-01,2019-03-01,2019-03-01,1.0,823.63,361.6,701.0,520.0,           ,1.0,1.0,184.0
79,Luokittelemattomat,2019-03-04 04:12:37.894736842,2019-03-04,2019-03-04,2019-03-04,1.0,-2.94,358.66,0.0,162.0,           ,1.0,1.0,118.0
80,Luokittelemattomat,2019-03-04 06:18:56.842105263,2019-03-04,2019-03-04,2019-03-04,1.0,-55.94,302.72,706.0,106.0,OKOYFIHH   ,1.0,0.0,190.0
81,Ruoka_paivittaistavarakauppa,2019-03-04 10:31:34.736842105,2019-03-04,2019-03-04,2019-03-04,1.0,-23.18,279.54,0.0,162.0,           ,1.0,1.0,111.0
82,Muut,2019-03-05 08:25:15.789473684,2019-03-05,2019-03-05,2019-03-05,1.0,-35.61,243.93,0.0,163.0,           ,1.0,1.0,167.0
83,Ruoka_paivittaistavarakauppa,2019-03-07 12:37:53.684210526,2019-03-07,2019-03-07,2019-03-07,1.0,-42.09,201.84,0.0,162.0,           ,1.0,1.0,81.0
84,Ruoka_paivittaistavarakauppa,2019-03-07 14:44:12.631578947,2019-03-07,2019-03-08,2019-03-07,1.0,-7.26,194.58,0.0,162.0,           ,1.0,1.0,106.0
85,Tulot,2019-03-11 18:56:50.526315789,2019-03-11,2019-03-11,2019-03-11,1.0,-139.34,55.24,0.0,162.0,           ,1.0,1.0,79.0
86,Asuminen,2019-03-11 21:03:09.473684210,2019-03-11,2019-03-11,2019-03-11,1.0,-15.9,39.34,0.0,162.0,           ,1.0,1.0,114.0
87,Ruoka_paivittaistavarakauppa,2019-03-12 16:50:31.578947368,2019-03-12,2019-03-12,2019-03-12,1.0,-11.35,27.99,0.0,162.0,           ,1.0,1.0,95.0
88,Lemmikit,2019-03-12 23:09:28.421052631,2019-03-12,2019-03-12,2019-03-12,1.0,-3.64,24.35,0.0,162.0,           ,1.0,1.0,80.0
89,Lemmikit,2019-03-14 01:15:47.368421052,2019-03-14,2019-03-14,2019-03-14,1.0,-8.59,15.76,0.0,106.0,OKOYFIHH   ,1.0,0.0,13.0
90,Tulot,2019-03-15 03:22:06.315789473,2019-03-15,2019-03-15,2019-03-15,1.0,4.51,20.27,710.0,588.0,           ,0.0,1.0,221.0
91,Tulot,2019-03-15 05:28:25.263157894,2019-03-15,2019-03-15,2019-03-15,1.0,48.33,68.6,710.0,588.0,           ,0.0,1.0,221.0
92,Liikkuminen,2019-03-18 07:34:44.210526315,2019-03-18,2019-03-18,2019-03-18,1.0,-90.95,-22.35,0.0,162.0,           ,1.0,1.0,133.0
93,Ravintolat_kahvilat,2019-03-18 09:41:03.157894736,2019-03-18,2019-03-18,2019-03-18,1.0,-26.64,-48.99,0.0,162.0,           ,1.0,1.0,84.0
94,Ruoka_paivittaistavarakauppa,2019-03-19 11:47:22.105263157,2019-03-19,2019-03-19,2019-03-19,1.0,-6.82,-55.81,0.0,162.0,           ,1.0,1.0,110.0
95,Ruoka_paivittaistavarakauppa,2019-03-19 13:53:41.052631578,2019-03-19,2019-03-19,2019-03-19,1.0,-2.14,-57.95,0.0,162.0,           ,1.0,1.0,50.0
96,Hyvinvointijakauneus,2019-03-21 15:59:59.999999999,2019-03-21,2019-03-21,2019-03-21,1.0,-4.02,-61.97,0.0,162.0,           ,1.0,1.0,41.0
97,Muut,2019-03-22 18:06:18.947368420,2019-03-22,2019-03-25,2019-03-22,1.0,-10.33,-72.3,0.0,163.0,           ,1.0,1.0,168.0
98,Vakuutukset,2019-03-22 20:12:37.894736841,2019-03-22,2019-03-22,2019-03-22,1.0,-24.6,-96.9,706.0,106.0,NDEAFIHH   ,0.0,0.0,197.0
99,Muut,2019-03-25 22:18:56.842105262,2019-03-25,2019-03-25,2019-03-25,1.0,-2.73,-99.63,706.0,106.0,NDEAFIHH   ,0.0,0.0,189.0
100,Kulttuuri_viihde,2019-03-26 00:25:15.789473683,2019-03-26,2019-03-26,2019-03-26,1.0,-17.44,-117.07,0.0,162.0,           ,1.0,1.0,80.0
101,Ravintolat_kahvilat,2019-03-27 02:31:34.736842104,2019-03-27,2019-03-27,2019-03-27,1.0,-10.5,-127.57,0.0,162.0,           ,1.0,1.0,85.0
102,Tulot,2019-03-28 04:37:53.684210525,2019-03-28,2019-03-28,2019-03-28,1.0,-22.37,-149.94,0.0,162.0,           ,1.0,1.0,104.0
103,Muut,2019-03-28 06:44:12.631578946,2019-03-28,2019-03-28,2019-03-28,1.0,-0.8,-150.74,0.0,162.0,           ,1.0,1.0,46.0
104,Ruoka_paivittaistavarakauppa,2019-03-29 08:50:31.578947367,2019-03-29,2019-03-29,2019-03-29,1.0,-1.48,-152.22,0.0,162.0,           ,1.0,1.0,100.0
105,Muut,2019-03-31 10:56:50.526315788,2019-03-31,2019-03-31,2019-03-31,1.0,-7.98,-160.2,0.0,163.0,           ,1.0,1.0,167.0
106,Tulot,2019-04-01 13:58:50.097087378,2019-04-01,2019-04-01,2019-04-01,1.0,252.24,92.04,701.0,520.0,           ,1.0,1.0,183.0
107,Liikkuminen,2019-04-02 03:57:40.194174756,2019-04-02,2019-04-02,2019-04-02,1.0,-9.49,82.55,0.0,162.0,           ,1.0,1.0,103.0
108,Ruoka_paivittaistavarakauppa,2019-04-02 17:56:30.291262134,2019-04-02,2019-04-02,2019-04-02,1.0,-3.17,79.38,0.0,162.0,           ,1.0,1.0,95.0
109,Liikkuminen,2019-04-03 07:55:20.388349512,2019-04-03,2019-04-03,2019-04-03,1.0,-39.31,40.07,0.0,162.0,           ,1.0,1.0,112.0
110,Luokittelemattomat,2019-04-03 21:54:10.485436890,2019-04-03,2019-04-03,2019-04-03,1.0,-17.59,22.48,706.0,106.0,OKOYFIHH   ,0.0,0.0,197.0
111,Liikkuminen,2019-04-04 11:53:00.582524268,2019-04-04,2019-04-04,2019-04-04,1.0,-5.87,16.61,0.0,162.0,           ,1.0,1.0,51.0
112,Ruoka_paivittaistavarakauppa,2019-04-05 01:51:50.679611646,2019-04-05,2019-04-05,2019-04-05,1.0,-5.04,11.57,0.0,162.0,           ,1.0,1.0,93.0
113,Ruoka_paivittaistavarakauppa,2019-04-05 05:49:30.873786402,2019-04-05,2019-04-05,2019-04-05,1.0,-3.36,8.21,0.0,162.0,           ,1.0,1.0,130.0
114,Ruoka_paivittaistavarakauppa,2019-04-05 09:47:11.067961158,2019-04-05,2019-04-05,2019-04-05,1.0,-12.62,-4.41,706.0,106.0,NDEAFIHH   ,0.0,0.0,190.0
115,Ruoka_paivittaistavarakauppa,2019-04-05 15:50:40.776699024,2019-04-05,2019-04-05,2019-04-05,1.0,-12.4,-16.81,0.0,162.0,           ,1.0,1.0,109.0
116,Hyvinvointi,2019-04-05 19:48:20.970873780,2019-04-05,2019-04-05,2019-04-05,1.0,-7.7,-24.51,706.0,106.0,NDEAFIHH   ,0.0,0.0,190.0
117,Lemmikit,2019-04-08 13:44:51.262135914,2019-04-08,2019-04-08,2019-04-08,1.0,-29.06,-53.57,0.0,162.0,           ,1.0,1.0,95.0
118,Ravintolat_kahvilat,2019-04-08 21:40:11.650485426,2019-04-08,2019-04-08,2019-04-08,1.0,-2.57,-56.14,0.0,162.0,           ,1.0,1.0,81.0
119,Ruoka_paivittaistavarakauppa,2019-04-08 23:46:01.165048536,2019-04-08,2019-04-09,2019-04-08,1.0,-0.57,-56.71,0.0,162.0,           ,1.0,1.0,94.0
120,Ruoka_paivittaistavarakauppa,2019-04-09 03:43:41.359223292,2019-04-09,2019-04-09,2019-04-09,1.0,-1.19,-57.9,0.0,162.0,           ,1.0,1.0,84.0
121,Ruoka_paivittaistavarakauppa,2019-04-09 17:42:31.456310670,2019-04-09,2019-04-09,2019-04-09,1.0,-4.16,-62.06,0.0,162.0,           ,1.0,1.0,60.0
122,Ruoka_paivittaistavarakauppa,2019-04-10 07:41:21.553398048,2019-04-10,2019-04-10,2019-04-10,1.0,-2.23,-64.29,0.0,162.0,           ,1.0,1.0,50.0
123,Luokittelemattomat,2019-04-11 11:39:01.747572804,2019-04-11,2019-04-11,2019-04-11,1.0,-5.92,-70.21,0.0,162.0,           ,1.0,1.0,79.0
124,Ruoka_paivittaistavarakauppa,2019-04-12 01:37:51.844660182,2019-04-12,2019-04-12,2019-04-12,1.0,-14.16,-84.37,0.0,162.0,           ,1.0,1.0,46.0
125,Liikkuminen,2019-04-12 05:35:32.038834938,2019-04-12,2019-04-12,2019-04-12,1.0,-4.74,-89.11,0.0,162.0,           ,1.0,1.0,111.0
126,Ruoka_paivittaistavarakauppa,2019-04-12 15:36:41.941747560,2019-04-12,2019-04-12,2019-04-12,1.0,-1.26,-90.37,0.0,162.0,           ,1.0,1.0,121.0
127,Liikkuminen,2019-04-15 09:33:12.233009694,2019-04-15,2019-04-15,2019-04-15,1.0,-3.15,-93.52,0.0,162.0,           ,1.0,1.0,94.0
128,Ruoka_paivittaistavarakauppa,2019-04-15 13:30:52.427184450,2019-04-15,2019-04-15,2019-04-15,1.0,-4.31,-97.83,0.0,162.0,           ,1.0,1.0,158.0
129,Liikkuminen,2019-04-15 19:34:22.135922316,2019-04-15,2019-04-15,2019-04-15,1.0,-4.44,-102.27,0.0,162.0,           ,1.0,1.0,100.0
130,Hyvinvointi,2019-04-15 23:32:02.330097072,2019-04-15,2019-04-15,2019-04-15,1.0,-9.95,-112.22,0.0,162.0,           ,1.0,1.0,94.0
131,Ruoka_paivittaistavarakauppa,2019-04-16 03:29:42.524271828,2019-04-16,2019-04-16,2019-04-16,1.0,-8.73,-120.95,0.0,162.0,           ,1.0,1.0,129.0
132,Ruoka_paivittaistavarakauppa,2019-04-16 07:27:22.718446584,2019-04-16,2019-04-16,2019-04-16,1.0,-2.81,-123.76,0.0,162.0,           ,1.0,1.0,98.0
133,Ruoka_paivittaistavarakauppa,2019-04-16 17:28:32.621359206,2019-04-16,2019-04-16,2019-04-16,1.0,-5.79,-129.55,0.0,162.0,           ,1.0,1.0,92.0
134,Matkailu,2019-04-18 11:25:02.912621340,2019-04-18,2019-04-18,2019-04-18,1.0,-2.62,-132.17,0.0,103.0,           ,0.0,1.0,4.0
135,Ruoka_paivittaistavarakauppa,2019-04-18 21:26:12.815533962,2019-04-18,2019-04-18,2019-04-18,1.0,-5.87,-138.04,0.0,162.0,           ,1.0,1.0,87.0
136,Ruoka_paivittaistavarakauppa,2019-04-19 01:23:53.009708718,2019-04-19,2019-04-19,2019-04-19,1.0,-11.98,-150.02,0.0,162.0,           ,1.0,1.0,129.0
137,Ruoka_paivittaistavarakauppa,2019-04-19 05:21:33.203883474,2019-04-19,2019-04-19,2019-04-19,1.0,-2.86,-152.88,0.0,162.0,           ,1.0,1.0,74.0
138,Ruoka_paivittaistavarakauppa,2019-04-19 15:22:43.106796096,2019-04-19,2019-04-19,2019-04-19,1.0,-1.97,-154.85,0.0,162.0,           ,1.0,1.0,65.0
139,Asuminen,2019-04-22 09:19:13.398058230,2019-04-22,2019-04-22,2019-04-22,1.0,-5.24,-160.09,706.0,106.0,DABAFIHH   ,0.0,0.0,195.0
140,Tulot,2019-04-22 13:16:53.592232986,2019-04-22,2019-04-22,2019-04-22,1.0,77.47,-82.62,710.0,588.0,           ,0.0,1.0,223.0
141,Ruoka_paivittaistavarakauppa,2019-04-22 19:20:23.300970852,2019-04-22,2019-04-22,2019-04-22,1.0,-6.18,-88.8,0.0,162.0,           ,1.0,1.0,129.0
142,Ruoka_paivittaistavarakauppa,2019-04-23 03:15:43.689320364,2019-04-23,2019-04-23,2019-04-23,1.0,-6.39,-95.19,0.0,162.0,           ,1.0,1.0,115.0
143,Ruoka_paivittaistavarakauppa,2019-04-23 17:14:33.786407742,2019-04-23,2019-04-23,2019-04-23,1.0,-6.04,-101.23,0.0,162.0,           ,1.0,1.0,127.0
144,Matkailu,2019-04-23 23:18:03.495145608,2019-04-23,2019-04-23,2019-04-23,1.0,-10.5,-111.73,0.0,162.0,           ,1.0,1.0,137.0
145,Ruoka_paivittaistavarakauppa,2019-04-24 07:13:23.883495120,2019-04-24,2019-04-24,2019-04-24,1.0,-4.63,-116.36,0.0,162.0,           ,1.0,1.0,95.0
146,Kulttuuri_viihde,2019-04-24 11:11:04.077669876,2019-04-24,2019-04-24,2019-04-24,1.0,-6.09,-122.45,0.0,106.0,OKOYFIHH   ,0.0,0.0,8.0
147,Ruoka_paivittaistavarakauppa,2019-04-25 15:08:44.271844632,2019-04-25,2019-04-25,2019-04-25,1.0,-4.64,-127.09,0.0,162.0,           ,1.0,1.0,111.0
148,Tulot,2019-04-25 21:12:13.980582498,2019-04-25,2019-04-25,2019-04-25,1.0,547.69,420.6,701.0,506.0,           ,1.0,1.0,180.0
149,Ruoka_paivittaistavarakauppa,2019-04-26 01:09:54.174757254,2019-04-26,2019-04-26,2019-04-26,1.0,-16.43,404.17,0.0,162.0,           ,1.0,1.0,113.0
150,Ravintolat_kahvilat,2019-04-26 05:07:34.368932010,2019-04-26,2019-04-26,2019-04-26,1.0,-42.41,361.76,0.0,162.0,           ,1.0,1.0,113.0
151,Ruoka_paivittaistavarakauppa,2019-04-26 19:06:24.466019388,2019-04-26,2019-04-26,2019-04-26,1.0,-30.85,330.91,0.0,162.0,           ,1.0,1.0,139.0
152,Liikkuminen,2019-04-26 23:04:04.660194144,2019-04-26,2019-04-26,2019-04-26,1.0,-4.17,326.74,0.0,162.0,           ,1.0,1.0,153.0
153,Harrastukset,2019-04-29 09:05:14.563106766,2019-04-29,2019-04-29,2019-04-29,1.0,-5.18,321.56,0.0,162.0,           ,1.0,1.0,166.0
154,Liikkuminen,2019-04-29 13:02:54.757281522,2019-04-29,2019-04-29,2019-04-29,1.0,-14.16,307.4,0.0,162.0,           ,1.0,1.0,101.0
155,Liikkuminen,2019-04-29 17:00:34.951456278,2019-04-29,2019-04-29,2019-04-29,1.0,-56.06,251.34,0.0,162.0,           ,1.0,1.0,111.0
156,Muut,2019-04-30 03:01:44.854368900,2019-04-26,2019-04-30,2019-04-30,1.0,-26.47,224.87,0.0,163.0,           ,1.0,1.0,170.0
157,Luokittelemattomat,2019-05-01 18:50:07.594936708,2019-05-01,2019-05-01,2019-05-01,1.0,-26.51,198.36,706.0,106.0,OKOYFIHH   ,1.0,0.0,191.0
158,Luokittelemattomat,2019-05-02 13:40:15.189873416,2019-05-02,2019-05-03,2019-05-02,1.0,-6.04,192.32,706.0,106.0,NDEAFIHH   ,0.0,0.0,195.0
159,Muut,2019-05-03 03:20:30.379746832,2019-05-03,2019-05-03,2019-05-03,1.0,-231.99,-39.67,0.0,105.0,OKOYFIHH   ,1.0,0.0,5.0
160,Ravintolat_kahvilat,2019-05-03 08:30:22.784810124,2019-05-03,2019-05-03,2019-05-03,1.0,-4.21,-43.88,0.0,162.0,           ,1.0,1.0,65.0
161,Ruoka_paivittaistavarakauppa,2019-05-03 22:10:37.974683540,2019-05-03,2019-05-03,2019-05-03,1.0,-7.31,-51.19,0.0,162.0,           ,1.0,1.0,50.0
162,Lemmikit,2019-05-06 11:50:53.164556956,2019-05-06,2019-05-06,2019-05-06,1.0,-14.23,-65.42,0.0,162.0,           ,1.0,1.0,142.0
163,Ruoka_paivittaistavarakauppa,2019-05-06 17:00:45.569620248,2019-05-06,2019-05-06,2019-05-06,1.0,-3.89,-69.31,0.0,162.0,           ,1.0,1.0,148.0
164,Hyvinvointijakauneus,2019-05-07 01:31:08.354430372,2019-05-07,2019-05-07,2019-05-07,1.0,-9.33,-78.64,706.0,106.0,OKOYFIHH   ,0.0,0.0,189.0
165,Kulttuuri_viihde,2019-05-07 06:41:00.759493664,2019-05-07,2019-05-07,2019-05-07,1.0,-2.22,-80.86,0.0,162.0,           ,1.0,1.0,65.0
166,Ruoka_paivittaistavarakauppa,2019-05-09 10:01:31.139240496,2019-05-09,2019-05-09,2019-05-09,1.0,-0.79,-81.65,0.0,162.0,           ,1.0,1.0,46.0
167,Ruoka_paivittaistavarakauppa,2019-05-09 15:11:23.544303788,2019-05-09,2019-05-09,2019-05-09,1.0,-10.56,-92.21,0.0,162.0,           ,1.0,1.0,149.0
168,Asuminen,2019-05-09 20:21:15.949367080,2019-05-09,2019-05-09,2019-05-09,1.0,-43.16,-135.37,706.0,106.0,OKOYFIHH   ,0.0,0.0,196.0
169,Liikkuminen,2019-05-10 04:51:38.734177204,2019-05-10,2019-05-10,2019-05-10,1.0,-7.08,-142.45,0.0,162.0,           ,1.0,1.0,137.0
170,Ruoka_paivittaistavarakauppa,2019-05-10 23:41:46.329113912,2019-05-10,2019-05-10,2019-05-10,1.0,-4.94,-147.39,0.0,162.0,           ,1.0,1.0,74.0
171,Lemmikit,2019-05-13 13:22:01.518987328,2019-05-13,2019-05-13,2019-05-13,1.0,-5.56,-152.95,0.0,162.0,           ,1.0,1.0,65.0
172,Ruoka_paivittaistavarakauppa,2019-05-13 18:31:53.924050620,2019-05-13,2019-05-13,2019-05-13,1.0,-1.75,-154.7,0.0,162.0,           ,1.0,1.0,94.0
173,Tulot,2019-05-14 08:12:09.113924036,2019-05-14,2019-05-16,2019-05-14,1.0,1.8,-152.9,710.0,588.0,           ,0.0,1.0,222.0
174,Asuminen,2019-05-15 03:02:16.708860744,2019-05-15,2019-05-15,2019-05-15,1.0,-36.78,-189.68,706.0,106.0,OKOYFIHH   ,0.0,0.0,193.0
175,Ruoka_paivittaistavarakauppa,2019-05-15 16:42:31.898734160,2019-05-15,2019-05-15,2019-05-15,1.0,-12.58,-202.26,0.0,162.0,           ,1.0,1.0,80.0
176,Ruoka_paivittaistavarakauppa,2019-05-15 21:52:24.303797452,2019-05-15,2019-05-15,2019-05-15,1.0,-3.32,-205.58,0.0,162.0,           ,1.0,1.0,55.0
177,Tulot,2019-05-16 11:32:39.493670868,2019-05-16,2019-05-16,2019-05-16,1.0,-4.99,-210.57,0.0,162.0,           ,1.0,1.0,117.0
178,Ruoka_paivittaistavarakauppa,2019-05-17 06:22:47.088607576,2019-05-17,2019-05-17,2019-05-17,1.0,-11.65,-222.22,0.0,162.0,           ,1.0,1.0,141.0
179,Kulttuuri_viihde,2019-05-20 01:12:54.683544284,2019-05-20,2019-05-20,2019-05-20,1.0,-2.41,-224.63,0.0,162.0,           ,1.0,1.0,151.0
180,Lemmikit,2019-05-20 09:43:17.468354408,2019-05-20,2019-05-20,2019-05-20,1.0,-2.34,-226.97,0.0,162.0,           ,1.0,1.0,118.0
181,Kulttuuri_viihde,2019-05-20 14:53:09.873417700,2019-05-20,2019-05-20,2019-05-20,1.0,-6.24,-233.21,0.0,162.0,           ,1.0,1.0,141.0
182,Luokittelemattomat,2019-05-21 20:03:02.278480992,2019-05-21,2019-05-21,2019-05-21,1.0,-2.5,-235.71,0.0,162.0,           ,1.0,1.0,79.0
183,Luottojen_maksut,2019-05-22 23:23:32.658227824,2019-05-22,2019-05-22,2019-05-22,1.0,-53.13,-288.84,706.0,106.0,OKOYFIHH   ,0.0,0.0,189.0
184,Kulttuuri_viihde,2019-05-23 04:33:25.063291116,2019-05-23,2019-05-23,2019-05-23,1.0,-14.23,-303.07,0.0,106.0,OKOYFIHH   ,0.0,0.0,16.0
185,Vakuutukset,2019-05-23 18:13:40.253164532,2019-05-23,2019-05-23,2019-05-23,1.0,-46.23,-349.3,706.0,106.0,OKOYFIHH   ,0.0,0.0,194.0
186,Luokittelemattomat,2019-05-24 13:03:47.848101240,2019-05-24,2019-05-24,2019-05-24,1.0,-77.66,-426.96,706.0,106.0,OKOYFIHH   ,1.0,0.0,189.0
187,Tulot,2019-05-25 07:53:55.443037948,2019-05-25,2019-05-25,2019-05-25,1.0,73.44,-353.52,0.0,588.0,           ,0.0,1.0,179.0
188,Luokittelemattomat,2019-05-27 02:44:03.037974656,2019-05-27,2019-05-27,2019-05-27,1.0,-6.82,-360.34,0.0,162.0,           ,1.0,1.0,117.0
189,Lemmikit,2019-05-27 11:14:25.822784780,2019-05-27,2019-05-27,2019-05-27,1.0,-2.1,-362.44,0.0,162.0,           ,1.0,1.0,100.0
190,Ruoka_paivittaistavarakauppa,2019-05-27 16:24:18.227848072,2019-05-27,2019-05-27,2019-05-27,1.0,-4.66,-367.1,0.0,162.0,           ,1.0,1.0,157.0
191,Ruoka_paivittaistavarakauppa,2019-05-27 21:34:10.632911364,2019-05-27,2019-05-29,2019-05-27,1.0,-15.75,-382.85,0.0,162.0,           ,1.0,1.0,116.0
192,Ravintolat_kahvilat,2019-05-29 06:04:33.417721488,2019-05-29,2019-05-29,2019-05-29,1.0,-16.58,-399.43,0.0,162.0,           ,1.0,1.0,134.0
193,Vakuutukset,2019-05-30 00:54:41.012658196,2019-05-30,2019-05-30,2019-05-30,1.0,-68.42,-467.85,706.0,106.0,OKOYFIHH   ,0.0,0.0,192.0
194,Ruoka_paivittaistavarakauppa,2019-05-30 19:44:48.607594904,2019-05-30,2019-05-30,2019-05-30,1.0,-1.0,-468.85,0.0,162.0,           ,1.0,1.0,44.0
195,Asuminen,2019-05-31 14:34:56.202531612,2019-05-31,2019-05-31,2019-05-30,1.0,-3.12,-471.97,0.0,162.0,           ,1.0,1.0,93.0
196,Muut,2019-06-01 04:14:07.058823529,2019-06-01,2019-06-01,2019-06-01,1.0,-19.2,-491.17,0.0,163.0,           ,1.0,1.0,168.0
197,Tulot,2019-06-03 08:28:14.117647058,2019-06-03,2019-06-03,2019-06-03,1.0,239.04,-252.13,710.0,588.0,           ,0.0,1.0,224.0
198,Luottojen_maksut,2019-06-04 12:42:21.176470587,2019-06-04,2019-06-04,2019-06-04,1.0,-5.11,-257.24,0.0,162.0,           ,1.0,1.0,116.0
199,Asuminen,2019-06-05 16:56:28.235294116,2019-06-05,2019-06-06,2019-06-05,1.0,-40.23,-297.47,706.0,106.0,DABAFIHH   ,0.0,0.0,189.0
200,Lapset,2019-06-06 21:10:35.294117645,2019-06-06,2019-06-06,2019-06-06,1.0,-2.14,-299.61,0.0,162.0,           ,1.0,1.0,116.0
201,Ruoka_paivittaistavarakauppa,2019-06-07 01:24:42.352941174,2019-06-07,2019-06-07,2019-06-07,1.0,-3.35,-302.96,0.0,162.0,           ,1.0,1.0,34.0
202,Ruoka_paivittaistavarakauppa,2019-06-10 05:38:49.411764703,2019-06-10,2019-06-10,2019-06-10,1.0,-30.45,-333.41,0.0,162.0,           ,1.0,1.0,87.0
203,Lapset,2019-06-10 09:52:56.470588232,2019-06-10,2019-06-10,2019-06-10,1.0,-3.13,-336.54,0.0,162.0,           ,1.0,1.0,95.0
204,Ravintolat_kahvilat,2019-06-10 14:07:03.529411761,2019-06-10,2019-06-10,2019-06-10,1.0,-7.11,-343.65,706.0,106.0,DABAFIHH   ,0.0,0.0,191.0
205,Hyvinvointi,2019-06-11 18:21:10.588235290,2019-06-11,2019-06-11,2019-06-11,1.0,-14.21,-357.86,0.0,162.0,           ,1.0,1.0,35.0
206,Hyvinvointijakauneus,2019-06-14 02:49:24.705882348,2019-06-14,2019-06-14,2019-06-14,1.0,-16.21,-374.07,706.0,106.0,DABAFIHH   ,0.0,0.0,191.0
207,Lemmikit,2019-06-14 22:35:17.647058819,2019-06-14,2019-06-14,2019-06-14,1.0,-1.65,-375.72,0.0,162.0,           ,1.0,1.0,65.0
208,Liikkuminen,2019-06-17 07:03:31.764705877,2019-06-17,2019-06-17,2019-06-17,1.0,-6.66,-382.38,0.0,162.0,           ,1.0,1.0,121.0
209,Ruoka_paivittaistavarakauppa,2019-06-17 11:17:38.823529406,2019-06-17,2019-06-17,2019-06-17,1.0,-0.65,-383.03,0.0,162.0,           ,1.0,1.0,91.0
210,Hyvinvointi,2019-06-18 15:31:45.882352935,2019-06-18,2019-06-18,2019-06-18,1.0,-3.57,-386.6,0.0,162.0,           ,1.0,1.0,148.0
211,Liikkuminen,2019-06-19 19:45:52.941176464,2019-06-19,2019-06-19,2019-06-19,1.0,-2.11,-388.71,0.0,162.0,           ,1.0,1.0,37.0
212,Ruoka_paivittaistavarakauppa,2019-06-20 23:59:59.999999993,2019-06-20,2019-06-21,2019-06-20,1.0,-7.8,-396.51,0.0,162.0,           ,1.0,1.0,122.0
213,Ruoka_paivittaistavarakauppa,2019-06-21 04:14:07.058823522,2019-06-21,2019-06-21,2019-06-21,1.0,-23.94,-420.45,0.0,162.0,           ,1.0,1.0,106.0
214,Ruoka_paivittaistavarakauppa,2019-06-24 12:42:21.176470580,2019-06-24,2019-06-24,2019-06-24,1.0,-4.2,-424.65,0.0,162.0,           ,1.0,1.0,65.0
215,Ruoka_paivittaistavarakauppa,2019-06-24 16:56:28.235294109,2019-06-24,2019-06-24,2019-06-24,1.0,-3.52,-428.17,0.0,162.0,           ,1.0,1.0,72.0
216,Tulot,2019-06-25 08:28:14.117647051,2019-06-25,2019-06-25,2019-06-25,1.0,31.09,-397.08,710.0,588.0,           ,0.0,1.0,221.0
217,Terveys,2019-06-25 21:10:35.294117638,2019-06-25,2019-06-25,2019-06-25,1.0,-1.48,-398.56,0.0,162.0,           ,1.0,1.0,158.0
218,Ruoka_paivittaistavarakauppa,2019-06-27 01:24:42.352941167,2019-06-27,2019-06-27,2019-06-27,1.0,-5.27,-403.83,0.0,162.0,           ,1.0,1.0,137.0
219,Ruoka_paivittaistavarakauppa,2019-06-27 05:38:49.411764696,2019-06-27,2019-06-27,2019-06-27,1.0,-8.93,-412.76,0.0,162.0,           ,1.0,1.0,65.0
220,Ruoka_paivittaistavarakauppa,2019-06-28 09:52:56.470588225,2019-06-28,2019-06-28,2019-06-28,1.0,-2.84,-415.6,0.0,162.0,           ,1.0,1.0,124.0
221,Tulot,2019-07-01 04:12:37.894736842,2019-07-01,2019-07-01,2019-07-01,1.0,269.22,-146.38,0.0,505.0,           ,1.0,1.0,174.0
222,Muut,2019-07-02 02:06:18.947368421,2019-07-02,2019-07-02,2019-07-02,1.0,-8.33,-154.71,0.0,105.0,OKOYFIHH   ,1.0,0.0,5.0
223,Tulot,2019-07-04 06:18:56.842105263,2019-07-04,2019-07-04,2019-07-04,1.0,344.65,189.94,701.0,521.0,           ,1.0,1.0,187.0
224,Ravintolat_kahvilat,2019-07-05 08:25:15.789473684,2019-07-05,2019-07-05,2019-07-05,1.0,-4.78,185.16,706.0,106.0,NDEAFIHH   ,0.0,0.0,189.0
225,Vakuutukset,2019-07-05 10:31:34.736842105,2019-07-05,2019-07-05,2019-07-05,1.0,-99.06,86.1,706.0,129.0,SBANFIHH   ,0.0,0.0,199.0
226,Ruoka_paivittaistavarakauppa,2019-07-08 14:44:12.631578947,2019-07-08,2019-07-09,2019-07-08,1.0,-11.05,75.05,0.0,162.0,           ,1.0,1.0,155.0
227,Ruoka_paivittaistavarakauppa,2019-07-09 16:50:31.578947368,2019-07-09,2019-07-09,2019-07-09,1.0,-32.1,42.95,0.0,162.0,           ,1.0,1.0,87.0
228,Luokittelemattomat,2019-07-10 12:37:53.684210526,2019-07-10,2019-07-10,2019-07-10,1.0,-10.49,32.46,706.0,106.0,OKOYFIHH   ,1.0,0.0,194.0
229,Ruoka_paivittaistavarakauppa,2019-07-11 18:56:50.526315789,2019-07-11,2019-07-11,2019-07-11,1.0,-3.07,29.39,0.0,162.0,           ,1.0,1.0,101.0
230,Ruoka_paivittaistavarakauppa,2019-07-11 21:03:09.473684210,2019-07-11,2019-07-11,2019-07-11,1.0,-20.97,8.42,0.0,162.0,           ,1.0,1.0,106.0
231,Ravintolat_kahvilat,2019-07-12 23:09:28.421052631,2019-07-12,2019-07-12,2019-07-12,1.0,-7.23,1.19,0.0,162.0,           ,1.0,1.0,113.0
232,Luokittelemattomat,2019-07-15 01:15:47.368421052,2019-07-15,2019-07-15,2019-07-15,1.0,-19.87,-18.68,0.0,162.0,           ,1.0,1.0,65.0
233,Hyvinvointi,2019-07-15 03:22:06.315789473,2019-07-15,2019-07-15,2019-07-15,1.0,-67.68,-86.36,0.0,106.0,OKOYFIHH   ,0.0,0.0,27.0
234,Vakuutukset,2019-07-16 05:28:25.263157894,2019-07-16,2019-07-16,2019-07-16,1.0,-86.12,-172.48,706.0,106.0,SBANFIHH   ,0.0,0.0,190.0
235,Matkailu,2019-07-17 07:34:44.210526315,2019-07-17,2019-07-17,2019-07-17,1.0,-17.84,-190.32,0.0,162.0,           ,1.0,1.0,64.0
236,Muut,2019-07-19 09:41:03.157894736,2019-07-19,2019-07-19,2019-07-19,1.0,-8.17,-198.49,0.0,163.0,           ,1.0,1.0,169.0
237,Ravintolat_kahvilat,2019-07-19 11:47:22.105263157,2019-07-19,2019-07-19,2019-07-19,1.0,-1.03,-199.52,0.0,162.0,           ,1.0,1.0,92.0
238,Ruoka_paivittaistavarakauppa,2019-07-22 13:53:41.052631578,2019-07-22,2019-07-22,2019-07-22,1.0,-2.9,-202.42,0.0,162.0,           ,1.0,1.0,145.0
239,Ravintolat_kahvilat,2019-07-22 15:59:59.999999999,2019-07-22,2019-07-22,2019-07-22,1.0,-8.47,-210.89,0.0,162.0,           ,1.0,1.0,94.0
240,Luokittelemattomat,2019-07-22 18:06:18.947368420,2019-07-22,2019-07-22,2019-07-22,1.0,-40.63,-251.52,706.0,106.0,NDEAFIHH   ,1.0,0.0,194.0
241,Muut,2019-07-24 20:12:37.894736841,2019-07-24,2019-07-24,2019-07-24,1.0,-8.61,-260.13,0.0,163.0,           ,1.0,1.0,167.0
242,Ruoka_paivittaistavarakauppa,2019-07-24 22:18:56.842105262,2019-07-24,2019-07-24,2019-07-24,1.0,-19.34,-279.47,0.0,162.0,           ,1.0,1.0,148.0
243,Liikkuminen,2019-07-25 00:25:15.789473683,2019-07-25,2019-07-25,2019-07-25,1.0,-13.72,-293.19,0.0,162.0,           ,1.0,1.0,77.0
244,Luokittelemattomat,2019-07-26 02:31:34.736842104,2019-07-26,2019-07-26,2019-07-26,1.0,-4.11,-297.3,706.0,106.0,NDEAFIHH   ,1.0,0.0,190.0
245,Ruoka_paivittaistavarakauppa,2019-07-29 06:44:12.631578946,2019-07-29,2019-07-29,2019-07-29,1.0,-4.79,-302.09,0.0,162.0,           ,1.0,1.0,59.0
246,Ruoka_paivittaistavarakauppa,2019-07-30 04:37:53.684210525,2019-07-30,2019-07-30,2019-07-30,1.0,-9.38,-311.47,0.0,162.0,           ,1.0,1.0,116.0
247,Ruoka_paivittaistavarakauppa,2019-07-30 08:50:31.578947367,2019-07-30,2019-07-30,2019-07-30,1.0,-9.21,-320.68,0.0,162.0,           ,1.0,1.0,111.0
248,Ruoka_paivittaistavarakauppa,2019-07-31 10:56:50.526315788,2019-07-31,2019-07-31,2019-07-31,1.0,-26.37,-347.05,0.0,162.0,           ,1.0,1.0,106.0
249,Ruoka_paivittaistavarakauppa,2019-08-02 02:06:18.947368421,2019-08-02,2019-08-02,2019-08-02,1.0,-4.29,-351.34,0.0,162.0,           ,1.0,1.0,127.0
250,Tulot,2019-08-02 04:12:37.894736842,2019-08-02,2019-08-02,2019-08-02,1.0,44.0,-307.34,710.0,588.0,           ,0.0,1.0,223.0
251,Ravintolat_kahvilat,2019-08-02 06:18:56.842105263,2019-08-02,2019-08-02,2019-08-02,1.0,-11.79,-319.13,0.0,163.0,           ,1.0,1.0,167.0
252,Ravintolat_kahvilat,2019-08-05 08:25:15.789473684,2019-08-05,2019-08-05,2019-08-05,1.0,-3.95,-323.08,0.0,162.0,           ,1.0,1.0,137.0
253,Ruoka_paivittaistavarakauppa,2019-08-07 10:31:34.736842105,2019-08-07,2019-08-07,2019-08-07,1.0,-9.77,-332.85,0.0,162.0,           ,1.0,1.0,96.0
254,Tulot,2019-08-07 12:37:53.684210526,2019-08-07,2019-08-07,2019-08-07,1.0,757.72,424.87,701.0,520.0,           ,1.0,1.0,184.0
255,Saastot_sijoitukset,2019-08-07 14:44:12.631578947,2019-08-07,2019-08-07,2019-08-07,1.0,-28.17,396.7,0.0,162.0,           ,1.0,1.0,128.0
256,Harrastukset,2019-08-08 18:56:50.526315789,2019-08-08,2019-08-08,2019-08-06,1.0,-2.62,394.08,0.0,162.0,           ,1.0,1.0,34.0
257,Liikkuminen,2019-08-09 16:50:31.578947368,2019-08-09,2019-08-09,2019-08-09,1.0,-76.35,317.73,0.0,162.0,           ,1.0,1.0,68.0
258,Liikkuminen,2019-08-12 21:03:09.473684210,2019-08-12,2019-08-12,2019-08-12,1.0,-10.37,307.36,0.0,162.0,           ,1.0,1.0,86.0
259,Ruoka_paivittaistavarakauppa,2019-08-12 23:09:28.421052631,2019-08-12,2019-08-12,2019-08-12,1.0,-12.36,295.0,706.0,129.0,NDEAFIHH   ,0.0,0.0,198.0
260,Ruoka_paivittaistavarakauppa,2019-08-14 01:15:47.368421052,2019-08-14,2019-08-15,2019-08-14,1.0,-13.33,281.67,0.0,162.0,           ,1.0,1.0,55.0
261,Ruoka_paivittaistavarakauppa,2019-08-15 03:22:06.315789473,2019-08-15,2019-08-15,2019-08-15,1.0,-31.72,249.95,0.0,162.0,           ,1.0,1.0,125.0
262,Tulot,2019-08-16 05:28:25.263157894,2019-08-16,2019-08-16,2019-08-16,1.0,138.87,388.82,0.0,505.0,           ,1.0,1.0,175.0
263,Ruoka_paivittaistavarakauppa,2019-08-19 07:34:44.210526315,2019-08-19,2019-08-19,2019-08-19,1.0,-2.55,386.27,0.0,162.0,           ,1.0,1.0,83.0
264,Lemmikit,2019-08-19 09:41:03.157894736,2019-08-19,2019-08-19,2019-08-19,1.0,-21.94,364.33,0.0,162.0,           ,1.0,1.0,122.0
265,Muut,2019-08-19 11:47:22.105263157,2019-08-19,2019-08-19,2019-08-19,1.0,-30.05,334.28,0.0,162.0,           ,1.0,1.0,65.0
266,Asuminen,2019-08-19 15:59:59.999999999,2019-08-19,2019-08-19,2019-08-19,1.0,-16.23,318.05,0.0,162.0,           ,1.0,1.0,39.0
267,Tulot,2019-08-20 13:53:41.052631578,2019-08-20,2019-08-20,2019-08-20,1.0,-145.36,172.69,0.0,162.0,           ,1.0,1.0,85.0
268,Ravintolat_kahvilat,2019-08-21 20:12:37.894736841,2019-08-21,2019-08-21,2019-08-21,1.0,-13.76,158.93,0.0,162.0,           ,1.0,1.0,165.0
269,Ruoka_paivittaistavarakauppa,2019-08-22 18:06:18.947368420,2019-08-22,2019-08-22,2019-08-22,1.0,-29.1,129.83,0.0,162.0,           ,1.0,1.0,86.0
270,Muut,2019-08-23 22:18:56.842105262,2019-08-23,2019-08-23,2019-08-23,1.0,-113.41,16.42,0.0,105.0,OKOYFIHH   ,1.0,0.0,6.0
271,Ruoka_paivittaistavarakauppa,2019-08-26 00:25:15.789473683,2019-08-26,2019-08-26,2019-08-26,1.0,-2.47,13.95,0.0,162.0,           ,1.0,1.0,77.0
272,Ruoka_paivittaistavarakauppa,2019-08-27 02:31:34.736842104,2019-08-27,2019-08-27,2019-08-27,1.0,-0.67,13.28,0.0,162.0,           ,1.0,1.0,52.0
273,Ruoka_paivittaistavarakauppa,2019-08-29 06:44:12.631578946,2019-08-29,2019-08-29,2019-08-29,1.0,-5.34,7.94,0.0,162.0,           ,1.0,1.0,145.0
274,Tulot,2019-08-30 04:37:53.684210525,2019-08-30,2019-08-30,2019-08-30,1.0,0.31,8.25,710.0,588.0,           ,0.0,1.0,221.0
275,Asuminen,2019-08-30 08:50:31.578947367,2019-08-30,2019-08-30,2019-08-30,1.0,-16.2,-7.95,706.0,129.0,OKOYFIHH   ,0.0,0.0,199.0
276,Muut,2019-08-30 10:56:50.526315788,2019-08-30,2019-08-30,2019-08-30,1.0,-6.11,-14.06,0.0,163.0,           ,1.0,1.0,168.0
277,Tulot,2019-09-02 11:07:19.024390243,2019-09-02,2019-09-02,2019-09-02,1.0,303.34,289.28,701.0,520.0,           ,1.0,1.0,186.0
278,Muut,2019-09-03 22:14:38.048780486,2019-09-03,2019-09-03,2019-09-03,1.0,-26.02,263.26,0.0,163.0,           ,1.0,1.0,167.0
279,Vakuutukset,2019-09-05 09:21:57.073170729,2019-09-05,2019-09-05,2019-09-05,1.0,-13.06,250.2,706.0,129.0,OKOYFIHH   ,0.0,0.0,200.0
280,Ravintolat_kahvilat,2019-09-06 20:29:16.097560972,2019-09-06,2019-09-06,2019-09-06,1.0,-11.76,238.44,0.0,162.0,           ,1.0,1.0,148.0
281,Ruoka_paivittaistavarakauppa,2019-09-09 05:51:13.170731701,2019-09-09,2019-09-09,2019-09-09,1.0,-13.79,224.65,0.0,162.0,           ,1.0,1.0,135.0
282,Hyvinvointijakauneus,2019-09-09 07:36:35.121951215,2019-09-09,2019-09-09,2019-09-09,1.0,-26.36,198.29,0.0,162.0,           ,1.0,1.0,111.0
283,Ruoka_paivittaistavarakauppa,2019-09-09 18:43:54.146341458,2019-09-09,2019-09-09,2019-09-09,1.0,-28.8,169.49,0.0,162.0,           ,1.0,1.0,79.0
284,Tulot,2019-09-12 16:58:32.195121944,2019-09-12,2019-09-12,2019-09-12,1.0,94.86,264.35,710.0,588.0,           ,0.0,1.0,223.0
285,Ruoka_paivittaistavarakauppa,2019-09-16 02:20:29.268292673,2019-09-16,2019-09-16,2019-09-16,1.0,-52.22,212.13,0.0,162.0,           ,1.0,1.0,140.0
286,Muut,2019-09-16 04:05:51.219512187,2019-09-16,2019-09-16,2019-09-16,1.0,-316.96,-104.83,706.0,147.0,OKOYFIHH   ,0.0,0.0,206.0
287,Ruoka_paivittaistavarakauppa,2019-09-16 15:13:10.243902430,2019-09-16,2019-09-16,2019-09-16,1.0,-4.71,-109.54,0.0,162.0,           ,1.0,1.0,90.0
288,Ravintolat_kahvilat,2019-09-18 13:27:48.292682916,2019-09-18,2019-09-18,2019-09-18,1.0,-3.96,-113.5,0.0,162.0,           ,1.0,1.0,65.0
289,Ravintolat_kahvilat,2019-09-20 00:35:07.317073159,2019-09-20,2019-09-20,2019-09-20,1.0,-2.33,-115.83,0.0,162.0,           ,1.0,1.0,101.0
290,Lemmikit,2019-09-20 11:42:26.341463402,2019-09-20,2019-09-20,2019-09-20,1.0,-1.44,-117.27,0.0,162.0,           ,1.0,1.0,68.0
291,Tulot,2019-09-23 22:49:45.365853645,2019-09-23,2019-09-24,2019-09-23,1.0,-12.63,-129.9,0.0,162.0,           ,1.0,1.0,40.0
292,Ruoka_paivittaistavarakauppa,2019-09-24 09:57:04.390243888,2019-09-24,2019-09-24,2019-09-24,1.0,-11.74,-141.64,0.0,162.0,           ,1.0,1.0,95.0
293,Ruoka_paivittaistavarakauppa,2019-09-25 21:04:23.414634131,2019-09-25,2019-09-25,2019-09-25,1.0,-13.73,-155.37,0.0,162.0,           ,1.0,1.0,80.0
294,Muut,2019-09-27 08:11:42.439024374,2019-09-27,2019-09-27,2019-09-27,1.0,-32.33,-187.7,0.0,163.0,           ,1.0,1.0,168.0
295,Ruoka_paivittaistavarakauppa,2019-09-27 19:19:01.463414617,2019-09-27,2019-09-27,2019-09-27,1.0,-3.47,-191.17,0.0,162.0,           ,1.0,1.0,35.0
296,Muut,2019-09-30 06:26:20.487804860,2019-09-30,2019-09-30,2019-09-30,1.0,-23.6,-214.77,0.0,162.0,           ,1.0,1.0,92.0
297,Tulot,2019-10-01 22:53:32.307692307,2019-10-01,2019-10-01,2019-10-01,1.0,219.24,4.47,701.0,520.0,           ,1.0,1.0,182.0
298,Ruoka_paivittaistavarakauppa,2019-10-02 21:47:04.615384614,2019-10-02,2019-10-02,2019-10-02,1.0,-3.52,0.95,0.0,162.0,           ,1.0,1.0,61.0
299,Ruoka_paivittaistavarakauppa,2019-10-03 20:40:36.923076921,2019-10-03,2019-10-03,2019-10-02,1.0,-3.98,-3.03,0.0,162.0,           ,1.0,1.0,148.0
300,Asuminen,2019-10-04 19:34:09.230769228,2019-10-04,2019-10-04,2019-10-04,1.0,-30.69,-33.72,0.0,106.0,NDEAFIHH   ,0.0,0.0,28.0
301,Muut,2019-10-05 18:27:41.538461535,2019-10-05,2019-10-05,2019-10-04,1.0,-11.6,-45.32,0.0,163.0,           ,1.0,1.0,169.0
302,Harrastukset,2019-10-07 16:14:46.153846149,2019-10-07,2019-10-07,2019-10-07,1.0,-3.17,-48.49,0.0,162.0,           ,1.0,1.0,56.0
303,Ravintolat_kahvilat,2019-10-07 17:21:13.846153842,2019-10-07,2019-10-07,2019-10-07,1.0,-4.5,-52.99,0.0,162.0,           ,1.0,1.0,112.0
304,Lemmikit,2019-10-08 15:08:18.461538456,2019-10-08,2019-10-08,2019-10-08,1.0,-4.7,-57.69,0.0,162.0,           ,1.0,1.0,148.0
305,Ruoka_paivittaistavarakauppa,2019-10-10 12:55:23.076923070,2019-10-10,2019-10-10,2019-10-10,1.0,-0.55,-58.24,0.0,162.0,           ,1.0,1.0,85.0
306,Lapset,2019-10-10 14:01:50.769230763,2019-10-10,2019-10-10,2019-10-10,1.0,-6.14,-64.38,0.0,162.0,           ,1.0,1.0,69.0
307,Saastot_sijoitukset,2019-10-11 11:48:55.384615377,2019-10-11,2019-10-14,2019-10-11,1.0,-49.33,-113.71,706.0,129.0,NDEAFIHH   ,0.0,0.0,204.0
308,Ruoka_paivittaistavarakauppa,2019-10-14 07:23:04.615384605,2019-10-14,2019-10-14,2019-10-14,1.0,-1.47,-115.18,0.0,162.0,           ,1.0,1.0,36.0
309,Ruoka_paivittaistavarakauppa,2019-10-14 08:29:32.307692298,2019-10-14,2019-10-14,2019-10-14,1.0,-8.21,-123.39,0.0,162.0,           ,1.0,1.0,80.0
310,Asuminen,2019-10-14 09:35:59.999999991,2019-10-14,2019-10-14,2019-10-14,1.0,-37.85,-161.24,706.0,129.0,OKOYFIHH   ,0.0,0.0,202.0
311,Liikkuminen,2019-10-14 10:42:27.692307684,2019-10-14,2019-10-14,2019-10-14,1.0,-12.45,-173.69,0.0,162.0,           ,1.0,1.0,134.0
312,Ruoka_paivittaistavarakauppa,2019-10-15 06:16:36.923076912,2019-10-15,2019-10-15,2019-10-15,1.0,-7.27,-180.96,0.0,162.0,           ,1.0,1.0,68.0
313,Ruoka_paivittaistavarakauppa,2019-10-17 02:57:13.846153833,2019-10-17,2019-10-17,2019-10-17,1.0,-14.28,-195.24,0.0,162.0,           ,1.0,1.0,90.0
314,Muut,2019-10-17 05:10:09.230769219,2019-10-17,2019-10-17,2019-10-17,1.0,-5.73,-200.97,0.0,162.0,           ,1.0,1.0,102.0
315,Muut,2019-10-18 04:03:41.538461526,2019-10-18,2019-10-18,2019-10-18,1.0,-4.43,-205.4,0.0,162.0,           ,1.0,1.0,161.0
316,Ruoka_paivittaistavarakauppa,2019-10-21 00:44:18.461538447,2019-10-21,2019-10-21,2019-10-21,1.0,-1.07,-206.47,0.0,162.0,           ,1.0,1.0,34.0
317,Muut,2019-10-21 01:50:46.153846140,2019-10-21,2019-10-21,2019-10-21,1.0,-2.79,-209.26,0.0,162.0,           ,1.0,1.0,99.0
318,Ruoka_paivittaistavarakauppa,2019-10-21 23:37:50.769230754,2019-10-21,2019-10-22,2019-10-21,1.0,-6.67,-215.93,0.0,162.0,           ,1.0,1.0,151.0
319,Asuminen,2019-10-24 19:11:59.999999982,2019-10-24,2019-10-24,2019-10-24,1.0,-51.85,-267.78,706.0,129.0,NDEAFIHH   ,0.0,0.0,198.0
320,Ruoka_paivittaistavarakauppa,2019-10-24 21:24:55.384615368,2019-10-24,2019-10-24,2019-10-24,1.0,-6.49,-274.27,0.0,162.0,           ,1.0,1.0,45.0
321,Ruoka_paivittaistavarakauppa,2019-10-24 22:31:23.076923061,2019-10-24,2019-10-24,2019-10-24,1.0,-5.02,-279.29,0.0,162.0,           ,1.0,1.0,112.0
322,Luokittelemattomat,2019-10-25 18:05:32.307692289,2019-10-25,2019-10-25,2019-10-25,1.0,-6.73,-286.02,0.0,162.0,           ,1.0,1.0,127.0
323,Muut,2019-10-25 20:18:27.692307675,2019-10-25,2019-10-25,2019-10-25,1.0,-11.07,-297.09,0.0,163.0,           ,1.0,1.0,167.0
324,Matkailu,2019-10-28 13:39:41.538461517,2019-10-28,2019-10-28,2019-10-28,1.0,-15.03,-312.12,0.0,162.0,           ,1.0,1.0,101.0
325,Liikkuminen,2019-10-28 15:52:36.923076903,2019-10-28,2019-10-28,2019-10-28,1.0,-25.52,-337.64,0.0,162.0,           ,1.0,1.0,99.0
326,Ruoka_paivittaistavarakauppa,2019-10-28 16:59:04.615384596,2019-10-28,2019-10-28,2019-10-28,1.0,-6.4,-344.04,0.0,162.0,           ,1.0,1.0,97.0
327,Liikkuminen,2019-10-29 14:46:09.230769210,2019-10-29,2019-10-30,2019-10-29,1.0,-7.08,-351.12,0.0,162.0,           ,1.0,1.0,107.0
328,Ravintolat_kahvilat,2019-10-30 12:33:13.846153824,2019-10-30,2019-10-30,2019-10-30,1.0,-0.85,-351.97,0.0,162.0,           ,1.0,1.0,121.0
329,Ruoka_paivittaistavarakauppa,2019-11-01 13:12:39.633027522,2019-11-01,2019-11-01,2019-11-01,1.0,-6.31,-358.28,0.0,162.0,           ,1.0,1.0,55.0
330,Hyvinvointi,2019-11-04 02:25:19.266055044,2019-11-04,2019-11-04,2019-11-04,1.0,-22.18,-380.46,0.0,162.0,           ,1.0,1.0,84.0
331,Liikkuminen,2019-11-04 04:50:38.532110088,2019-11-04,2019-11-04,2019-11-04,1.0,-3.83,-384.29,0.0,162.0,           ,1.0,1.0,86.0
332,Asuminen,2019-11-04 07:15:57.798165132,2019-11-04,2019-11-04,2019-11-04,1.0,-39.89,-424.18,706.0,129.0,OKOYFIHH   ,0.0,0.0,198.0
333,Ruoka_paivittaistavarakauppa,2019-11-04 15:37:58.899082566,2019-11-04,2019-11-04,2019-11-04,1.0,-2.23,-426.41,0.0,162.0,           ,1.0,1.0,136.0
334,Ravintolat_kahvilat,2019-11-04 18:03:18.165137610,2019-11-04,2019-11-04,2019-11-04,1.0,-1.22,-427.63,0.0,162.0,           ,1.0,1.0,81.0
335,Matkailu,2019-11-04 20:28:37.431192654,2019-11-04,2019-11-06,2019-11-04,1.0,-17.37,-445.0,0.0,106.0,NDEAFIHH   ,0.0,0.0,12.0
336,Ravintolat_kahvilat,2019-11-05 01:19:15.963302742,2019-11-05,2019-11-05,2019-11-05,1.0,-2.8,-447.8,0.0,106.0,OKOYFIHH   ,0.0,0.0,13.0
337,Lemmikit,2019-11-05 09:41:17.064220176,2019-11-05,2019-11-05,2019-11-05,1.0,-27.92,-475.72,0.0,106.0,OKOYFIHH   ,0.0,0.0,9.0
338,Muut,2019-11-05 14:31:55.596330264,2019-11-05,2019-11-05,2019-11-05,1.0,-37.7,-513.42,0.0,106.0,NDEAFIHH   ,0.0,0.0,13.0
339,Kulttuuri_viihde,2019-11-05 22:53:56.697247698,2019-11-05,2019-11-05,2019-11-05,1.0,-15.03,-528.45,0.0,106.0,DABAFIHH   ,0.0,0.0,25.0
340,Liikkuminen,2019-11-06 12:06:36.330275220,2019-11-06,2019-11-06,2019-11-06,1.0,-26.26,-554.71,0.0,106.0,OKOYFIHH   ,0.0,0.0,20.0
341,Harrastukset,2019-11-07 06:09:54.495412830,2019-11-07,2019-11-07,2019-11-07,1.0,-44.26,-598.97,0.0,106.0,DABAFIHH   ,0.0,0.0,9.0
342,Ruoka_paivittaistavarakauppa,2019-11-07 21:47:53.394495396,2019-11-07,2019-11-07,2019-11-07,1.0,-1.39,-600.36,0.0,162.0,           ,1.0,1.0,150.0
343,Liikkuminen,2019-11-08 03:44:35.229357786,2019-11-08,2019-11-08,2019-11-08,1.0,-5.28,-605.64,0.0,162.0,           ,1.0,1.0,148.0
344,Muut,2019-11-08 16:57:14.862385308,2019-11-08,2019-11-08,2019-11-08,1.0,-11.22,-616.86,0.0,163.0,           ,1.0,1.0,168.0
345,Matkailu,2019-11-10 19:22:34.128440352,2019-11-10,2019-11-10,2019-11-10,1.0,-89.22,-706.08,0.0,106.0,DABAFIHH   ,0.0,0.0,15.0
346,Ravintolat_kahvilat,2019-11-11 08:35:13.761467874,2019-11-11,2019-11-11,2019-11-11,1.0,-3.29,-709.37,0.0,162.0,           ,1.0,1.0,33.0
347,Luokittelemattomat,2019-11-11 11:00:33.027522918,2019-11-11,2019-11-11,2019-11-11,1.0,-35.51,-744.88,706.0,129.0,OKOYFIHH   ,0.0,0.0,201.0
348,Liikkuminen,2019-11-12 00:13:12.660550440,2019-11-12,2019-11-12,2019-11-12,1.0,-9.18,-754.06,0.0,162.0,           ,1.0,1.0,33.0
349,Liikkuminen,2019-11-12 13:25:52.293577962,2019-11-12,2019-11-12,2019-11-12,1.0,-2.75,-756.81,0.0,162.0,           ,1.0,1.0,127.0
350,Ruoka_paivittaistavarakauppa,2019-11-12 15:51:11.559633006,2019-11-12,2019-11-12,2019-11-12,1.0,-6.85,-763.66,0.0,162.0,           ,1.0,1.0,163.0
351,Ruoka_paivittaistavarakauppa,2019-11-13 05:03:51.192660528,2019-11-13,2019-11-13,2019-11-13,1.0,-9.28,-772.94,0.0,162.0,           ,1.0,1.0,48.0
352,Luokittelemattomat,2019-11-13 18:16:30.825688050,2019-11-13,2019-11-13,2019-11-13,1.0,-5.87,-778.81,0.0,162.0,           ,1.0,1.0,87.0
353,Ruoka_paivittaistavarakauppa,2019-11-14 20:41:50.091743094,2019-11-14,2019-11-14,2019-11-14,1.0,-0.89,-779.7,0.0,162.0,           ,1.0,1.0,35.0
354,Ruoka_paivittaistavarakauppa,2019-11-15 02:38:31.926605484,2019-11-15,2019-11-15,2019-11-15,1.0,-2.91,-782.61,0.0,162.0,           ,1.0,1.0,59.0
355,Muut,2019-11-15 07:29:10.458715572,2019-11-15,2019-11-15,2019-11-15,1.0,-40.21,-822.82,0.0,163.0,           ,1.0,1.0,167.0
356,Tulot,2019-11-15 09:54:29.724770616,2019-11-15,2019-11-15,2019-11-15,1.0,708.92,-113.9,710.0,506.0,           ,1.0,1.0,211.0
357,Muut,2019-11-16 23:07:09.357798138,2019-11-16,2019-11-16,2019-11-16,1.0,-71.79,-185.69,0.0,163.0,           ,1.0,1.0,167.0
358,Liikkuminen,2019-11-18 01:32:28.623853182,2019-11-18,2019-11-18,2019-11-18,1.0,-0.87,-186.56,0.0,162.0,           ,1.0,1.0,104.0
359,Ruoka_paivittaistavarakauppa,2019-11-18 12:19:48.990825660,2019-11-18,2019-11-18,2019-11-18,1.0,-2.34,-188.9,0.0,162.0,           ,1.0,1.0,64.0
360,Ruoka_paivittaistavarakauppa,2019-11-18 14:45:08.256880704,2019-11-18,2019-11-18,2019-11-18,1.0,-19.34,-208.24,0.0,162.0,           ,1.0,1.0,36.0
361,Lapset,2019-11-19 03:57:47.889908226,2019-11-19,2019-11-19,2019-11-19,1.0,-9.91,-218.15,0.0,106.0,OKOYFIHH   ,0.0,0.0,22.0
362,Ruoka_paivittaistavarakauppa,2019-11-19 17:10:27.522935748,2019-11-19,2019-11-19,2019-11-19,1.0,-0.23,-218.38,0.0,162.0,           ,1.0,1.0,119.0
363,Ruoka_paivittaistavarakauppa,2019-11-20 06:23:07.155963270,2019-11-20,2019-11-20,2019-11-19,1.0,-1.09,-219.47,0.0,162.0,           ,1.0,1.0,127.0
364,Ruoka_paivittaistavarakauppa,2019-11-21 19:35:46.788990792,2019-11-21,2019-11-21,2019-11-21,1.0,-3.29,-222.76,0.0,162.0,           ,1.0,1.0,100.0
365,Hyvinvointijakauneus,2019-11-22 00:26:25.321100880,2019-11-22,2019-11-22,2019-11-22,1.0,-15.94,-238.7,0.0,106.0,OKOYFIHH   ,0.0,0.0,25.0
366,Muut,2019-11-22 08:48:26.422018314,2019-11-22,2019-11-22,2019-11-22,1.0,-8.32,-247.02,0.0,163.0,           ,1.0,1.0,167.0
367,Luokittelemattomat,2019-11-22 11:13:45.688073358,2019-11-22,2019-11-22,2019-11-22,1.0,-8.84,-255.86,0.0,106.0,NDEAFIHH   ,1.0,0.0,14.0
368,Asuminen,2019-11-22 13:39:04.954128402,2019-11-22,2019-11-22,2019-11-22,1.0,-3.65,-259.51,706.0,129.0,NDEAFIHH   ,0.0,0.0,200.0
369,Muut,2019-11-22 22:01:06.055045836,2019-11-22,2019-11-25,2019-11-22,1.0,-25.18,-284.69,0.0,106.0,OKOYFIHH   ,0.0,0.0,30.0
370,Asuminen,2019-11-25 02:51:44.587155924,2019-11-25,2019-11-25,2019-11-25,1.0,-59.17,-343.86,706.0,129.0,NDEAFIHH   ,0.0,0.0,203.0
371,Hyvinvointijakauneus,2019-11-25 05:17:03.853210968,2019-11-25,2019-11-25,2019-11-21,1.0,-5.76,-349.62,0.0,162.0,           ,1.0,1.0,143.0
372,Muut,2019-11-25 16:04:24.220183446,2019-11-25,2019-11-25,2019-11-25,1.0,-24.62,-374.24,0.0,163.0,           ,1.0,1.0,167.0
373,Ruoka_paivittaistavarakauppa,2019-11-25 18:29:43.486238490,2019-11-25,2019-11-25,2019-11-25,1.0,-4.77,-379.01,0.0,162.0,           ,1.0,1.0,33.0
374,Tulot,2019-11-26 07:42:23.119266012,2019-11-26,2019-11-26,2019-11-26,1.0,17.37,-361.64,710.0,588.0,           ,0.0,1.0,222.0
375,Ruoka_paivittaistavarakauppa,2019-11-26 20:55:02.752293534,2019-11-26,2019-11-26,2019-11-26,1.0,-5.51,-367.15,0.0,162.0,           ,1.0,1.0,122.0
376,Luokittelemattomat,2019-11-27 10:07:42.385321056,2019-11-27,2019-11-27,2019-11-27,1.0,-2.66,-369.81,0.0,162.0,           ,1.0,1.0,81.0
377,Luokittelemattomat,2019-11-27 23:20:22.018348578,2019-11-27,2019-11-27,2019-11-27,1.0,-5.32,-375.13,0.0,162.0,           ,1.0,1.0,127.0
378,Matkailu,2019-11-29 01:45:41.284403622,2019-11-29,2019-11-29,2019-11-29,1.0,-0.2,-375.33,0.0,162.0,           ,1.0,1.0,65.0
379,Lapset,2019-11-29 04:11:00.550458666,2019-11-29,2019-11-29,2019-11-29,1.0,-4.84,-380.17,0.0,162.0,           ,1.0,1.0,122.0
380,Ravintolat_kahvilat,2019-11-29 12:33:01.651376100,2019-11-29,2019-11-29,2019-11-29,1.0,-1.37,-381.54,0.0,162.0,           ,1.0,1.0,65.0
381,Lemmikit,2019-11-29 14:58:20.917431144,2019-11-29,2019-11-29,2019-11-29,1.0,-6.07,-387.61,0.0,162.0,           ,1.0,1.0,119.0
382,Luottojen_maksut,2019-11-29 17:23:40.183486188,2019-11-29,2019-11-29,2019-11-29,1.0,-5.44,-393.05,0.0,162.0,           ,1.0,1.0,73.0
383,Muut,2019-12-02 12:44:26.666666666,2019-12-02,2019-12-02,2019-12-02,1.0,-21.78,-414.83,0.0,163.0,           ,1.0,1.0,167.0
384,Asuminen,2019-12-02 18:22:13.333333333,2019-12-02,2019-12-02,2019-12-02,1.0,-19.01,-433.84,706.0,129.0,OKOYFIHH   ,0.0,0.0,198.0
385,Muut,2019-12-03 07:06:39.999999999,2019-12-03,2019-12-03,2019-12-03,1.0,-17.52,-451.36,0.0,163.0,           ,1.0,1.0,167.0
386,Liikkuminen,2019-12-04 01:28:53.333333332,2019-12-04,2019-12-04,2019-12-04,1.0,-20.59,-471.95,0.0,106.0,NDEAFIHH   ,0.0,0.0,12.0
387,Terveys,2019-12-04 19:51:06.666666665,2019-12-04,2019-12-05,2019-12-04,1.0,-20.33,-492.28,0.0,106.0,OKOYFIHH   ,0.0,0.0,16.0
388,Matkailu,2019-12-05 14:13:19.999999998,2019-12-05,2019-12-05,2019-12-04,1.0,-17.61,-509.89,0.0,106.0,NDEAFIHH   ,0.0,0.0,21.0
389,Luokittelemattomat,2019-12-06 08:35:33.333333331,2019-12-06,2019-12-06,2019-12-06,1.0,-13.52,-523.41,0.0,106.0,OKOYFIHH   ,0.0,0.0,8.0
390,Liikkuminen,2019-12-06 21:19:59.999999997,2019-12-06,2019-12-06,2019-12-06,1.0,-11.47,-534.88,0.0,106.0,OKOYFIHH   ,0.0,0.0,23.0
391,Matkailu,2019-12-07 02:57:46.666666664,2019-12-07,2019-12-07,2019-12-07,1.0,-231.83,-766.71,0.0,106.0,OKOYFIHH   ,1.0,0.0,31.0
392,Asuminen,2019-12-09 10:04:26.666666663,2019-12-09,2019-12-09,2019-12-09,1.0,-23.56,-790.27,0.0,106.0,DABAFIHH   ,0.0,0.0,18.0
393,Luokittelemattomat,2019-12-09 15:42:13.333333330,2019-12-09,2019-12-09,2019-12-09,1.0,-11.48,-801.75,0.0,106.0,NDEAFIHH   ,0.0,0.0,28.0
394,Lemmikit,2019-12-10 04:26:39.999999996,2019-12-10,2019-12-10,2019-12-10,1.0,-52.35,-854.1,0.0,162.0,           ,1.0,1.0,98.0
395,Ravintolat_kahvilat,2019-12-10 22:48:53.333333329,2019-12-10,2019-12-10,2019-12-10,1.0,-0.76,-854.86,0.0,162.0,           ,1.0,1.0,90.0
396,Ravintolat_kahvilat,2019-12-11 05:55:33.333333328,2019-12-11,2019-12-11,2019-12-11,1.0,-4.14,-859.0,0.0,162.0,           ,1.0,1.0,68.0
397,Luokittelemattomat,2019-12-11 17:11:06.666666662,2019-12-11,2019-12-11,2019-12-11,1.0,-1.69,-860.69,0.0,162.0,           ,1.0,1.0,130.0
398,Lapset,2019-12-13 00:17:46.666666661,2019-12-13,2019-12-13,2019-12-13,1.0,-27.64,-888.33,0.0,106.0,OKOYFIHH   ,1.0,0.0,10.0
399,Matkailu,2019-12-13 11:33:19.999999995,2019-12-13,2019-12-13,2019-12-13,1.0,-12.74,-901.07,706.0,129.0,DABAFIHH   ,0.0,0.0,201.0
400,Hyvinvointijakauneus,2019-12-15 18:39:59.999999994,2019-12-15,2019-12-15,2019-12-15,1.0,-5.12,-906.19,0.0,106.0,OKOYFIHH   ,0.0,0.0,31.0
401,Tulot,2019-12-16 07:24:26.666666660,2019-12-16,2019-12-16,2019-12-16,1.0,842.3,-63.89,710.0,588.0,           ,0.0,1.0,222.0
402,Ruoka_paivittaistavarakauppa,2019-12-16 13:02:13.333333327,2019-12-16,2019-12-16,2019-12-16,1.0,-0.99,-64.88,0.0,162.0,           ,1.0,1.0,115.0
403,Asuminen,2019-12-16 20:08:53.333333326,2019-12-16,2019-12-16,2019-12-16,1.0,-15.01,-79.89,706.0,129.0,DABAFIHH   ,0.0,0.0,198.0
404,Tulot,2019-12-17 01:46:39.999999993,2019-12-17,2019-12-17,2019-12-17,1.0,2.24,-77.65,710.0,506.0,           ,1.0,1.0,219.0
405,Muut,2019-12-18 14:31:06.666666659,2019-12-18,2019-12-18,2019-12-18,1.0,-0.16,-77.81,0.0,162.0,           ,1.0,1.0,98.0
406,Ruoka_paivittaistavarakauppa,2019-12-19 08:53:19.999999992,2019-12-19,2019-12-19,2019-12-19,1.0,-0.57,-78.38,0.0,162.0,           ,1.0,1.0,59.0
407,Muut,2019-12-19 15:59:59.999999991,2019-12-19,2019-12-19,2019-12-19,1.0,-0.58,-78.96,0.0,103.0,           ,0.0,1.0,3.0
408,Terveys,2019-12-20 03:15:33.333333325,2019-12-20,2019-12-20,2019-12-20,1.0,-3.72,-82.68,0.0,162.0,           ,1.0,1.0,99.0
409,Ruoka_paivittaistavarakauppa,2019-12-20 10:22:13.333333324,2019-12-20,2019-12-20,2019-12-20,1.0,-0.53,-83.21,0.0,162.0,           ,1.0,1.0,136.0
410,Ruoka_paivittaistavarakauppa,2019-12-20 21:37:46.666666658,2019-12-20,2019-12-20,2019-12-20,1.0,-45.51,-128.72,0.0,162.0,           ,1.0,1.0,151.0
411,Ruoka_paivittaistavarakauppa,2019-12-23 11:51:06.666666656,2019-12-23,2019-12-23,2019-12-23,1.0,-5.76,-134.48,0.0,162.0,           ,1.0,1.0,95.0
412,Ruoka_paivittaistavarakauppa,2019-12-23 23:06:39.999999990,2019-12-23,2019-12-23,2019-12-23,1.0,-3.13,-137.61,0.0,162.0,           ,1.0,1.0,81.0
413,Ravintolat_kahvilat,2019-12-24 04:44:26.666666657,2019-12-24,2019-12-24,2019-12-24,1.0,-14.79,-152.4,0.0,163.0,           ,1.0,1.0,167.0
414,Ruoka_paivittaistavarakauppa,2019-12-24 17:28:53.333333323,2019-12-24,2019-12-24,2019-12-24,1.0,-39.37,-191.77,0.0,162.0,           ,1.0,1.0,50.0
415,Ruoka_paivittaistavarakauppa,2019-12-27 00:35:33.333333322,2019-12-27,2019-12-27,2019-12-27,1.0,-0.43,-192.2,0.0,162.0,           ,1.0,1.0,41.0
416,Ruoka_paivittaistavarakauppa,2019-12-27 06:13:19.999999989,2019-12-27,2019-12-27,2019-12-27,1.0,-7.93,-200.13,0.0,162.0,           ,1.0,1.0,130.0
417,Luottojen_maksut,2019-12-27 18:57:46.666666655,2019-12-27,2019-12-27,2019-12-27,1.0,-25.16,-225.29,0.0,162.0,           ,1.0,1.0,100.0
418,Hyvinvointi,2019-12-30 02:04:26.666666654,2019-12-30,2019-12-30,2019-12-30,1.0,-14.33,-239.62,0.0,106.0,DABAFIHH   ,0.0,0.0,32.0
419,Asuminen,2019-12-30 07:42:13.333333321,2019-12-30,2019-12-30,2019-12-30,1.0,-12.81,-252.43,0.0,106.0,OKOYFIHH   ,0.0,0.0,26.0
420,Tulot,2019-12-30 13:19:59.999999988,2019-12-30,2019-12-30,2019-12-30,1.0,436.18,183.75,701.0,520.0,           ,1.0,1.0,185.0
421,Vakuutukset,2019-12-30 14:48:53.333333320,2019-12-30,2019-12-30,2019-12-30,1.0,-49.1,134.65,0.0,106.0,NDEAFIHH   ,0.0,0.0,17.0
422,Hyvinvointijakauneus,2019-12-30 20:26:39.999999987,2019-12-30,2019-12-30,2019-12-30,1.0,-15.87,118.78,0.0,106.0,OKOYFIHH   ,0.0,0.0,31.0
423,Muut,2020-01-01 18:50:07.594936708,2020-01-01,2020-01-01,2020-01-01,1.0,-23.38,95.4,0.0,163.0,           ,1.0,1.0,167.0
424,Muut,2020-01-02 13:40:15.189873416,2020-01-02,2020-01-02,2020-01-02,1.0,-36.02,59.38,0.0,163.0,           ,1.0,1.0,168.0
425,Ruoka_paivittaistavarakauppa,2020-01-03 08:30:22.784810124,2020-01-03,2020-01-03,2020-01-03,1.0,-3.37,56.01,0.0,162.0,           ,1.0,1.0,117.0
426,Ruoka_paivittaistavarakauppa,2020-01-06 01:31:08.354430372,2020-01-06,2020-01-06,2020-01-06,1.0,-5.19,50.82,0.0,162.0,           ,1.0,1.0,157.0
427,Ruoka_paivittaistavarakauppa,2020-01-06 03:20:30.379746832,2020-01-06,2020-01-06,2020-01-06,1.0,-11.21,39.61,0.0,162.0,           ,1.0,1.0,34.0
428,Muut,2020-01-06 11:50:53.164556956,2020-01-06,2020-01-06,2020-01-06,1.0,-16.59,23.02,0.0,163.0,           ,1.0,1.0,167.0
429,Ravintolat_kahvilat,2020-01-06 17:00:45.569620248,2020-01-06,2020-01-06,2020-01-06,1.0,-3.07,19.95,0.0,162.0,           ,1.0,1.0,34.0
430,Luokittelemattomat,2020-01-06 22:10:37.974683540,2020-01-06,2020-01-06,2020-01-06,1.0,-8.83,11.12,0.0,162.0,           ,1.0,1.0,125.0
431,Muut,2020-01-07 06:41:00.759493664,2020-01-07,2020-01-07,2020-01-07,1.0,-62.68,-51.56,0.0,163.0,           ,1.0,1.0,171.0
432,Tulot,2020-01-08 20:21:15.949367080,2020-01-08,2020-01-08,2020-01-08,1.0,11.43,-40.13,710.0,588.0,           ,0.0,1.0,221.0
433,Tulot,2020-01-09 15:11:23.544303788,2020-01-09,2020-01-10,2020-01-09,1.0,9.36,-30.77,710.0,588.0,           ,0.0,1.0,221.0
434,Tulot,2020-01-10 10:01:31.139240496,2020-01-10,2020-01-10,2020-01-10,1.0,276.23,245.46,710.0,588.0,           ,0.0,1.0,221.0
435,Saastot_sijoitukset,2020-01-10 18:31:53.924050620,2020-01-10,2020-01-10,2020-01-10,1.0,-1.48,243.98,0.0,162.0,           ,1.0,1.0,95.0
436,Liikkuminen,2020-01-13 04:51:38.734177204,2020-01-13,2020-01-13,2020-01-13,1.0,-221.15,22.83,0.0,162.0,           ,1.0,1.0,133.0
437,Ruoka_paivittaistavarakauppa,2020-01-13 13:22:01.518987328,2020-01-13,2020-01-13,2020-01-13,1.0,-10.08,12.75,0.0,162.0,           ,1.0,1.0,79.0
438,Ruoka_paivittaistavarakauppa,2020-01-13 23:41:46.329113912,2020-01-13,2020-01-13,2020-01-13,1.0,-1.57,11.18,0.0,162.0,           ,1.0,1.0,80.0
439,Luokittelemattomat,2020-01-14 03:02:16.708860744,2020-01-14,2020-01-14,2020-01-14,1.0,-14.1,-2.92,0.0,162.0,           ,1.0,1.0,93.0
440,Muut,2020-01-14 08:12:09.113924036,2020-01-14,2020-01-14,2020-01-14,1.0,-48.01,-50.93,0.0,163.0,           ,1.0,1.0,168.0
441,Ruoka_paivittaistavarakauppa,2020-01-16 11:32:39.493670868,2020-01-16,2020-01-16,2020-01-16,1.0,-2.79,-53.72,0.0,162.0,           ,1.0,1.0,126.0
442,Muut,2020-01-16 16:42:31.898734160,2020-01-16,2020-01-16,2020-01-16,1.0,-10.66,-64.38,0.0,163.0,           ,1.0,1.0,168.0
443,Kulttuuri_viihde,2020-01-16 21:52:24.303797452,2020-01-16,2020-01-16,2020-01-16,1.0,-16.45,-80.83,0.0,162.0,           ,1.0,1.0,109.0
444,Asuminen,2020-01-17 06:22:47.088607576,2020-01-17,2020-01-17,2020-01-17,1.0,-4.1,-84.93,0.0,162.0,           ,1.0,1.0,42.0
445,Kulttuuri_viihde,2020-01-20 01:12:54.683544284,2020-01-20,2020-01-20,2020-01-20,1.0,-11.34,-96.27,0.0,162.0,           ,1.0,1.0,64.0
446,Ruoka_paivittaistavarakauppa,2020-01-20 14:53:09.873417700,2020-01-20,2020-01-20,2020-01-20,1.0,-1.81,-98.08,0.0,162.0,           ,1.0,1.0,34.0
447,Hyvinvointijakauneus,2020-01-20 20:03:02.278480992,2020-01-20,2020-01-20,2020-01-20,1.0,-5.63,-103.71,0.0,162.0,           ,1.0,1.0,137.0
448,Tulot,2020-01-21 09:43:17.468354408,2020-01-21,2020-01-21,2020-01-21,1.0,1.46,-102.25,710.0,588.0,           ,0.0,1.0,221.0
449,Ruoka_paivittaistavarakauppa,2020-01-22 18:13:40.253164532,2020-01-22,2020-01-23,2020-01-22,1.0,-3.52,-105.77,0.0,162.0,           ,1.0,1.0,157.0
450,Ruoka_paivittaistavarakauppa,2020-01-23 04:33:25.063291116,2020-01-23,2020-01-23,2020-01-23,1.0,-2.25,-108.02,0.0,162.0,           ,1.0,1.0,55.0
451,Ruoka_paivittaistavarakauppa,2020-01-23 13:03:47.848101240,2020-01-23,2020-01-23,2020-01-23,1.0,-7.34,-115.36,0.0,162.0,           ,1.0,1.0,86.0
452,Ruoka_paivittaistavarakauppa,2020-01-24 23:23:32.658227824,2020-01-24,2020-01-24,2020-01-24,1.0,-2.72,-118.08,0.0,162.0,           ,1.0,1.0,74.0
453,Ravintolat_kahvilat,2020-01-27 07:53:55.443037948,2020-01-27,2020-01-27,2020-01-27,1.0,-2.16,-120.24,0.0,162.0,           ,1.0,1.0,55.0
454,Ruoka_paivittaistavarakauppa,2020-01-27 16:24:18.227848072,2020-01-27,2020-01-27,2020-01-27,1.0,-7.13,-127.37,0.0,162.0,           ,1.0,1.0,127.0
455,Saastot_sijoitukset,2020-01-27 21:34:10.632911364,2020-01-27,2020-01-27,2020-01-27,1.0,-19.21,-146.58,0.0,162.0,           ,1.0,1.0,84.0
456,Ruoka_paivittaistavarakauppa,2020-01-28 02:44:03.037974656,2020-01-28,2020-01-29,2020-01-28,1.0,-16.37,-162.95,0.0,162.0,           ,1.0,1.0,65.0
457,Ruoka_paivittaistavarakauppa,2020-01-28 11:14:25.822784780,2020-01-28,2020-01-28,2020-01-28,1.0,-1.62,-164.57,0.0,162.0,           ,1.0,1.0,124.0
458,Kulttuuri_viihde,2020-01-29 00:54:41.012658196,2020-01-29,2020-01-29,2020-01-29,1.0,-71.82,-236.39,0.0,106.0,OKOYFIHH   ,0.0,0.0,31.0
459,Liikkuminen,2020-01-29 06:04:33.417721488,2020-01-29,2020-01-29,2020-01-29,1.0,-12.23,-248.62,0.0,106.0,OKOYFIHH   ,1.0,0.0,7.0
460,Ruoka_paivittaistavarakauppa,2020-01-29 19:44:48.607594904,2020-01-29,2020-01-29,2020-01-29,1.0,-1.18,-249.8,0.0,162.0,           ,1.0,1.0,97.0
461,Ravintolat_kahvilat,2020-01-31 14:34:56.202531612,2020-01-31,2020-01-31,2020-01-31,1.0,-5.47,-255.27,0.0,162.0,           ,1.0,1.0,44.0
462,Ruoka_paivittaistavarakauppa,2020-02-03 02:15:50.943396226,2020-02-03,2020-02-03,2020-02-03,1.0,-16.91,-272.18,0.0,162.0,           ,1.0,1.0,59.0
463,Asuminen,2020-02-03 04:31:41.886792452,2020-02-03,2020-02-03,2020-02-03,1.0,-59.39,-331.57,0.0,162.0,           ,1.0,1.0,95.0
464,Liikkuminen,2020-02-04 06:47:32.830188678,2020-02-04,2020-02-04,2020-02-04,1.0,-37.18,-368.75,0.0,106.0,OKOYFIHH   ,0.0,0.0,15.0
465,Luottojen_maksut,2020-02-05 09:03:23.773584904,2020-02-05,2020-02-05,2020-02-05,1.0,-19.36,-388.11,0.0,106.0,NDEAFIHH   ,0.0,0.0,31.0
466,Shoppailu,2020-02-06 11:19:14.716981130,2020-02-06,2020-02-06,2020-02-06,1.0,-6.66,-394.77,0.0,106.0,OKOYFIHH   ,0.0,0.0,7.0
467,Asuminen,2020-02-07 13:35:05.660377356,2020-02-07,2020-02-07,2020-02-07,1.0,-1.96,-396.73,0.0,162.0,           ,1.0,1.0,87.0
468,Ravintolat_kahvilat,2020-02-10 15:50:56.603773582,2020-02-10,2020-02-10,2020-02-10,1.0,-2.69,-399.42,0.0,162.0,           ,1.0,1.0,112.0
469,Ruoka_paivittaistavarakauppa,2020-02-10 18:06:47.547169808,2020-02-10,2020-02-10,2020-02-10,1.0,-2.86,-402.28,0.0,162.0,           ,1.0,1.0,36.0
470,Ravintolat_kahvilat,2020-02-10 20:22:38.490566034,2020-02-10,2020-02-10,2020-02-10,1.0,-3.02,-405.3,0.0,162.0,           ,1.0,1.0,93.0
471,Saastot_sijoitukset,2020-02-11 22:38:29.433962260,2020-02-11,2020-02-11,2020-02-11,1.0,-4.08,-409.38,0.0,162.0,           ,1.0,1.0,68.0
472,Ravintolat_kahvilat,2020-02-13 00:54:20.377358486,2020-02-13,2020-02-13,2020-02-13,1.0,-8.13,-417.51,0.0,162.0,           ,1.0,1.0,123.0
473,Tulot,2020-02-14 03:10:11.320754712,2020-02-14,2020-02-14,2020-02-14,1.0,9.88,-407.63,710.0,506.0,           ,1.0,1.0,216.0
474,Ruoka_paivittaistavarakauppa,2020-02-17 05:26:02.264150938,2020-02-17,2020-02-17,2020-02-17,1.0,-5.46,-413.09,0.0,162.0,           ,1.0,1.0,166.0
475,Saastot_sijoitukset,2020-02-17 07:41:53.207547164,2020-02-17,2020-02-17,2020-02-17,1.0,-9.3,-422.39,706.0,147.0,OKOYFIHH   ,0.0,0.0,206.0
476,Ravintolat_kahvilat,2020-02-17 09:57:44.150943390,2020-02-17,2020-02-17,2020-02-17,1.0,-4.47,-426.86,0.0,162.0,           ,1.0,1.0,59.0
477,Ruoka_paivittaistavarakauppa,2020-02-18 12:13:35.094339616,2020-02-18,2020-02-18,2020-02-18,1.0,-3.95,-430.81,0.0,162.0,           ,1.0,1.0,124.0
478,Liikkuminen,2020-02-19 14:29:26.037735842,2020-02-19,2020-02-19,2020-02-19,1.0,-3.66,-434.47,0.0,162.0,           ,1.0,1.0,137.0
479,Ruoka_paivittaistavarakauppa,2020-02-20 16:45:16.981132068,2020-02-20,2020-02-20,2020-02-20,1.0,-1.64,-436.11,0.0,162.0,           ,1.0,1.0,95.0
480,Ruoka_paivittaistavarakauppa,2020-02-20 19:01:07.924528294,2020-02-20,2020-02-20,2020-02-20,1.0,-4.4,-440.51,0.0,162.0,           ,1.0,1.0,33.0
481,Saastot_sijoitukset,2020-02-21 23:32:49.811320746,2020-02-21,2020-02-21,2020-02-21,1.0,-6.84,-447.35,0.0,162.0,           ,1.0,1.0,160.0
482,Kulttuuri_viihde,2020-02-24 01:48:40.754716972,2020-02-24,2020-02-24,2020-02-24,1.0,-7.68,-455.03,0.0,162.0,           ,1.0,1.0,51.0
483,Ruoka_paivittaistavarakauppa,2020-02-25 21:16:58.867924520,2020-02-25,2020-02-25,2020-02-25,1.0,-1.18,-456.21,0.0,162.0,           ,1.0,1.0,95.0
484,Ruoka_paivittaistavarakauppa,2020-02-26 08:36:13.584905650,2020-02-26,2020-02-26,2020-02-26,1.0,-1.16,-457.37,0.0,162.0,           ,1.0,1.0,95.0
485,Tulot,2020-02-27 04:04:31.698113198,2020-02-27,2020-02-27,2020-02-27,1.0,745.8,288.43,0.0,506.0,           ,1.0,1.0,178.0
486,Kulttuuri_viihde,2020-02-27 06:20:22.641509424,2020-02-27,2020-02-27,2020-02-27,1.0,-0.74,287.69,0.0,162.0,           ,1.0,1.0,91.0
487,Ruoka_paivittaistavarakauppa,2020-02-28 10:52:04.528301876,2020-02-28,2020-02-28,2020-02-28,1.0,-16.94,270.75,0.0,162.0,           ,1.0,1.0,74.0
488,Tulot,2020-03-03 22:51:25.714285714,2020-03-03,2020-03-03,2020-03-03,1.0,47.68,318.43,701.0,520.0,           ,1.0,1.0,185.0
489,Asuminen,2020-03-06 21:42:51.428571428,2020-03-06,2020-03-06,2020-03-06,1.0,-19.14,299.29,706.0,147.0,OKOYFIHH   ,0.0,0.0,208.0
490,Muut,2020-03-09 20:34:17.142857142,2020-03-09,2020-03-09,2020-03-09,1.0,-144.15,155.14,706.0,147.0,OKOYFIHH   ,0.0,0.0,206.0
491,Muut,2020-03-11 19:25:42.857142856,2020-03-11,2020-03-11,2020-03-11,1.0,-11.34,143.8,706.0,147.0,OKOYFIHH   ,0.0,0.0,209.0
492,Ruoka_paivittaistavarakauppa,2020-03-16 18:17:08.571428570,2020-03-16,2020-03-16,2020-03-16,1.0,-6.04,137.76,0.0,162.0,           ,1.0,1.0,81.0
493,Liikkuminen,2020-03-18 17:08:34.285714284,2020-03-18,2020-03-18,2020-03-18,1.0,-6.27,131.49,0.0,162.0,           ,1.0,1.0,118.0
494,Ruoka_paivittaistavarakauppa,2020-03-23 14:51:25.714285712,2020-03-23,2020-03-23,2020-03-23,1.0,-4.86,126.63,0.0,162.0,           ,1.0,1.0,106.0
495,Ruoka_paivittaistavarakauppa,2020-03-24 15:59:59.999999998,2020-03-24,2020-03-24,2020-03-24,1.0,-4.01,122.62,0.0,162.0,           ,1.0,1.0,44.0
496,Harrastukset,2020-03-27 13:42:51.428571426,2020-03-27,2020-03-27,2020-03-27,1.0,-17.02,105.6,0.0,162.0,           ,1.0,1.0,100.0
497,Ruoka_paivittaistavarakauppa,2020-03-30 12:34:17.142857140,2020-03-30,2020-03-30,2020-03-30,1.0,-12.69,92.91,0.0,162.0,           ,1.0,1.0,97.0
498,Ravintolat_kahvilat,2020-04-02 20:54:11.612903224,2020-04-02,2020-04-02,2020-04-02,1.0,-19.74,73.17,0.0,162.0,           ,1.0,1.0,103.0
499,Ruoka_paivittaistavarakauppa,2020-04-02 22:27:05.806451612,2020-04-02,2020-04-02,2020-04-02,1.0,-29.8,43.37,0.0,162.0,           ,1.0,1.0,67.0
500,Muut,2020-04-06 19:21:17.419354836,2020-04-06,2020-04-06,2020-04-06,1.0,-43.09,0.28,0.0,105.0,OKOYFIHH   ,1.0,0.0,6.0
501,Ruoka_paivittaistavarakauppa,2020-04-08 17:48:23.225806448,2020-04-08,2020-04-08,2020-04-08,1.0,-0.96,-0.68,0.0,162.0,           ,1.0,1.0,103.0
502,Tulot,2020-04-10 16:15:29.032258060,2020-04-10,2020-04-10,2020-04-10,1.0,106.9,106.22,710.0,506.0,           ,1.0,1.0,217.0
503,Lemmikit,2020-04-13 13:09:40.645161284,2020-04-13,2020-04-13,2020-04-13,1.0,-5.85,100.37,0.0,162.0,           ,1.0,1.0,159.0
504,Hyvinvointi,2020-04-13 14:42:34.838709672,2020-04-13,2020-04-13,2020-04-13,1.0,-16.86,83.51,0.0,162.0,           ,1.0,1.0,101.0
505,Ruoka_paivittaistavarakauppa,2020-04-16 11:36:46.451612896,2020-04-16,2020-04-16,2020-04-16,1.0,-1.44,82.07,0.0,162.0,           ,1.0,1.0,125.0
506,Liikkuminen,2020-04-20 08:30:58.064516120,2020-04-20,2020-04-20,2020-04-20,1.0,-7.94,74.13,0.0,162.0,           ,1.0,1.0,99.0
507,Luokittelemattomat,2020-04-20 10:03:52.258064508,2020-04-20,2020-04-20,2020-04-20,1.0,-30.01,44.12,0.0,162.0,           ,1.0,1.0,128.0
508,Lemmikit,2020-04-24 05:25:09.677419344,2020-04-24,2020-04-24,2020-04-24,1.0,-27.06,17.06,0.0,162.0,           ,1.0,1.0,84.0
509,Ravintolat_kahvilat,2020-04-24 06:58:03.870967732,2020-04-24,2020-04-24,2020-04-24,1.0,-13.21,3.85,0.0,162.0,           ,1.0,1.0,90.0
510,Muut,2020-04-27 03:52:15.483870956,2020-04-27,2020-04-27,2020-04-27,1.0,-9.47,-5.62,0.0,163.0,           ,1.0,1.0,167.0
511,Muut,2020-04-28 02:19:21.290322568,2020-04-28,2020-04-28,2020-04-28,1.0,-6.31,-11.93,0.0,162.0,           ,1.0,1.0,94.0
512,Ruoka_paivittaistavarakauppa,2020-04-30 00:46:27.096774180,2020-04-30,2020-04-30,2020-04-30,1.0,-6.74,-18.67,0.0,162.0,           ,1.0,1.0,137.0
513,Ruoka_paivittaistavarakauppa,2020-05-01 09:04:00.000000000,2020-05-01,2020-05-01,2020-05-01,1.0,-1.24,-19.91,0.0,162.0,           ,1.0,1.0,106.0
514,Kulttuuri_viihde,2020-05-04 18:08:00.000000000,2020-05-04,2020-05-04,2020-05-04,1.0,-2.24,-22.15,0.0,162.0,           ,1.0,1.0,84.0
515,Ruoka_paivittaistavarakauppa,2020-05-05 03:12:00.000000000,2020-05-05,2020-05-05,2020-05-05,1.0,-11.9,-34.05,0.0,162.0,           ,1.0,1.0,94.0
516,Hyvinvointijakauneus,2020-05-06 12:16:00.000000000,2020-05-06,2020-05-06,2020-05-06,1.0,-5.76,-39.81,0.0,162.0,           ,1.0,1.0,121.0
517,Ruoka_paivittaistavarakauppa,2020-05-07 06:24:00.000000000,2020-05-07,2020-05-07,2020-05-07,1.0,-2.93,-42.74,0.0,162.0,           ,1.0,1.0,146.0
518,Ruoka_paivittaistavarakauppa,2020-05-07 21:20:00.000000000,2020-05-07,2020-05-07,2020-05-07,1.0,-6.72,-49.46,0.0,162.0,           ,1.0,1.0,124.0
519,Hyvinvointi,2020-05-11 15:28:00.000000000,2020-05-11,2020-05-11,2020-05-11,1.0,-11.08,-60.54,0.0,162.0,           ,1.0,1.0,103.0
520,Ruoka_paivittaistavarakauppa,2020-05-12 00:32:00.000000000,2020-05-12,2020-05-12,2020-05-12,1.0,-3.4,-63.94,0.0,162.0,           ,1.0,1.0,50.0
521,Ruoka_paivittaistavarakauppa,2020-05-13 09:36:00.000000000,2020-05-13,2020-05-13,2020-05-13,1.0,-3.08,-67.02,0.0,162.0,           ,1.0,1.0,158.0
522,Ruoka_paivittaistavarakauppa,2020-05-14 18:40:00.000000000,2020-05-14,2020-05-14,2020-05-14,1.0,-3.39,-70.41,0.0,162.0,           ,1.0,1.0,50.0
523,Tulot,2020-05-15 12:48:00.000000000,2020-05-15,2020-05-15,2020-05-15,1.0,-2.51,-72.92,0.0,162.0,           ,1.0,1.0,98.0
524,Liikkuminen,2020-05-18 03:44:00.000000000,2020-05-18,2020-05-18,2020-05-18,1.0,-48.47,-121.39,0.0,162.0,           ,1.0,1.0,122.0
525,Ruoka_paivittaistavarakauppa,2020-05-18 21:52:00.000000000,2020-05-18,2020-05-18,2020-05-18,1.0,-0.9,-122.29,0.0,162.0,           ,1.0,1.0,84.0
526,Ravintolat_kahvilat,2020-05-19 16:00:00.000000000,2020-05-19,2020-05-19,2020-05-19,1.0,-0.2,-122.49,0.0,103.0,           ,0.0,1.0,3.0
527,Muut,2020-05-20 06:56:00.000000000,2020-05-20,2020-05-20,2020-05-20,1.0,-3.04,-125.53,0.0,162.0,           ,1.0,1.0,127.0
528,Ruoka_paivittaistavarakauppa,2020-05-25 01:04:00.000000000,2020-05-25,2020-05-25,2020-05-25,1.0,-0.76,-126.29,0.0,162.0,           ,1.0,1.0,65.0
529,Ruoka_paivittaistavarakauppa,2020-05-25 10:08:00.000000000,2020-05-25,2020-05-25,2020-05-25,1.0,-1.33,-127.62,0.0,162.0,           ,1.0,1.0,108.0
530,Ruoka_paivittaistavarakauppa,2020-05-25 19:12:00.000000000,2020-05-25,2020-05-25,2020-05-25,1.0,-5.32,-132.94,0.0,162.0,           ,1.0,1.0,148.0
531,Muut,2020-05-27 04:16:00.000000000,2020-05-27,2020-05-27,2020-05-27,1.0,-39.21,-172.15,0.0,101.0,           ,1.0,1.0,1.0
532,Liikkuminen,2020-05-27 13:20:00.000000000,2020-05-27,2020-05-27,2020-05-27,1.0,-3.84,-175.99,0.0,162.0,           ,1.0,1.0,81.0
533,Luokittelemattomat,2020-05-29 07:28:00.000000000,2020-05-29,2020-05-29,2020-05-29,1.0,-6.04,-182.03,0.0,162.0,           ,1.0,1.0,117.0
534,Terveys,2020-05-29 22:24:00.000000000,2020-05-29,2020-05-29,2020-05-29,1.0,-7.27,-189.3,0.0,162.0,           ,1.0,1.0,93.0
535,Ravintolat_kahvilat,2020-06-02 00:24:24.406779661,2020-06-02,2020-06-02,2020-06-02,1.0,-0.23,-189.53,0.0,162.0,           ,1.0,1.0,115.0
536,Ravintolat_kahvilat,2020-06-03 00:48:48.813559322,2020-06-03,2020-06-03,2020-06-03,1.0,-7.41,-196.94,0.0,162.0,           ,1.0,1.0,34.0
537,Ruoka_paivittaistavarakauppa,2020-06-04 01:13:13.220338983,2020-06-04,2020-06-04,2020-06-04,1.0,-6.88,-203.82,0.0,162.0,           ,1.0,1.0,148.0
538,Ruoka_paivittaistavarakauppa,2020-06-05 01:37:37.627118644,2020-06-05,2020-06-05,2020-06-05,1.0,-4.74,-208.56,0.0,162.0,           ,1.0,1.0,110.0
539,Tulot,2020-06-05 02:02:02.033898305,2020-06-05,2020-06-05,2020-06-05,1.0,27.03,-181.53,710.0,505.0,           ,1.0,1.0,210.0
540,Ravintolat_kahvilat,2020-06-05 02:26:26.440677966,2020-06-05,2020-06-05,2020-06-05,1.0,-0.71,-182.24,0.0,162.0,           ,1.0,1.0,107.0
541,Ravintolat_kahvilat,2020-06-08 02:50:50.847457627,2020-06-08,2020-06-08,2020-06-08,1.0,-62.3,-244.54,0.0,171.0,           ,1.0,1.0,172.0
542,Asuminen,2020-06-09 03:15:15.254237288,2020-06-09,2020-06-09,2020-06-09,1.0,-1.48,-246.02,0.0,162.0,           ,1.0,1.0,100.0
543,Muut,2020-06-10 03:39:39.661016949,2020-06-10,2020-06-10,2020-06-10,1.0,-3.26,-249.28,0.0,105.0,OKOYFIHH   ,1.0,0.0,6.0
544,Lemmikit,2020-06-11 04:04:04.067796610,2020-06-11,2020-06-11,2020-06-11,1.0,-14.42,-263.7,0.0,162.0,           ,1.0,1.0,57.0
545,Tulot,2020-06-12 04:28:28.474576271,2020-06-12,2020-06-12,2020-06-12,1.0,117.6,-146.1,710.0,506.0,           ,1.0,1.0,214.0
546,Tulot,2020-06-12 04:52:52.881355932,2020-06-12,2020-06-12,2020-06-09,1.0,128.52,-17.58,710.0,506.0,           ,1.0,1.0,211.0
547,Terveys,2020-06-15 05:17:17.288135593,2020-06-15,2020-06-15,2020-06-15,1.0,-35.98,-53.56,706.0,106.0,NDEAFIHH   ,0.0,0.0,194.0
548,Luottojen_maksut,2020-06-15 05:41:41.694915254,2020-06-15,2020-06-15,2020-06-15,1.0,-8.54,-62.1,0.0,162.0,           ,1.0,1.0,86.0
549,Ruoka_paivittaistavarakauppa,2020-06-16 06:06:06.101694915,2020-06-16,2020-06-16,2020-06-16,1.0,-2.35,-64.45,0.0,162.0,           ,1.0,1.0,105.0
550,Ruoka_paivittaistavarakauppa,2020-06-18 06:30:30.508474576,2020-06-18,2020-06-18,2020-06-18,1.0,-2.06,-66.51,0.0,162.0,           ,1.0,1.0,65.0
551,Ravintolat_kahvilat,2020-06-18 06:54:54.915254237,2020-06-18,2020-06-18,2020-06-18,1.0,-0.5,-67.01,0.0,162.0,           ,1.0,1.0,136.0
552,Ruoka_paivittaistavarakauppa,2020-06-18 07:43:43.728813559,2020-06-18,2020-06-18,2020-06-18,1.0,-0.86,-67.87,0.0,162.0,           ,1.0,1.0,123.0
553,Ruoka_paivittaistavarakauppa,2020-06-19 07:19:19.322033898,2020-06-19,2020-06-19,2020-06-19,1.0,-10.65,-78.52,0.0,162.0,           ,1.0,1.0,137.0
554,Muut,2020-06-22 08:08:08.135593220,2020-06-22,2020-06-22,2020-06-22,1.0,-61.05,-139.57,0.0,163.0,           ,1.0,1.0,167.0
555,Ruoka_paivittaistavarakauppa,2020-06-22 08:32:32.542372881,2020-06-22,2020-06-22,2020-06-22,1.0,-0.69,-140.26,0.0,162.0,           ,1.0,1.0,68.0
556,Ruoka_paivittaistavarakauppa,2020-06-23 08:56:56.949152542,2020-06-23,2020-06-23,2020-06-23,1.0,-3.22,-143.48,0.0,162.0,           ,1.0,1.0,124.0
557,Ruoka_paivittaistavarakauppa,2020-06-24 09:21:21.355932203,2020-06-24,2020-06-24,2020-06-24,1.0,-22.6,-166.08,0.0,162.0,           ,1.0,1.0,47.0
558,Ruoka_paivittaistavarakauppa,2020-06-26 09:45:45.762711864,2020-06-26,2020-06-26,2020-06-26,1.0,-1.7,-167.78,0.0,162.0,           ,1.0,1.0,133.0
559,Tulot,2020-06-26 10:10:10.169491525,2020-06-26,2020-06-26,2020-06-26,1.0,24.05,-143.73,710.0,506.0,           ,1.0,1.0,213.0
560,Ruoka_paivittaistavarakauppa,2020-06-26 10:34:34.576271186,2020-06-26,2020-06-26,2020-06-26,1.0,-1.87,-145.6,0.0,162.0,           ,1.0,1.0,121.0
561,Liikkuminen,2020-06-29 10:58:58.983050847,2020-06-29,2020-06-29,2020-06-29,1.0,-3.33,-148.93,0.0,162.0,           ,1.0,1.0,68.0
562,Lapset,2020-06-29 11:23:23.389830508,2020-06-29,2020-06-29,2020-06-29,1.0,-3.67,-152.6,0.0,162.0,           ,1.0,1.0,80.0
563,Ruoka_paivittaistavarakauppa,2020-06-29 11:47:47.796610169,2020-06-29,2020-06-29,2020-06-29,1.0,-11.49,-164.09,0.0,162.0,           ,1.0,1.0,122.0
564,Ruoka_paivittaistavarakauppa,2020-07-02 10:36:16.744186046,2020-07-02,2020-07-02,2020-07-02,1.0,-7.86,-171.95,0.0,162.0,           ,1.0,1.0,35.0
565,Liikkuminen,2020-07-03 21:12:33.488372092,2020-07-03,2020-07-03,2020-07-03,1.0,-3.7,-175.65,0.0,162.0,           ,1.0,1.0,147.0
566,Ruoka_paivittaistavarakauppa,2020-07-06 07:48:50.232558138,2020-07-06,2020-07-06,2020-07-06,1.0,-8.4,-184.05,0.0,162.0,           ,1.0,1.0,65.0
567,Ruoka_paivittaistavarakauppa,2020-07-06 18:25:06.976744184,2020-07-06,2020-07-06,2020-07-06,1.0,-9.11,-193.16,0.0,162.0,           ,1.0,1.0,65.0
568,Ruoka_paivittaistavarakauppa,2020-07-08 05:01:23.720930230,2020-07-08,2020-07-08,2020-07-08,1.0,-1.95,-195.11,0.0,162.0,           ,1.0,1.0,78.0
569,Liikkuminen,2020-07-09 15:37:40.465116276,2020-07-09,2020-07-09,2020-07-09,1.0,-8.03,-203.14,0.0,162.0,           ,1.0,1.0,129.0
570,Luokittelemattomat,2020-07-10 02:13:57.209302322,2020-07-10,2020-07-10,2020-07-10,1.0,-1.87,-205.01,0.0,162.0,           ,1.0,1.0,104.0
571,Ruoka_paivittaistavarakauppa,2020-07-13 12:50:13.953488368,2020-07-09,2020-07-13,2020-07-13,1.0,-1.63,-206.64,0.0,162.0,           ,1.0,1.0,72.0
572,Liikkuminen,2020-07-13 23:26:30.697674414,2020-07-13,2020-07-13,2020-07-13,1.0,-3.61,-210.25,0.0,162.0,           ,1.0,1.0,70.0
573,Ravintolat_kahvilat,2020-07-15 10:02:47.441860460,2020-07-15,2020-07-15,2020-07-15,1.0,-4.55,-214.8,0.0,162.0,           ,1.0,1.0,129.0
574,Tulot,2020-07-17 07:15:20.930232552,2020-07-17,2020-07-17,2020-07-17,1.0,51.08,-163.72,710.0,505.0,           ,1.0,1.0,210.0
575,Ravintolat_kahvilat,2020-07-17 17:51:37.674418598,2020-07-17,2020-07-17,2020-07-17,1.0,-0.91,-164.63,0.0,162.0,           ,1.0,1.0,117.0
576,Liikkuminen,2020-07-17 20:39:04.186046506,2020-07-17,2020-07-17,2020-07-17,1.0,-24.39,-189.02,0.0,162.0,           ,1.0,1.0,100.0
577,Ruoka_paivittaistavarakauppa,2020-07-20 04:27:54.418604644,2020-07-20,2020-07-20,2020-07-20,1.0,-4.71,-193.73,0.0,162.0,           ,1.0,1.0,50.0
578,Ravintolat_kahvilat,2020-07-21 15:04:11.162790690,2020-07-21,2020-07-21,2020-07-21,1.0,-4.39,-198.12,0.0,162.0,           ,1.0,1.0,34.0
579,Ruoka_paivittaistavarakauppa,2020-07-24 01:40:27.906976736,2020-07-24,2020-07-24,2020-07-24,1.0,-8.95,-207.07,0.0,162.0,           ,1.0,1.0,57.0
580,Ruoka_paivittaistavarakauppa,2020-07-27 12:16:44.651162782,2020-07-27,2020-07-27,2020-07-27,1.0,-1.63,-208.7,0.0,162.0,           ,1.0,1.0,86.0
581,Asuminen,2020-07-27 22:53:01.395348828,2020-07-23,2020-07-27,2020-07-27,1.0,-97.59,-306.29,706.0,147.0,NDEAFIHH   ,0.0,0.0,207.0
582,Tulot,2020-07-28 09:29:18.139534874,2020-07-28,2020-07-28,2020-07-30,1.0,254.88,-51.41,0.0,505.0,           ,1.0,1.0,173.0
583,Tulot,2020-07-28 20:05:34.883720920,2020-07-28,2020-07-28,2020-07-28,1.0,31.67,-19.74,710.0,506.0,           ,1.0,1.0,214.0
584,Hyvinvointijakauneus,2020-07-30 06:41:51.627906966,2020-07-30,2020-07-31,2020-07-30,1.0,-9.85,-29.59,0.0,162.0,           ,1.0,1.0,106.0
585,Ravintolat_kahvilat,2020-08-03 08:30:22.784810124,2020-08-03,2020-08-03,2020-08-03,1.0,-1.09,-30.68,0.0,162.0,           ,1.0,1.0,148.0
586,Ruoka_paivittaistavarakauppa,2020-08-03 13:40:15.189873416,2020-08-03,2020-08-03,2020-08-03,1.0,-2.12,-32.8,0.0,162.0,           ,1.0,1.0,94.0
587,Ravintolat_kahvilat,2020-08-03 18:50:07.594936708,2020-08-03,2020-08-03,2020-08-03,1.0,-5.53,-38.33,0.0,162.0,           ,1.0,1.0,136.0
588,Ruoka_paivittaistavarakauppa,2020-08-04 03:20:30.379746832,2020-08-04,2020-08-04,2020-08-04,1.0,-2.87,-41.2,0.0,162.0,           ,1.0,1.0,85.0
589,Tulot,2020-08-04 22:10:37.974683540,2020-08-04,2020-08-04,2020-08-04,1.0,49.83,8.63,0.0,505.0,           ,1.0,1.0,173.0
590,Ruoka_paivittaistavarakauppa,2020-08-05 17:00:45.569620248,2020-08-05,2020-08-05,2020-08-05,1.0,-4.38,4.25,0.0,162.0,           ,1.0,1.0,154.0
591,Ruoka_paivittaistavarakauppa,2020-08-07 06:41:00.759493664,2020-08-07,2020-08-07,2020-08-07,1.0,-4.36,-0.11,0.0,162.0,           ,1.0,1.0,60.0
592,Ruoka_paivittaistavarakauppa,2020-08-07 11:50:53.164556956,2020-08-07,2020-08-07,2020-08-07,1.0,-8.9,-9.01,0.0,162.0,           ,1.0,1.0,104.0
593,Kulttuuri_viihde,2020-08-07 20:21:15.949367080,2020-08-07,2020-08-07,2020-08-07,1.0,-1.97,-10.98,0.0,162.0,           ,1.0,1.0,72.0
594,Ravintolat_kahvilat,2020-08-10 01:31:08.354430372,2020-08-10,2020-08-10,2020-08-10,1.0,-10.09,-21.07,0.0,162.0,           ,1.0,1.0,104.0
595,Ruoka_paivittaistavarakauppa,2020-08-10 10:01:31.139240496,2020-08-10,2020-08-12,2020-08-10,1.0,-8.93,-30.0,0.0,162.0,           ,1.0,1.0,80.0
596,Ruoka_paivittaistavarakauppa,2020-08-11 04:51:38.734177204,2020-08-11,2020-08-11,2020-08-11,1.0,-24.15,-54.15,0.0,162.0,           ,1.0,1.0,93.0
597,Ruoka_paivittaistavarakauppa,2020-08-11 15:11:23.544303788,2020-08-11,2020-08-11,2020-08-11,1.0,-5.72,-59.87,0.0,162.0,           ,1.0,1.0,85.0
598,Muut,2020-08-11 23:41:46.329113912,2020-08-11,2020-08-11,2020-08-11,1.0,-5.06,-64.93,0.0,162.0,           ,1.0,1.0,127.0
599,Ruoka_paivittaistavarakauppa,2020-08-12 03:02:16.708860744,2020-08-12,2020-08-12,2020-08-12,1.0,-4.21,-69.14,0.0,162.0,           ,1.0,1.0,44.0
600,Lapset,2020-08-12 13:22:01.518987328,2020-08-12,2020-08-12,2020-08-12,1.0,-2.96,-72.1,0.0,162.0,           ,1.0,1.0,105.0
601,Muut,2020-08-12 18:31:53.924050620,2020-08-12,2020-08-12,2020-08-12,1.0,-121.53,-193.63,0.0,101.0,           ,1.0,1.0,2.0
602,Ruoka_paivittaistavarakauppa,2020-08-14 08:12:09.113924036,2020-08-14,2020-08-14,2020-08-14,1.0,-5.69,-199.32,0.0,162.0,           ,1.0,1.0,80.0
603,Ruoka_paivittaistavarakauppa,2020-08-14 21:52:24.303797452,2020-08-14,2020-08-14,2020-08-14,1.0,-0.41,-199.73,0.0,162.0,           ,1.0,1.0,92.0
604,Tulot,2020-08-15 16:42:31.898734160,2020-08-15,2020-08-15,2020-08-15,1.0,291.55,91.82,0.0,505.0,           ,1.0,1.0,175.0
605,Ravintolat_kahvilat,2020-08-17 11:32:39.493670868,2020-08-17,2020-08-17,2020-08-17,1.0,-44.85,46.97,0.0,163.0,           ,1.0,1.0,167.0
606,Liikkuminen,2020-08-19 01:12:54.683544284,2020-08-19,2020-08-21,2020-08-19,1.0,-6.16,40.81,0.0,162.0,           ,1.0,1.0,99.0
607,Muut,2020-08-19 06:22:47.088607576,2020-08-19,2020-08-19,2020-08-19,1.0,-30.7,10.11,0.0,163.0,           ,1.0,1.0,168.0
608,Ruoka_paivittaistavarakauppa,2020-08-19 20:03:02.278480992,2020-08-19,2020-08-19,2020-08-19,1.0,-1.28,8.83,0.0,162.0,           ,1.0,1.0,43.0
609,Ruoka_paivittaistavarakauppa,2020-08-20 09:43:17.468354408,2020-08-20,2020-08-20,2020-08-20,1.0,-4.95,3.88,0.0,162.0,           ,1.0,1.0,65.0
610,Ravintolat_kahvilat,2020-08-20 14:53:09.873417700,2020-08-20,2020-08-20,2020-08-20,1.0,-1.56,2.32,0.0,162.0,           ,1.0,1.0,152.0
611,Ruoka_paivittaistavarakauppa,2020-08-21 04:33:25.063291116,2020-08-21,2020-08-21,2020-08-21,1.0,-6.67,-4.35,0.0,162.0,           ,1.0,1.0,52.0
612,Ruoka_paivittaistavarakauppa,2020-08-21 23:23:32.658227824,2020-08-21,2020-08-21,2020-08-21,1.0,-31.73,-36.08,0.0,162.0,           ,1.0,1.0,95.0
613,Tulot,2020-08-24 07:53:55.443037948,2020-08-24,2020-08-24,2020-08-24,1.0,120.18,84.1,0.0,505.0,           ,1.0,1.0,173.0
614,Ruoka_paivittaistavarakauppa,2020-08-24 13:03:47.848101240,2020-08-24,2020-08-25,2020-08-24,1.0,-8.86,75.24,0.0,162.0,           ,1.0,1.0,139.0
615,Liikkuminen,2020-08-24 18:13:40.253164532,2020-08-24,2020-08-24,2020-08-24,1.0,-23.68,51.56,0.0,162.0,           ,1.0,1.0,111.0
616,Luokittelemattomat,2020-08-26 02:44:03.037974656,2020-08-26,2020-08-26,2020-08-26,1.0,-5.6,45.96,0.0,162.0,           ,1.0,1.0,131.0
617,Asuminen,2020-08-27 16:24:18.227848072,2020-08-27,2020-08-27,2020-08-27,1.0,-19.19,26.77,0.0,162.0,           ,1.0,1.0,144.0
618,Ruoka_paivittaistavarakauppa,2020-08-27 21:34:10.632911364,2020-08-27,2020-08-27,2020-08-27,1.0,-12.89,13.88,0.0,162.0,           ,1.0,1.0,156.0
619,Ruoka_paivittaistavarakauppa,2020-08-28 06:04:33.417721488,2020-08-28,2020-08-28,2020-08-28,1.0,-2.85,11.03,0.0,162.0,           ,1.0,1.0,71.0
620,Luokittelemattomat,2020-08-28 11:14:25.822784780,2020-08-28,2020-08-28,2020-08-28,1.0,-1.51,9.52,0.0,162.0,           ,1.0,1.0,115.0
621,Ruoka_paivittaistavarakauppa,2020-08-31 00:54:41.012658196,2020-08-31,2020-08-31,2020-08-31,1.0,-5.66,3.86,0.0,162.0,           ,1.0,1.0,90.0
622,Lemmikit,2020-08-31 14:34:56.202531612,2020-08-31,2020-08-31,2020-08-31,1.0,-4.2,-0.34,0.0,162.0,           ,1.0,1.0,58.0
623,Ruoka_paivittaistavarakauppa,2020-08-31 19:44:48.607594904,2020-08-31,2020-08-31,2020-08-31,1.0,-3.34,-3.68,0.0,162.0,           ,1.0,1.0,34.0
624,Ruoka_paivittaistavarakauppa,2020-09-02 20:18:27.692307692,2020-09-02,2020-09-02,2020-09-02,1.0,-1.89,-5.57,0.0,162.0,           ,1.0,1.0,33.0
625,Lapset,2020-09-03 18:27:41.538461538,2020-09-03,2020-09-03,2020-09-03,1.0,-8.73,-14.3,0.0,162.0,           ,1.0,1.0,117.0
626,Ruoka_paivittaistavarakauppa,2020-09-03 22:09:13.846153846,2020-09-03,2020-09-03,2020-09-03,1.0,-8.8,-23.1,0.0,162.0,           ,1.0,1.0,86.0
627,Ruoka_paivittaistavarakauppa,2020-09-04 12:55:23.076923076,2020-09-04,2020-09-04,2020-09-04,1.0,-2.1,-25.2,0.0,162.0,           ,1.0,1.0,82.0
628,Lapset,2020-09-04 14:46:09.230769230,2020-09-04,2020-09-04,2020-09-04,1.0,-2.87,-28.07,0.0,162.0,           ,1.0,1.0,54.0
629,Ruoka_paivittaistavarakauppa,2020-09-04 16:36:55.384615384,2020-09-04,2020-09-04,2020-09-04,1.0,-1.67,-29.74,0.0,162.0,           ,1.0,1.0,81.0
630,Ruoka_paivittaistavarakauppa,2020-09-07 07:23:04.615384614,2020-09-07,2020-09-07,2020-09-07,1.0,-27.19,-56.93,0.0,162.0,           ,1.0,1.0,117.0
631,Hyvinvointijakauneus,2020-09-07 11:04:36.923076922,2020-09-07,2020-09-07,2020-09-07,1.0,-3.51,-60.44,0.0,162.0,           ,1.0,1.0,133.0
632,Saastot_sijoitukset,2020-09-08 09:13:50.769230768,2020-09-08,2020-09-08,2020-09-08,1.0,-8.35,-68.79,0.0,162.0,           ,1.0,1.0,106.0
633,Ruoka_paivittaistavarakauppa,2020-09-11 01:50:46.153846152,2020-09-11,2020-09-11,2020-09-11,1.0,-4.5,-73.29,0.0,162.0,           ,1.0,1.0,74.0
634,Ruoka_paivittaistavarakauppa,2020-09-11 03:41:32.307692306,2020-09-11,2020-09-11,2020-09-11,1.0,-3.79,-77.08,0.0,162.0,           ,1.0,1.0,101.0
635,Liikkuminen,2020-09-11 05:32:18.461538460,2020-09-11,2020-09-11,2020-09-11,1.0,-25.36,-102.44,0.0,162.0,           ,1.0,1.0,106.0
636,Ruoka_paivittaistavarakauppa,2020-09-11 23:59:59.999999998,2020-09-11,2020-09-11,2020-09-11,1.0,-4.14,-106.58,0.0,162.0,           ,1.0,1.0,44.0
637,Muut,2020-09-14 20:18:27.692307690,2020-09-14,2020-09-14,2020-09-14,1.0,-34.03,-140.61,0.0,162.0,           ,1.0,1.0,123.0
638,Ruoka_paivittaistavarakauppa,2020-09-14 22:09:13.846153844,2020-09-14,2020-09-14,2020-09-14,1.0,-0.65,-141.26,0.0,162.0,           ,1.0,1.0,95.0
639,Ruoka_paivittaistavarakauppa,2020-09-15 18:27:41.538461536,2020-09-15,2020-09-17,2020-09-15,1.0,-2.29,-143.55,0.0,162.0,           ,1.0,1.0,95.0
640,Ravintolat_kahvilat,2020-09-16 16:36:55.384615382,2020-09-16,2020-09-16,2020-09-16,1.0,-2.06,-145.61,0.0,162.0,           ,1.0,1.0,158.0
641,Tulot,2020-09-18 11:04:36.923076920,2020-09-18,2020-09-18,2020-09-18,1.0,51.67,-93.94,710.0,506.0,           ,1.0,1.0,215.0
642,Liikkuminen,2020-09-18 12:55:23.076923074,2020-09-18,2020-09-18,2020-09-18,1.0,-16.85,-110.79,0.0,162.0,           ,1.0,1.0,68.0
643,Kulttuuri_viihde,2020-09-18 14:46:09.230769228,2020-09-18,2020-09-18,2020-09-18,1.0,-15.34,-126.13,0.0,162.0,           ,1.0,1.0,72.0
644,Ruoka_paivittaistavarakauppa,2020-09-21 07:23:04.615384612,2020-09-21,2020-09-21,2020-09-21,1.0,-6.42,-132.55,0.0,162.0,           ,1.0,1.0,101.0
645,Ravintolat_kahvilat,2020-09-21 09:13:50.769230766,2020-09-21,2020-09-21,2020-09-21,1.0,-3.29,-135.84,0.0,162.0,           ,1.0,1.0,90.0
646,Muut,2020-09-22 03:41:32.307692304,2020-09-22,2020-09-22,2020-09-22,1.0,-3.21,-139.05,0.0,105.0,OKOYFIHH   ,1.0,0.0,5.0
647,Muut,2020-09-22 05:32:18.461538458,2020-09-22,2020-09-22,2020-09-22,1.0,-15.39,-154.44,0.0,163.0,           ,1.0,1.0,168.0
648,Tulot,2020-09-23 22:09:13.846153842,2020-09-23,2020-09-23,2020-09-23,1.0,92.55,-61.89,710.0,506.0,           ,1.0,1.0,218.0
649,Ruoka_paivittaistavarakauppa,2020-09-24 01:50:46.153846150,2020-09-24,2020-09-24,2020-09-24,1.0,-9.43,-71.32,0.0,162.0,           ,1.0,1.0,50.0
650,Harrastukset,2020-09-25 18:27:41.538461534,2020-09-25,2020-09-25,2020-09-25,1.0,-16.54,-87.86,706.0,129.0,NDEAFIHH   ,0.0,0.0,199.0
651,Ravintolat_kahvilat,2020-09-25 23:59:59.999999996,2020-09-25,2020-09-25,2020-09-25,1.0,-4.94,-92.8,0.0,162.0,           ,1.0,1.0,86.0
652,Ravintolat_kahvilat,2020-09-28 16:36:55.384615380,2020-09-28,2020-09-28,2020-09-28,1.0,-1.92,-94.72,0.0,162.0,           ,1.0,1.0,33.0
653,Saastot_sijoitukset,2020-09-28 20:18:27.692307688,2020-09-28,2020-09-28,2020-09-28,1.0,-8.57,-103.29,0.0,162.0,           ,1.0,1.0,118.0
654,Kulttuuri_viihde,2020-09-29 12:55:23.076923072,2020-09-29,2020-09-29,2020-09-29,1.0,-33.08,-136.37,0.0,162.0,           ,1.0,1.0,33.0
655,Luokittelemattomat,2020-09-29 14:46:09.230769226,2020-09-29,2020-09-29,2020-09-29,1.0,-2.02,-138.39,0.0,162.0,           ,1.0,1.0,87.0
656,Shoppailu,2020-10-01 06:33:18.237885462,2020-10-01,2020-10-01,2020-10-01,1.0,-23.78,-162.17,0.0,162.0,           ,1.0,1.0,123.0
657,Ruoka_paivittaistavarakauppa,2020-10-02 02:13:12.951541848,2020-10-02,2020-10-02,2020-10-02,1.0,-0.17,-162.34,0.0,162.0,           ,1.0,1.0,148.0
658,Liikkuminen,2020-10-02 08:46:31.189427310,2020-10-02,2020-10-02,2020-10-02,1.0,-4.68,-167.02,0.0,162.0,           ,1.0,1.0,86.0
659,Hyvinvointijakauneus,2020-10-02 13:06:36.475770924,2020-10-02,2020-10-02,2020-10-02,1.0,-3.28,-170.3,0.0,162.0,           ,1.0,1.0,127.0
660,Ruoka_paivittaistavarakauppa,2020-10-02 15:19:49.427312772,2020-10-02,2020-10-02,2020-10-02,1.0,-11.21,-181.51,0.0,162.0,           ,1.0,1.0,65.0
661,Asuminen,2020-10-02 17:33:02.378854620,2020-10-02,2020-10-02,2020-10-02,1.0,-25.42,-206.93,706.0,129.0,OKOYFIHH   ,0.0,0.0,199.0
662,Ravintolat_kahvilat,2020-10-02 19:39:54.713656386,2020-10-02,2020-10-02,2020-10-02,1.0,-8.12,-215.05,0.0,162.0,           ,1.0,1.0,137.0
663,Ruoka_paivittaistavarakauppa,2020-10-02 21:53:07.665198234,2020-10-02,2020-10-02,2020-10-02,1.0,-8.25,-223.3,0.0,162.0,           ,1.0,1.0,91.0
664,Muut,2020-10-03 04:26:25.903083696,2020-10-03,2020-10-03,2020-10-03,1.0,-34.23,-257.53,0.0,163.0,           ,1.0,1.0,167.0
665,Ravintolat_kahvilat,2020-10-05 00:06:20.616740082,2020-10-05,2020-10-05,2020-10-05,1.0,-1.68,-259.21,0.0,162.0,           ,1.0,1.0,158.0
666,Ruoka_paivittaistavarakauppa,2020-10-05 02:19:33.568281930,2020-10-05,2020-10-05,2020-10-05,1.0,-20.68,-279.89,0.0,162.0,           ,1.0,1.0,115.0
667,Hyvinvointijakauneus,2020-10-05 06:39:38.854625544,2020-10-05,2020-10-05,2020-10-05,1.0,-2.61,-282.5,0.0,162.0,           ,1.0,1.0,148.0
668,Ruoka_paivittaistavarakauppa,2020-10-05 08:52:51.806167392,2020-10-05,2020-10-05,2020-10-05,1.0,-3.39,-285.89,0.0,162.0,           ,1.0,1.0,95.0
669,Ruoka_paivittaistavarakauppa,2020-10-05 10:59:44.140969158,2020-10-05,2020-10-05,2020-10-05,1.0,-4.17,-290.06,0.0,162.0,           ,1.0,1.0,125.0
670,Kulttuuri_viihde,2020-10-05 11:06:04.757709240,2020-10-05,2020-10-05,2020-10-05,1.0,-2.94,-293.0,0.0,162.0,           ,1.0,1.0,35.0
671,Lapset,2020-10-05 13:12:57.092511006,2020-10-05,2020-10-05,2020-10-05,1.0,-30.96,-323.96,0.0,162.0,           ,1.0,1.0,144.0
672,Ruoka_paivittaistavarakauppa,2020-10-05 15:26:10.044052854,2020-10-05,2020-10-05,2020-10-05,1.0,-1.02,-324.98,0.0,162.0,           ,1.0,1.0,34.0
673,Asuminen,2020-10-05 19:46:15.330396468,2020-10-05,2020-10-05,2020-10-05,1.0,-28.28,-353.26,706.0,129.0,OKOYFIHH   ,0.0,0.0,198.0
674,Kulttuuri_viihde,2020-10-05 21:59:28.281938316,2020-10-05,2020-10-05,2020-10-05,1.0,-5.4,-358.66,0.0,162.0,           ,1.0,1.0,162.0
675,Liikkuminen,2020-10-06 04:32:46.519823778,2020-10-06,2020-10-06,2020-10-06,1.0,-1.97,-360.63,0.0,162.0,           ,1.0,1.0,110.0
676,Vakuutukset,2020-10-06 17:39:22.995594702,2020-10-06,2020-10-08,2020-10-06,1.0,-22.39,-383.02,706.0,129.0,OKOYFIHH   ,0.0,0.0,205.0
677,Ruoka_paivittaistavarakauppa,2020-10-06 19:52:35.947136550,2020-10-06,2020-10-06,2020-10-06,1.0,-0.66,-383.68,0.0,162.0,           ,1.0,1.0,132.0
678,Matkailu,2020-10-07 00:12:41.233480164,2020-10-07,2020-10-07,2020-10-07,1.0,-4.8,-388.48,0.0,162.0,           ,1.0,1.0,133.0
679,Matkailu,2020-10-07 02:25:54.185022012,2020-10-07,2020-10-07,2020-10-07,1.0,-19.86,-408.34,0.0,162.0,           ,1.0,1.0,72.0
680,Ruoka_paivittaistavarakauppa,2020-10-07 06:45:59.471365626,2020-10-07,2020-10-07,2020-10-07,1.0,-3.36,-411.7,0.0,162.0,           ,1.0,1.0,103.0
681,Tulot,2020-10-08 00:19:01.850220246,2020-10-08,2020-10-08,2020-10-08,1.0,24.65,-387.05,710.0,506.0,           ,1.0,1.0,211.0
682,Ruoka_paivittaistavarakauppa,2020-10-08 08:59:12.422907474,2020-10-08,2020-10-08,2020-10-08,1.0,-32.31,-419.36,0.0,162.0,           ,1.0,1.0,90.0
683,Ruoka_paivittaistavarakauppa,2020-10-08 13:19:17.709251088,2020-10-08,2020-10-08,2020-10-08,1.0,-4.32,-423.68,0.0,162.0,           ,1.0,1.0,55.0
684,Ruoka_paivittaistavarakauppa,2020-10-08 15:32:30.660792936,2020-10-08,2020-10-08,2020-10-08,1.0,-3.57,-427.25,0.0,162.0,           ,1.0,1.0,146.0
685,Luottojen_maksut,2020-10-08 22:05:48.898678398,2020-10-08,2020-10-08,2020-10-08,1.0,-191.22,-618.47,0.0,100.0,           ,1.0,1.0,0.0
686,Tulot,2020-10-09 04:39:07.136563860,2020-10-09,2020-10-09,2020-10-09,1.0,74.71,-543.76,0.0,505.0,           ,1.0,1.0,174.0
687,Saastot_sijoitukset,2020-10-09 06:52:20.088105708,2020-10-09,2020-10-09,2020-10-09,1.0,-2.84,-546.6,0.0,162.0,           ,1.0,1.0,121.0
688,Ruoka_paivittaistavarakauppa,2020-10-09 09:05:33.039647556,2020-10-09,2020-10-09,2020-10-09,1.0,-24.16,-570.76,0.0,162.0,           ,1.0,1.0,86.0
689,Ravintolat_kahvilat,2020-10-09 11:12:25.374449322,2020-10-09,2020-10-09,2020-10-09,1.0,-4.53,-575.29,0.0,162.0,           ,1.0,1.0,109.0
690,Muut,2020-10-09 17:45:43.612334784,2020-10-09,2020-10-09,2020-10-09,1.0,-2.85,-578.14,0.0,162.0,           ,1.0,1.0,98.0
691,Matkailu,2020-10-11 02:32:14.801762094,2020-10-11,2020-10-11,2020-10-11,1.0,-14.56,-592.7,0.0,163.0,           ,1.0,1.0,167.0
692,Ruoka_paivittaistavarakauppa,2020-10-12 04:45:27.753303942,2020-10-12,2020-10-12,2020-10-12,1.0,-7.3,-600.0,0.0,162.0,           ,1.0,1.0,140.0
693,Ruoka_paivittaistavarakauppa,2020-10-12 11:18:45.991189404,2020-10-12,2020-10-12,2020-10-14,1.0,-0.41,-600.41,0.0,162.0,           ,1.0,1.0,95.0
694,Liikkuminen,2020-10-12 13:25:38.325991170,2020-10-12,2020-10-12,2020-10-12,1.0,-3.56,-603.97,0.0,162.0,           ,1.0,1.0,129.0
695,Muut,2020-10-12 15:38:51.277533018,2020-10-12,2020-10-12,2020-10-12,1.0,-1.93,-605.9,0.0,162.0,           ,1.0,1.0,101.0
696,Liikkuminen,2020-10-12 17:52:04.229074866,2020-10-12,2020-10-12,2020-10-12,1.0,-1.39,-607.29,0.0,162.0,           ,1.0,1.0,45.0
697,Saastot_sijoitukset,2020-10-12 19:58:56.563876632,2020-10-12,2020-10-12,2020-10-12,1.0,-6.26,-613.55,0.0,162.0,           ,1.0,1.0,33.0
698,Ravintolat_kahvilat,2020-10-12 20:05:17.180616714,2020-10-12,2020-10-14,2020-10-12,1.0,-5.5,-619.05,0.0,162.0,           ,1.0,1.0,39.0
699,Luokittelemattomat,2020-10-12 22:12:09.515418480,2020-10-12,2020-10-12,2020-10-12,1.0,-4.32,-623.37,0.0,162.0,           ,1.0,1.0,41.0
700,Ruoka_paivittaistavarakauppa,2020-10-13 00:25:22.466960328,2020-10-13,2020-10-13,2020-10-13,1.0,-5.71,-629.08,0.0,162.0,           ,1.0,1.0,87.0
701,Ruoka_paivittaistavarakauppa,2020-10-13 09:11:53.656387638,2020-10-13,2020-10-15,2020-10-13,1.0,-4.34,-633.42,0.0,162.0,           ,1.0,1.0,146.0
702,Ruoka_paivittaistavarakauppa,2020-10-13 15:45:11.894273100,2020-10-13,2020-10-13,2020-10-13,1.0,-0.82,-634.24,0.0,162.0,           ,1.0,1.0,80.0
703,Lemmikit,2020-10-13 22:18:30.132158562,2020-10-13,2020-10-13,2020-10-13,1.0,-7.39,-641.63,0.0,162.0,           ,1.0,1.0,74.0
704,Ruoka_paivittaistavarakauppa,2020-10-14 06:58:40.704845790,2020-10-14,2020-10-15,2020-10-14,1.0,-2.83,-644.46,0.0,162.0,           ,1.0,1.0,91.0
705,Ravintolat_kahvilat,2020-10-14 07:05:01.321585872,2020-10-14,2020-10-14,2020-10-14,1.0,-4.75,-649.21,0.0,162.0,           ,1.0,1.0,141.0
706,Ruoka_paivittaistavarakauppa,2020-10-14 17:58:24.845814948,2020-10-14,2020-10-14,2020-10-14,1.0,-4.14,-653.35,0.0,162.0,           ,1.0,1.0,88.0
707,Ruoka_paivittaistavarakauppa,2020-10-15 02:38:35.418502176,2020-10-15,2020-10-15,2020-10-15,1.0,-5.46,-658.81,0.0,162.0,           ,1.0,1.0,124.0
708,Ruoka_paivittaistavarakauppa,2020-10-15 04:51:48.370044024,2020-10-15,2020-10-15,2020-10-12,1.0,-11.8,-670.61,0.0,162.0,           ,1.0,1.0,74.0
709,Ruoka_paivittaistavarakauppa,2020-10-15 13:31:58.942731252,2020-10-15,2020-10-15,2020-10-15,1.0,-6.11,-676.72,0.0,162.0,           ,1.0,1.0,127.0
710,Liikkuminen,2020-10-15 13:38:19.559471334,2020-10-15,2020-10-15,2020-10-15,1.0,-30.57,-707.29,0.0,162.0,           ,1.0,1.0,39.0
711,Ravintolat_kahvilat,2020-10-16 00:31:43.083700410,2020-10-16,2020-10-16,2020-10-16,1.0,-1.23,-708.52,0.0,162.0,           ,1.0,1.0,131.0
712,Ruoka_paivittaistavarakauppa,2020-10-16 11:25:06.607929486,2020-10-16,2020-10-16,2020-10-16,1.0,-2.74,-711.26,0.0,162.0,           ,1.0,1.0,75.0
713,Kulttuuri_viihde,2020-10-16 15:51:32.511013182,2020-10-16,2020-10-16,2020-10-16,1.0,-17.23,-728.49,0.0,162.0,           ,1.0,1.0,76.0
714,Ruoka_paivittaistavarakauppa,2020-10-16 20:11:37.797356796,2020-10-16,2020-10-16,2020-10-16,1.0,-1.45,-729.94,0.0,162.0,           ,1.0,1.0,80.0
715,Ruoka_paivittaistavarakauppa,2020-10-19 00:38:03.700440492,2020-10-19,2020-10-19,2020-10-19,1.0,-5.66,-735.6,0.0,162.0,           ,1.0,1.0,105.0
716,Ruoka_paivittaistavarakauppa,2020-10-19 02:44:56.035242258,2020-10-19,2020-10-19,2020-10-19,1.0,-8.42,-744.02,0.0,162.0,           ,1.0,1.0,158.0
717,Ruoka_paivittaistavarakauppa,2020-10-19 04:58:08.986784106,2020-10-19,2020-10-19,2020-10-19,1.0,-1.08,-745.1,0.0,162.0,           ,1.0,1.0,74.0
718,Ruoka_paivittaistavarakauppa,2020-10-19 07:11:21.938325954,2020-10-19,2020-10-19,2020-10-19,1.0,-20.6,-765.7,0.0,162.0,           ,1.0,1.0,129.0
719,Ruoka_paivittaistavarakauppa,2020-10-19 09:18:14.273127720,2020-10-19,2020-10-19,2020-10-19,1.0,-5.16,-770.86,0.0,162.0,           ,1.0,1.0,148.0
720,Ruoka_paivittaistavarakauppa,2020-10-19 11:31:27.224669568,2020-10-19,2020-10-19,2020-10-19,1.0,-26.36,-797.22,0.0,162.0,           ,1.0,1.0,158.0
721,Ruoka_paivittaistavarakauppa,2020-10-19 11:37:47.841409650,2020-10-19,2020-10-19,2020-10-19,1.0,-2.98,-800.2,0.0,162.0,           ,1.0,1.0,106.0
722,Ruoka_paivittaistavarakauppa,2020-10-19 13:44:40.176211416,2020-10-19,2020-10-22,2020-10-19,1.0,-5.66,-805.86,0.0,162.0,           ,1.0,1.0,123.0
723,Hyvinvointijakauneus,2020-10-19 18:04:45.462555030,2020-10-19,2020-10-19,2020-10-19,1.0,-12.77,-818.63,0.0,162.0,           ,1.0,1.0,50.0
724,Ruoka_paivittaistavarakauppa,2020-10-19 20:17:58.414096878,2020-10-19,2020-10-19,2020-10-19,1.0,-1.49,-820.12,0.0,162.0,           ,1.0,1.0,126.0
725,Ruoka_paivittaistavarakauppa,2020-10-19 22:24:50.748898644,2020-10-19,2020-10-19,2020-10-19,1.0,-2.76,-822.88,0.0,162.0,           ,1.0,1.0,86.0
726,Ravintolat_kahvilat,2020-10-20 02:51:16.651982340,2020-10-20,2020-10-20,2020-10-20,1.0,-1.98,-824.86,0.0,162.0,           ,1.0,1.0,94.0
727,Ruoka_paivittaistavarakauppa,2020-10-20 09:24:34.889867802,2020-10-20,2020-10-22,2020-10-20,1.0,-5.42,-830.28,0.0,162.0,           ,1.0,1.0,80.0
728,Tulot,2020-10-20 15:57:53.127753264,2020-10-20,2020-10-20,2020-10-20,1.0,36.34,-793.94,0.0,505.0,           ,1.0,1.0,173.0
729,Ruoka_paivittaistavarakauppa,2020-10-20 18:11:06.079295112,2020-10-20,2020-10-20,2020-10-20,1.0,-0.42,-794.36,0.0,162.0,           ,1.0,1.0,164.0
730,Ruoka_paivittaistavarakauppa,2020-10-20 22:31:11.365638726,2020-10-20,2020-10-20,2020-10-20,1.0,-1.82,-796.18,0.0,162.0,           ,1.0,1.0,90.0
731,Luokittelemattomat,2020-10-21 05:04:29.603524188,2020-10-21,2020-10-21,2020-10-21,1.0,-1.25,-797.43,0.0,162.0,           ,1.0,1.0,55.0
732,Ravintolat_kahvilat,2020-10-22 22:37:31.982378808,2020-10-22,2020-10-23,2020-10-22,1.0,-3.29,-800.72,0.0,162.0,           ,1.0,1.0,38.0
733,Ruoka_paivittaistavarakauppa,2020-10-23 00:44:24.317180574,2020-10-23,2020-10-23,2020-10-23,1.0,-2.38,-803.1,0.0,162.0,           ,1.0,1.0,114.0
734,Ruoka_paivittaistavarakauppa,2020-10-23 02:57:37.268722422,2020-10-23,2020-10-23,2020-10-23,1.0,-8.05,-811.15,0.0,162.0,           ,1.0,1.0,133.0
735,Ruoka_paivittaistavarakauppa,2020-10-23 07:17:42.555066036,2020-10-23,2020-10-23,2020-10-23,1.0,-9.34,-820.49,0.0,162.0,           ,1.0,1.0,146.0
736,Ruoka_paivittaistavarakauppa,2020-10-23 09:30:55.506607884,2020-10-23,2020-10-23,2020-10-23,1.0,-2.0,-822.49,0.0,162.0,           ,1.0,1.0,80.0
737,Liikkuminen,2020-10-23 11:44:08.458149732,2020-10-23,2020-10-23,2020-10-23,1.0,-40.99,-863.48,0.0,162.0,           ,1.0,1.0,49.0
738,Ruoka_paivittaistavarakauppa,2020-10-23 13:51:00.792951498,2020-10-23,2020-10-23,2020-10-23,1.0,-0.8,-864.28,0.0,162.0,           ,1.0,1.0,89.0
739,Tulot,2020-10-23 16:04:13.744493346,2020-10-23,2020-10-23,2020-10-22,1.0,300.95,-563.33,0.0,505.0,OKOYFIHH   ,1.0,0.0,176.0
740,Tulot,2020-10-23 18:17:26.696035194,2020-10-23,2020-10-23,2020-10-23,1.0,619.4,56.07,701.0,506.0,           ,1.0,1.0,181.0
741,Ruoka_paivittaistavarakauppa,2020-10-23 20:24:19.030836960,2020-10-23,2020-10-23,2020-10-23,1.0,-3.03,53.04,0.0,162.0,           ,1.0,1.0,121.0
742,Tulot,2020-10-24 05:10:50.220264270,2020-10-24,2020-10-24,2020-10-24,1.0,225.63,278.67,0.0,505.0,           ,1.0,1.0,176.0
743,Kulttuuri_viihde,2020-10-26 00:50:44.933920656,2020-10-26,2020-10-26,2020-10-26,1.0,-6.97,271.7,0.0,162.0,           ,1.0,1.0,33.0
744,Luokittelemattomat,2020-10-26 03:03:57.885462504,2020-10-26,2020-10-26,2020-10-26,1.0,-7.48,264.22,0.0,162.0,           ,1.0,1.0,42.0
745,Ravintolat_kahvilat,2020-10-26 07:24:03.171806118,2020-10-26,2020-10-26,2020-10-26,1.0,-6.19,258.03,0.0,162.0,           ,1.0,1.0,38.0
746,Ruoka_paivittaistavarakauppa,2020-10-26 09:37:16.123347966,2020-10-26,2020-10-26,2020-10-26,1.0,-14.11,243.92,0.0,162.0,           ,1.0,1.0,63.0
747,Ravintolat_kahvilat,2020-10-26 13:57:21.409691580,2020-10-26,2020-10-26,2020-10-26,1.0,-9.95,233.97,0.0,162.0,           ,1.0,1.0,109.0
748,Ruoka_paivittaistavarakauppa,2020-10-26 14:03:42.026431662,2020-10-26,2020-10-26,2020-10-26,1.0,-3.33,230.64,0.0,162.0,           ,1.0,1.0,36.0
749,Ruoka_paivittaistavarakauppa,2020-10-26 16:10:34.361233428,2020-10-26,2020-10-26,2020-10-26,1.0,-5.97,224.67,0.0,162.0,           ,1.0,1.0,85.0
750,Ruoka_paivittaistavarakauppa,2020-10-26 20:30:39.647577042,2020-10-26,2020-10-26,2020-10-26,1.0,-36.62,188.05,0.0,162.0,           ,1.0,1.0,59.0
751,Ruoka_paivittaistavarakauppa,2020-10-26 22:43:52.599118890,2020-10-26,2020-10-26,2020-10-26,1.0,-9.87,178.18,0.0,162.0,           ,1.0,1.0,92.0
752,Liikkuminen,2020-10-27 05:17:10.837004352,2020-10-27,2020-10-27,2020-10-27,1.0,-23.69,154.49,0.0,162.0,           ,1.0,1.0,93.0
753,Liikkuminen,2020-10-27 07:30:23.788546200,2020-10-27,2020-10-27,2020-10-27,1.0,-26.75,127.74,0.0,162.0,           ,1.0,1.0,120.0
754,Hyvinvointijakauneus,2020-10-27 11:50:29.074889814,2020-10-27,2020-10-27,2020-10-27,1.0,-3.24,124.5,0.0,162.0,           ,1.0,1.0,55.0
755,Ruoka_paivittaistavarakauppa,2020-10-27 11:56:49.691629896,2020-10-27,2020-10-27,2020-10-27,1.0,-20.18,104.32,0.0,162.0,           ,1.0,1.0,94.0
756,Muut,2020-10-28 00:57:05.550660738,2020-10-28,2020-10-29,2020-10-28,1.0,-7.48,96.84,0.0,162.0,           ,1.0,1.0,62.0
757,Ravintolat_kahvilat,2020-10-28 03:10:18.502202586,2020-10-28,2020-10-28,2020-10-28,1.0,-6.92,89.92,0.0,162.0,           ,1.0,1.0,79.0
758,Ruoka_paivittaistavarakauppa,2020-10-28 22:50:13.215858972,2020-10-28,2020-10-28,2020-10-28,1.0,-1.32,88.6,0.0,162.0,           ,1.0,1.0,100.0
759,Ruoka_paivittaistavarakauppa,2020-10-29 05:23:31.453744434,2020-10-29,2020-10-29,2020-10-29,1.0,-10.71,77.89,0.0,162.0,           ,1.0,1.0,140.0
760,Ravintolat_kahvilat,2020-10-29 16:16:54.977973510,2020-10-29,2020-10-29,2020-10-29,1.0,-5.41,72.48,0.0,162.0,           ,1.0,1.0,44.0
761,Tulot,2020-10-29 18:23:47.312775276,2020-10-29,2020-10-29,2020-10-29,1.0,135.22,207.7,0.0,505.0,           ,1.0,1.0,173.0
762,Ravintolat_kahvilat,2020-10-29 20:37:00.264317124,2020-10-29,2020-10-30,2020-10-29,1.0,-2.43,205.27,0.0,162.0,           ,1.0,1.0,35.0
763,Ruoka_paivittaistavarakauppa,2020-10-30 01:03:26.167400820,2020-10-30,2020-10-30,2020-10-30,1.0,-46.62,158.65,0.0,162.0,           ,1.0,1.0,154.0
764,Ravintolat_kahvilat,2020-10-30 07:36:44.405286282,2020-10-30,2020-10-30,2020-10-30,1.0,-22.24,136.41,0.0,162.0,           ,1.0,1.0,103.0
765,Ruoka_paivittaistavarakauppa,2020-10-30 09:43:36.740088048,2020-10-30,2020-10-30,2020-10-30,1.0,-51.5,84.91,0.0,162.0,           ,1.0,1.0,158.0
766,Ruoka_paivittaistavarakauppa,2020-10-30 14:10:02.643171744,2020-10-30,2020-10-30,2020-10-30,1.0,-32.19,52.72,0.0,162.0,           ,1.0,1.0,80.0
767,Ruoka_paivittaistavarakauppa,2020-10-30 18:30:07.929515358,2020-10-30,2020-10-30,2020-10-30,1.0,-7.09,45.63,0.0,162.0,           ,1.0,1.0,124.0
768,Luokittelemattomat,2020-10-30 20:43:20.881057206,2020-10-30,2020-10-30,2020-10-30,1.0,-96.09,-50.46,702.0,106.0,           ,1.0,1.0,188.0
769,Ravintolat_kahvilat,2020-11-02 11:42:08.925619833,2020-11-02,2020-11-02,2020-11-02,1.0,-7.11,-57.57,0.0,162.0,           ,1.0,1.0,55.0
770,Tulot,2020-11-02 11:54:02.975206611,2020-11-02,2020-11-02,2020-11-02,1.0,17.59,-39.98,710.0,570.0,           ,1.0,1.0,220.0
771,Ruoka_paivittaistavarakauppa,2020-11-02 23:36:11.900826444,2020-11-02,2020-11-02,2020-11-02,1.0,-1.58,-41.56,0.0,162.0,           ,1.0,1.0,118.0
772,Ruoka_paivittaistavarakauppa,2020-11-02 23:48:05.950413222,2020-11-02,2020-11-02,2020-11-02,1.0,-9.48,-51.04,0.0,162.0,           ,1.0,1.0,84.0
773,Liikkuminen,2020-11-03 11:30:14.876033055,2020-11-03,2020-11-03,2020-11-03,1.0,-34.33,-85.37,0.0,162.0,           ,1.0,1.0,81.0
774,Lemmikit,2020-11-03 23:24:17.851239666,2020-11-03,2020-11-03,2020-11-03,1.0,-11.14,-96.51,0.0,162.0,           ,1.0,1.0,95.0
775,Ruoka_paivittaistavarakauppa,2020-11-04 11:18:20.826446277,2020-11-04,2020-11-04,2020-11-04,1.0,-33.12,-129.63,0.0,162.0,           ,1.0,1.0,90.0
776,Lapset,2020-11-04 23:12:23.801652888,2020-11-04,2020-11-04,2020-11-04,1.0,-1.62,-131.25,0.0,162.0,           ,1.0,1.0,59.0
777,Ruoka_paivittaistavarakauppa,2020-11-05 22:48:35.702479332,2020-11-05,2020-11-05,2020-11-05,1.0,-2.96,-134.21,0.0,162.0,           ,1.0,1.0,96.0
778,Luokittelemattomat,2020-11-05 23:00:29.752066110,2020-11-05,2020-11-05,2020-11-05,1.0,-2.38,-136.59,0.0,162.0,           ,1.0,1.0,72.0
779,Ravintolat_kahvilat,2020-11-06 10:54:32.727272721,2020-11-06,2020-11-06,2020-11-06,1.0,-3.51,-140.1,0.0,162.0,           ,1.0,1.0,81.0
780,Ravintolat_kahvilat,2020-11-06 11:06:26.776859499,2020-11-06,2020-11-06,2020-11-06,1.0,-2.71,-142.81,0.0,162.0,           ,1.0,1.0,66.0
781,Ruoka_paivittaistavarakauppa,2020-11-06 22:36:41.652892554,2020-11-06,2020-11-06,2020-11-06,1.0,-3.51,-146.32,0.0,162.0,           ,1.0,1.0,148.0
782,Asuminen,2020-11-09 10:18:50.578512387,2020-11-09,2020-11-09,2020-11-09,1.0,-2.88,-149.2,0.0,162.0,           ,1.0,1.0,100.0
783,Ruoka_paivittaistavarakauppa,2020-11-09 10:30:44.628099165,2020-11-09,2020-11-09,2020-11-09,1.0,-21.57,-170.77,0.0,162.0,           ,1.0,1.0,34.0
784,Harrastukset,2020-11-09 10:42:38.677685943,2020-11-09,2020-11-09,2020-11-09,1.0,-5.81,-176.58,0.0,162.0,           ,1.0,1.0,159.0
785,Ravintolat_kahvilat,2020-11-09 22:12:53.553718998,2020-11-09,2020-11-09,2020-11-09,1.0,-8.7,-185.28,0.0,162.0,           ,1.0,1.0,44.0
786,Liikkuminen,2020-11-09 22:24:47.603305776,2020-11-09,2020-11-09,2020-11-09,1.0,-24.12,-209.4,0.0,162.0,           ,1.0,1.0,84.0
787,Ruoka_paivittaistavarakauppa,2020-11-10 10:06:56.528925609,2020-11-10,2020-11-10,2020-11-10,1.0,-4.07,-213.47,0.0,162.0,           ,1.0,1.0,120.0
788,Ruoka_paivittaistavarakauppa,2020-11-10 22:00:59.504132220,2020-11-10,2020-11-13,2020-11-10,1.0,-39.57,-253.04,0.0,162.0,           ,1.0,1.0,65.0
789,Ruoka_paivittaistavarakauppa,2020-11-11 09:55:02.479338831,2020-11-11,2020-11-11,2020-11-11,1.0,-6.7,-259.74,0.0,162.0,           ,1.0,1.0,108.0
790,Ruoka_paivittaistavarakauppa,2020-11-11 21:25:17.355371886,2020-11-11,2020-11-12,2020-11-11,1.0,-8.77,-268.51,0.0,162.0,           ,1.0,1.0,161.0
791,Ravintolat_kahvilat,2020-11-11 21:49:05.454545442,2020-11-11,2020-11-11,2020-11-11,1.0,-2.6,-271.11,0.0,162.0,           ,1.0,1.0,65.0
792,Muut,2020-11-12 09:43:08.429752053,2020-11-12,2020-11-12,2020-11-12,1.0,-6.4,-277.51,0.0,162.0,           ,1.0,1.0,37.0
793,Ruoka_paivittaistavarakauppa,2020-11-12 21:37:11.404958664,2020-11-12,2020-11-12,2020-11-12,1.0,-3.4,-280.91,0.0,162.0,           ,1.0,1.0,50.0
794,Ravintolat_kahvilat,2020-11-13 09:19:20.330578497,2020-11-13,2020-11-13,2020-11-13,1.0,-3.17,-284.08,0.0,162.0,           ,1.0,1.0,101.0
795,Ruoka_paivittaistavarakauppa,2020-11-13 09:31:14.380165275,2020-11-13,2020-11-13,2020-11-13,1.0,-13.1,-297.18,0.0,162.0,           ,1.0,1.0,119.0
796,Liikkuminen,2020-11-13 21:13:23.305785108,2020-11-13,2020-11-13,2020-11-12,1.0,-2.08,-299.26,0.0,162.0,           ,1.0,1.0,151.0
797,Ruoka_paivittaistavarakauppa,2020-11-16 08:55:32.231404941,2020-11-16,2020-11-16,2020-11-16,1.0,-4.69,-303.95,0.0,162.0,           ,1.0,1.0,123.0
798,Ruoka_paivittaistavarakauppa,2020-11-16 09:07:26.280991719,2020-11-16,2020-11-16,2020-11-16,1.0,-10.87,-314.82,0.0,162.0,           ,1.0,1.0,111.0
799,Ruoka_paivittaistavarakauppa,2020-11-16 20:37:41.157024774,2020-11-16,2020-11-16,2020-11-16,1.0,-3.21,-318.03,0.0,162.0,           ,1.0,1.0,125.0
800,Tulot,2020-11-16 20:49:35.206611552,2020-11-16,2020-11-16,2020-11-16,1.0,125.76,-192.27,710.0,506.0,           ,1.0,1.0,212.0
801,Ruoka_paivittaistavarakauppa,2020-11-16 21:01:29.256198330,2020-11-16,2020-11-16,2020-11-16,1.0,-1.33,-193.6,0.0,162.0,           ,1.0,1.0,100.0
802,Liikkuminen,2020-11-17 08:43:38.181818163,2020-11-17,2020-11-17,2020-11-17,1.0,-5.96,-199.56,0.0,162.0,           ,1.0,1.0,114.0
803,Tulot,2020-11-18 08:31:44.132231385,2020-11-18,2020-11-18,2020-11-18,1.0,28.59,-170.97,710.0,588.0,           ,0.0,1.0,222.0
804,Liikkuminen,2020-11-18 20:25:47.107437996,2020-11-18,2020-11-18,2020-11-17,1.0,-14.41,-185.38,0.0,106.0,SBANFIHH   ,1.0,0.0,19.0
805,Muut,2020-11-19 08:19:50.082644607,2020-11-19,2020-11-19,2020-11-19,1.0,-25.24,-210.62,0.0,162.0,           ,1.0,1.0,127.0
806,Ruoka_paivittaistavarakauppa,2020-11-19 20:13:53.057851218,2020-11-19,2020-11-19,2020-11-19,1.0,-1.51,-212.13,0.0,162.0,           ,1.0,1.0,65.0
807,Ruoka_paivittaistavarakauppa,2020-11-20 07:44:07.933884273,2020-11-20,2020-11-20,2020-11-20,1.0,-4.54,-216.67,0.0,162.0,           ,1.0,1.0,146.0
808,Luottojen_maksut,2020-11-20 08:07:56.033057829,2020-11-20,2020-11-20,2020-11-20,1.0,-19.22,-235.89,706.0,129.0,OKOYFIHH   ,0.0,0.0,201.0
809,Ruoka_paivittaistavarakauppa,2020-11-20 20:01:59.008264440,2020-11-20,2020-11-20,2020-11-20,1.0,-7.99,-243.88,0.0,162.0,           ,1.0,1.0,105.0
810,Ruoka_paivittaistavarakauppa,2020-11-23 07:32:13.884297495,2020-11-23,2020-11-23,2020-11-23,1.0,-0.69,-244.57,0.0,162.0,           ,1.0,1.0,158.0
811,Ravintolat_kahvilat,2020-11-23 07:56:01.983471051,2020-11-23,2020-11-23,2020-11-23,1.0,-1.74,-246.31,0.0,162.0,           ,1.0,1.0,116.0
812,Ruoka_paivittaistavarakauppa,2020-11-23 19:02:28.760330550,2020-11-23,2020-11-23,2020-11-23,1.0,-3.23,-249.54,0.0,162.0,           ,1.0,1.0,87.0
813,Lemmikit,2020-11-23 19:26:16.859504106,2020-11-23,2020-11-23,2020-11-23,1.0,-2.97,-252.51,0.0,162.0,           ,1.0,1.0,50.0
814,Ruoka_paivittaistavarakauppa,2020-11-23 19:38:10.909090884,2020-11-23,2020-11-23,2020-11-23,1.0,-1.69,-254.2,0.0,162.0,           ,1.0,1.0,110.0
815,Tulot,2020-11-23 19:50:04.958677662,2020-11-23,2020-11-23,2020-11-23,1.0,30.14,-224.06,710.0,588.0,           ,0.0,1.0,221.0
816,Ruoka_paivittaistavarakauppa,2020-11-24 07:08:25.785123939,2020-11-24,2020-11-24,2020-11-24,1.0,-7.19,-231.25,0.0,162.0,           ,1.0,1.0,122.0
817,Tulot,2020-11-24 19:14:22.809917328,2020-11-24,2020-11-24,2020-11-24,1.0,62.05,-169.2,710.0,588.0,           ,0.0,1.0,221.0
818,Ruoka_paivittaistavarakauppa,2020-11-25 07:20:19.834710717,2020-11-25,2020-11-25,2020-11-25,1.0,-2.95,-172.15,0.0,162.0,           ,1.0,1.0,124.0
819,Ravintolat_kahvilat,2020-11-25 18:50:34.710743772,2020-11-25,2020-11-25,2020-11-25,1.0,-5.59,-177.74,0.0,162.0,           ,1.0,1.0,137.0
820,Hyvinvointijakauneus,2020-11-26 06:56:31.735537161,2020-11-26,2020-11-26,2020-11-26,1.0,-2.62,-180.36,0.0,162.0,           ,1.0,1.0,127.0
821,Ravintolat_kahvilat,2020-11-27 06:32:43.636363605,2020-11-27,2020-11-27,2020-11-27,1.0,-1.54,-181.9,0.0,162.0,           ,1.0,1.0,112.0
822,Ruoka_paivittaistavarakauppa,2020-11-27 06:44:37.685950383,2020-11-27,2020-11-27,2020-11-27,1.0,-47.55,-229.45,0.0,162.0,           ,1.0,1.0,72.0
823,Ruoka_paivittaistavarakauppa,2020-11-27 18:26:46.611570216,2020-11-27,2020-11-27,2020-11-27,1.0,-6.99,-236.44,0.0,162.0,           ,1.0,1.0,123.0
824,Asuminen,2020-11-27 18:38:40.661156994,2020-11-27,2020-11-27,2020-11-27,1.0,-14.71,-251.15,706.0,129.0,NDEAFIHH   ,0.0,0.0,199.0
825,Ruoka_paivittaistavarakauppa,2020-11-30 06:08:55.537190049,2020-11-30,2020-12-01,2020-11-30,1.0,-7.09,-258.24,0.0,162.0,           ,1.0,1.0,117.0
826,Lapset,2020-11-30 06:20:49.586776827,2020-11-30,2020-12-01,2020-11-30,1.0,-4.51,-262.75,0.0,162.0,           ,1.0,1.0,137.0
827,Ruoka_paivittaistavarakauppa,2020-11-30 18:02:58.512396660,2020-11-30,2020-11-30,2020-11-30,1.0,-3.74,-266.49,0.0,162.0,           ,1.0,1.0,108.0
828,Ruoka_paivittaistavarakauppa,2020-11-30 18:14:52.561983438,2020-11-30,2020-11-30,2020-11-30,1.0,-1.67,-268.16,0.0,162.0,           ,1.0,1.0,92.0
829,Tulot,2020-12-01 20:57:27.887323943,2020-12-01,2020-12-01,2020-12-01,1.0,97.16,-171.0,710.0,588.0,           ,0.0,1.0,221.0
830,Tulot,2020-12-02 17:54:55.774647886,2020-12-02,2020-12-02,2020-12-02,1.0,137.18,-33.82,710.0,588.0,           ,0.0,1.0,221.0
831,Ruoka_paivittaistavarakauppa,2020-12-03 14:52:23.661971829,2020-12-03,2020-12-03,2020-12-03,1.0,-1.85,-35.67,0.0,162.0,           ,1.0,1.0,127.0
832,Ruoka_paivittaistavarakauppa,2020-12-04 08:47:19.436619715,2020-12-04,2020-12-04,2020-12-04,1.0,-8.91,-44.58,0.0,162.0,           ,1.0,1.0,80.0
833,Ruoka_paivittaistavarakauppa,2020-12-04 11:49:51.549295772,2020-12-04,2020-12-04,2020-12-03,1.0,-0.4,-44.98,0.0,162.0,           ,1.0,1.0,115.0
834,Ruoka_paivittaistavarakauppa,2020-12-07 02:42:15.211267601,2020-12-07,2020-12-07,2020-12-07,1.0,-1.54,-46.52,0.0,162.0,           ,1.0,1.0,137.0
835,Ruoka_paivittaistavarakauppa,2020-12-07 05:44:47.323943658,2020-12-07,2020-12-07,2020-12-07,1.0,-3.77,-50.29,0.0,162.0,           ,1.0,1.0,126.0
836,Asuminen,2020-12-07 20:37:10.985915487,2020-12-07,2020-12-07,2020-12-07,1.0,-46.1,-96.39,706.0,129.0,OKOYFIHH   ,0.0,0.0,201.0
837,Tulot,2020-12-07 23:39:43.098591544,2020-12-07,2020-12-07,2020-12-07,1.0,143.49,47.1,0.0,505.0,           ,1.0,1.0,175.0
838,Asuminen,2020-12-08 17:34:38.873239430,2020-12-08,2020-12-08,2020-12-08,1.0,-29.27,17.83,706.0,129.0,DABAFIHH   ,0.0,0.0,201.0
839,Ravintolat_kahvilat,2020-12-10 14:32:06.760563373,2020-12-10,2020-12-10,2020-12-10,1.0,-10.34,7.49,0.0,162.0,           ,1.0,1.0,72.0
840,Lapset,2020-12-11 11:29:34.647887316,2020-12-11,2020-12-11,2020-12-11,1.0,-4.34,3.15,0.0,162.0,           ,1.0,1.0,59.0
841,Ruoka_paivittaistavarakauppa,2020-12-14 02:21:58.309859145,2020-12-14,2020-12-14,2020-12-14,1.0,-6.68,-3.53,0.0,162.0,           ,1.0,1.0,53.0
842,Ruoka_paivittaistavarakauppa,2020-12-14 05:24:30.422535202,2020-12-14,2020-12-14,2020-12-14,1.0,-18.3,-21.83,0.0,162.0,           ,1.0,1.0,156.0
843,Liikkuminen,2020-12-14 08:27:02.535211259,2020-12-14,2020-12-14,2020-12-14,1.0,-29.68,-51.51,0.0,162.0,           ,1.0,1.0,100.0
844,Muut,2020-12-14 23:19:26.197183088,2020-12-14,2020-12-14,2020-12-14,1.0,-24.94,-76.45,0.0,162.0,           ,1.0,1.0,85.0
845,Tulot,2020-12-15 20:16:54.084507031,2020-12-15,2020-12-15,2020-12-15,1.0,0.05,-76.4,710.0,588.0,           ,0.0,1.0,221.0
846,Ruoka_paivittaistavarakauppa,2020-12-16 17:14:21.971830974,2020-12-16,2020-12-16,2020-12-16,1.0,-8.94,-85.34,0.0,162.0,           ,1.0,1.0,112.0
847,Tulot,2020-12-17 14:11:49.859154917,2020-12-17,2020-12-17,2020-12-17,1.0,436.96,351.62,701.0,506.0,           ,1.0,1.0,181.0
848,Ravintolat_kahvilat,2020-12-18 08:06:45.633802803,2020-12-18,2020-12-18,2020-12-18,1.0,-6.81,344.81,0.0,162.0,           ,1.0,1.0,119.0
849,Ravintolat_kahvilat,2020-12-18 11:09:17.746478860,2020-12-18,2020-12-18,2020-12-18,1.0,-9.39,335.42,0.0,162.0,           ,1.0,1.0,148.0
850,Ravintolat_kahvilat,2020-12-21 02:01:41.408450689,2020-12-21,2020-12-22,2020-12-21,1.0,-9.66,325.76,0.0,162.0,           ,1.0,1.0,86.0
851,Liikkuminen,2020-12-21 05:04:13.521126746,2020-12-21,2020-12-23,2020-12-21,1.0,-39.74,286.02,0.0,162.0,           ,1.0,1.0,127.0
852,Lemmikit,2020-12-21 22:59:09.295774632,2020-12-21,2020-12-21,2020-12-21,1.0,-27.26,258.76,0.0,162.0,           ,1.0,1.0,55.0
853,Saastot_sijoitukset,2020-12-22 13:51:32.957746461,2020-12-22,2020-12-22,2020-12-22,1.0,-5.58,253.18,0.0,162.0,           ,1.0,1.0,136.0
854,Ruoka_paivittaistavarakauppa,2020-12-22 16:54:05.070422518,2020-12-22,2020-12-22,2020-12-22,1.0,-5.05,248.13,0.0,162.0,           ,1.0,1.0,155.0
855,Ruoka_paivittaistavarakauppa,2020-12-22 19:56:37.183098575,2020-12-22,2020-12-22,2020-12-22,1.0,-8.45,239.68,0.0,162.0,           ,1.0,1.0,140.0
856,Muut,2020-12-24 07:46:28.732394347,2020-12-24,2020-12-24,2020-12-24,1.0,-7.74,231.94,0.0,162.0,           ,1.0,1.0,92.0
857,Ravintolat_kahvilat,2020-12-25 10:49:00.845070404,2020-12-25,2020-12-25,2020-12-25,1.0,-1.55,230.39,0.0,162.0,           ,1.0,1.0,120.0
858,Asuminen,2020-12-26 04:43:56.619718290,2020-12-26,2020-12-26,2020-12-26,1.0,-38.29,192.1,0.0,106.0,DABAFIHH   ,0.0,0.0,11.0
859,Lapset,2020-12-28 01:41:24.507042233,2020-12-28,2020-12-28,2020-12-28,1.0,-0.62,191.48,0.0,162.0,           ,1.0,1.0,148.0
860,Tulot,2020-12-28 22:38:52.394366176,2020-12-28,2020-12-28,2020-12-28,1.0,550.98,742.46,701.0,506.0,           ,1.0,1.0,180.0
861,Vakuutukset,2020-12-29 19:36:20.281690119,2020-12-29,2020-12-29,2020-12-29,1.0,-64.29,678.17,706.0,129.0,OKOYFIHH   ,0.0,0.0,198.0
862,Muut,2020-12-30 13:31:16.056338005,2020-12-30,2020-12-30,2020-12-30,1.0,-205.36,472.81,0.0,163.0,           ,1.0,1.0,168.0
863,Lemmikit,2020-12-30 16:33:48.169014062,2020-12-30,2020-12-30,2020-12-30,1.0,-37.13,435.68,706.0,129.0,NDEAFIHH   ,0.0,0.0,201.0
864,Tulot,2019-01-01 00:00:00.000000000,2019-01-01,2019-01-03,2019-01-01,2.0,184.89,2214.27,0.0,505.0,           ,1.0,1.0,162.0
865,Ruoka_paivittaistavarakauppa,2019-01-07 21:20:00.000000000,2019-01-07,2019-01-07,2019-01-07,2.0,-5.75,2208.52,0.0,162.0,           ,1.0,1.0,72.0
866,Ruoka_paivittaistavarakauppa,2019-01-14 18:40:00.000000000,2019-01-14,2019-01-14,2019-01-14,2.0,-17.24,2191.28,0.0,162.0,           ,1.0,1.0,76.0
867,Muut,2019-01-20 16:00:00.000000000,2019-01-20,2019-01-20,2019-01-20,2.0,-61.97,2129.31,0.0,163.0,           ,1.0,1.0,156.0
868,Lapset,2019-01-28 13:20:00.000000000,2019-01-28,2019-01-28,2019-01-28,2.0,-9.03,2120.28,0.0,162.0,           ,1.0,1.0,101.0
869,Muut,2019-02-04 16:00:00.000000000,2019-02-04,2019-02-04,2019-02-04,2.0,-43.88,2076.4,0.0,162.0,           ,1.0,1.0,50.0
870,Kulttuuri_viihde,2019-02-07 08:00:00.000000000,2019-02-07,2019-02-07,2019-02-07,2.0,-27.64,2048.76,0.0,162.0,           ,1.0,1.0,116.0
871,Ruoka_paivittaistavarakauppa,2019-02-08 00:00:00.000000000,2019-02-08,2019-02-08,2019-02-08,2.0,-2.63,2046.13,0.0,162.0,           ,1.0,1.0,106.0
872,Ruoka_paivittaistavarakauppa,2019-02-11 16:00:00.000000000,2019-02-11,2019-02-11,2019-02-11,2.0,-19.14,2026.99,0.0,162.0,           ,1.0,1.0,50.0
873,Tulot,2019-02-14 08:00:00.000000000,2019-02-14,2019-02-14,2019-02-14,2.0,57.32,2084.31,701.0,524.0,           ,1.0,1.0,185.0
874,Ruoka_paivittaistavarakauppa,2019-02-19 00:00:00.000000000,2019-02-19,2019-02-19,2019-02-19,2.0,-25.18,2059.13,0.0,162.0,           ,1.0,1.0,60.0
875,Hyvinvointijakauneus,2019-02-19 16:00:00.000000000,2019-02-19,2019-02-20,2019-02-19,2.0,-22.25,2036.88,0.0,162.0,           ,1.0,1.0,83.0
876,Ruoka_paivittaistavarakauppa,2019-02-22 08:00:00.000000000,2019-02-22,2019-02-22,2019-02-22,2.0,-55.5,1981.38,0.0,162.0,           ,1.0,1.0,50.0
877,Luokittelemattomat,2019-02-25 00:00:00.000000000,2019-02-25,2019-02-25,2019-02-25,2.0,-136.78,1844.6,706.0,106.0,OKOYFIHH   ,1.0,0.0,191.0
878,Ravintolat_kahvilat,2019-02-27 16:00:00.000000000,2019-02-27,2019-02-27,2019-02-27,2.0,-12.89,1831.71,0.0,162.0,           ,1.0,1.0,28.0
879,Ruoka_paivittaistavarakauppa,2019-03-04 06:22:02.448979591,2019-03-04,2019-03-04,2019-03-04,2.0,-22.04,1809.67,0.0,162.0,           ,1.0,1.0,83.0
880,Saastot_sijoitukset,2019-03-04 12:44:04.897959182,2019-03-04,2019-03-04,2019-03-04,2.0,-64.82,1744.85,0.0,162.0,           ,1.0,1.0,37.0
881,Ruoka_paivittaistavarakauppa,2019-03-04 19:06:07.346938773,2019-03-04,2019-03-04,2019-03-04,2.0,-6.48,1738.37,0.0,162.0,           ,1.0,1.0,87.0
882,Ruoka_paivittaistavarakauppa,2019-03-07 01:28:09.795918364,2019-03-07,2019-03-07,2019-03-07,2.0,-17.49,1720.88,0.0,162.0,           ,1.0,1.0,115.0
883,Asuminen,2019-03-07 07:50:12.244897955,2019-03-07,2019-03-07,2019-03-07,2.0,-20.52,1700.36,0.0,162.0,           ,1.0,1.0,86.0
884,Tulot,2019-03-08 14:12:14.693877546,2019-03-08,2019-03-08,2019-03-08,2.0,714.0,2414.36,710.0,506.0,           ,1.0,1.0,214.0
885,Luottojen_maksut,2019-03-08 20:34:17.142857137,2019-03-08,2019-03-08,2019-03-07,2.0,-11.9,2402.46,706.0,106.0,OKOYFIHH   ,0.0,0.0,194.0
886,Ruoka_paivittaistavarakauppa,2019-03-11 02:56:19.591836728,2019-03-11,2019-03-11,2019-03-11,2.0,-49.7,2352.76,0.0,162.0,           ,1.0,1.0,54.0
887,Luokittelemattomat,2019-03-11 09:18:22.040816319,2019-03-11,2019-03-11,2019-03-11,2.0,-214.38,2138.38,706.0,106.0,OKOYFIHH   ,0.0,0.0,186.0
888,Ruoka_paivittaistavarakauppa,2019-03-11 15:40:24.489795910,2019-03-11,2019-03-11,2019-03-11,2.0,-25.97,2112.41,0.0,162.0,           ,1.0,1.0,50.0
889,Ravintolat_kahvilat,2019-03-14 04:24:29.387755092,2019-03-14,2019-03-14,2019-03-14,2.0,-23.82,2088.59,0.0,162.0,           ,1.0,1.0,151.0
890,Luokittelemattomat,2019-03-14 22:02:26.938775501,2019-03-14,2019-03-14,2019-03-14,2.0,-52.7,2035.89,706.0,106.0,NDEAFIHH   ,1.0,0.0,186.0
891,Tulot,2019-03-15 10:46:31.836734683,2019-03-15,2019-03-15,2019-03-15,2.0,-63.44,1972.45,706.0,106.0,NDEAFIHH   ,0.0,0.0,190.0
892,Ravintolat_kahvilat,2019-03-18 17:08:34.285714274,2019-03-18,2019-03-19,2019-03-18,2.0,-9.33,1963.12,0.0,162.0,           ,1.0,1.0,144.0
893,Tulot,2019-03-19 23:30:36.734693865,2019-03-15,2019-03-19,2019-03-19,2.0,9.47,1972.59,0.0,505.0,           ,1.0,1.0,161.0
894,Lemmikit,2019-03-21 05:52:39.183673456,2019-03-21,2019-03-21,2019-03-21,2.0,-166.97,1805.62,706.0,106.0,NDEAFIHH   ,0.0,0.0,188.0
895,Matkailu,2019-03-22 12:14:41.632653047,2019-03-22,2019-03-22,2019-03-22,2.0,-76.55,1729.07,706.0,106.0,SBANFIHH   ,0.0,0.0,195.0
896,Tulot,2019-03-22 18:36:44.081632638,2019-03-22,2019-03-22,2019-03-22,2.0,1267.64,2996.71,0.0,505.0,           ,1.0,1.0,161.0
897,Lapset,2019-03-25 00:58:46.530612229,2019-03-25,2019-03-25,2019-03-25,2.0,-10.87,2985.84,0.0,106.0,OKOYFIHH   ,0.0,0.0,22.0
898,Luokittelemattomat,2019-03-26 07:20:48.979591820,2019-03-26,2019-03-26,2019-03-26,2.0,-23.14,2962.7,0.0,162.0,           ,1.0,1.0,71.0
899,Luokittelemattomat,2019-03-27 13:42:51.428571411,2019-03-27,2019-03-27,2019-03-27,2.0,-141.62,2821.08,706.0,106.0,OKOYFIHH   ,1.0,0.0,193.0
900,Lapset,2019-03-28 02:26:56.326530593,2019-03-28,2019-03-28,2019-03-28,2.0,-105.47,2715.61,706.0,106.0,DABAFIHH   ,0.0,0.0,186.0
901,Liikkuminen,2019-03-28 08:48:58.775510184,2019-03-28,2019-03-28,2019-03-28,2.0,-3.04,2712.57,0.0,162.0,           ,1.0,1.0,70.0
902,Luokittelemattomat,2019-03-28 20:04:53.877551002,2019-03-28,2019-03-28,2019-03-28,2.0,-32.5,2680.07,706.0,106.0,OKOYFIHH   ,0.0,0.0,188.0
903,Luottojen_maksut,2019-04-03 09:36:00.000000000,2019-04-03,2019-04-03,2019-04-03,2.0,-660.38,2019.69,706.0,106.0,OKOYFIHH   ,0.0,0.0,186.0
904,Tulot,2019-04-05 19:12:00.000000000,2019-04-05,2019-04-05,2019-04-05,2.0,480.39,2500.08,0.0,574.0,           ,1.0,1.0,170.0
905,Ruoka_paivittaistavarakauppa,2019-04-08 04:48:00.000000000,2019-04-08,2019-04-08,2019-04-08,2.0,-1.0,2499.08,0.0,162.0,           ,1.0,1.0,76.0
906,Tulot,2019-04-12 00:00:00.000000000,2019-04-12,2019-04-12,2019-04-12,2.0,58.06,2557.14,701.0,510.0,           ,1.0,1.0,175.0
907,Luokittelemattomat,2019-04-12 14:24:00.000000000,2019-04-12,2019-04-12,2019-04-12,2.0,-124.39,2432.75,706.0,106.0,OKOYFIHH   ,1.0,0.0,189.0
908,Lapset,2019-04-15 09:36:00.000000000,2019-04-15,2019-04-15,2019-04-15,2.0,-878.3,1554.45,706.0,106.0,ITELFIHH   ,0.0,0.0,190.0
909,Ruoka_paivittaistavarakauppa,2019-04-16 19:12:00.000000000,2019-04-16,2019-04-16,2019-04-16,2.0,-28.6,1525.85,0.0,162.0,           ,1.0,1.0,130.0
910,Ruoka_paivittaistavarakauppa,2019-04-19 04:48:00.000000000,2019-04-19,2019-04-19,2019-04-19,2.0,-5.52,1520.33,0.0,162.0,           ,1.0,1.0,92.0
911,Shoppailu,2019-04-22 14:24:00.000000000,2019-04-22,2019-04-22,2019-04-22,2.0,-8.55,1511.78,0.0,162.0,           ,1.0,1.0,45.0
912,Ruoka_paivittaistavarakauppa,2019-04-24 00:00:00.000000000,2019-04-24,2019-04-24,2019-04-24,2.0,-5.81,1505.97,0.0,162.0,           ,1.0,1.0,73.0
913,Ruoka_paivittaistavarakauppa,2019-04-26 09:36:00.000000000,2019-04-26,2019-04-26,2019-04-26,2.0,-9.02,1496.95,0.0,162.0,           ,1.0,1.0,136.0
914,Luottojen_maksut,2019-04-29 19:12:00.000000000,2019-04-29,2019-04-29,2019-04-29,2.0,-43.51,1453.44,706.0,106.0,OKOYFIHH   ,0.0,0.0,186.0
915,Tulot,2019-05-02 06:22:02.448979591,2019-05-02,2019-05-02,2019-05-02,2.0,-395.27,1058.17,0.0,162.0,           ,1.0,1.0,96.0
916,Tulot,2019-05-03 12:44:04.897959182,2019-05-03,2019-05-03,2019-05-03,2.0,671.98,1730.15,701.0,524.0,           ,1.0,1.0,184.0
917,Ruoka_paivittaistavarakauppa,2019-05-03 19:06:07.346938773,2019-05-03,2019-05-03,2019-05-03,2.0,-64.45,1665.7,0.0,162.0,           ,1.0,1.0,27.0
918,Luokittelemattomat,2019-05-06 01:28:09.795918364,2019-05-06,2019-05-06,2019-05-06,2.0,-6.94,1658.76,0.0,162.0,           ,1.0,1.0,40.0
919,Luokittelemattomat,2019-05-07 07:50:12.244897955,2019-05-07,2019-05-07,2019-05-07,2.0,-33.73,1625.03,0.0,162.0,           ,1.0,1.0,35.0
920,Hyvinvointijakauneus,2019-05-07 20:34:17.142857137,2019-05-07,2019-05-07,2019-05-07,2.0,-14.59,1610.44,706.0,106.0,OKOYFIHH   ,0.0,0.0,192.0
921,Ruoka_paivittaistavarakauppa,2019-05-08 14:12:14.693877546,2019-05-08,2019-05-08,2019-05-08,2.0,-38.5,1571.94,0.0,162.0,           ,1.0,1.0,74.0
922,Ruoka_paivittaistavarakauppa,2019-05-10 02:56:19.591836728,2019-05-10,2019-05-10,2019-05-10,2.0,-43.33,1528.61,0.0,162.0,           ,1.0,1.0,95.0
923,Asuminen,2019-05-10 09:18:22.040816319,2019-05-10,2019-05-10,2019-05-10,2.0,-75.13,1453.48,706.0,106.0,NDEAFIHH   ,0.0,0.0,187.0
924,Ruoka_paivittaistavarakauppa,2019-05-13 15:40:24.489795910,2019-05-13,2019-05-13,2019-05-13,2.0,-36.24,1417.24,0.0,162.0,           ,1.0,1.0,57.0
925,Lemmikit,2019-05-13 22:02:26.938775501,2019-05-13,2019-05-13,2019-05-13,2.0,-12.15,1405.09,0.0,162.0,           ,1.0,1.0,90.0
926,Ruoka_paivittaistavarakauppa,2019-05-15 10:46:31.836734683,2019-05-15,2019-05-15,2019-05-15,2.0,-26.4,1378.69,0.0,162.0,           ,1.0,1.0,124.0
927,Ravintolat_kahvilat,2019-05-17 04:24:29.387755092,2019-05-17,2019-05-20,2019-05-17,2.0,-10.87,1367.82,0.0,162.0,           ,1.0,1.0,90.0
928,Harrastukset,2019-05-20 05:52:39.183673456,2019-05-20,2019-05-20,2019-05-20,2.0,-58.89,1308.93,706.0,106.0,OKOYFIHH   ,0.0,0.0,186.0
929,Shoppailu,2019-05-20 12:14:41.632653047,2019-05-20,2019-05-20,2019-05-20,2.0,-26.26,1282.67,0.0,162.0,           ,1.0,1.0,126.0
930,Luokittelemattomat,2019-05-20 17:08:34.285714274,2019-05-20,2019-05-20,2019-05-20,2.0,-14.02,1268.65,0.0,162.0,           ,1.0,1.0,90.0
931,Ruoka_paivittaistavarakauppa,2019-05-20 23:30:36.734693865,2019-05-20,2019-05-20,2019-05-20,2.0,-6.36,1262.29,0.0,162.0,           ,1.0,1.0,74.0
932,Matkailu,2019-05-23 18:36:44.081632638,2019-05-23,2019-05-23,2019-05-23,2.0,-68.76,1193.53,706.0,106.0,NDEAFIHH   ,0.0,0.0,187.0
933,Ruoka_paivittaistavarakauppa,2019-05-24 00:58:46.530612229,2019-05-24,2019-05-24,2019-05-24,2.0,-23.34,1170.19,0.0,162.0,           ,1.0,1.0,75.0
934,Liikkuminen,2019-05-27 07:20:48.979591820,2019-05-27,2019-05-27,2019-05-27,2.0,-8.33,1161.86,0.0,162.0,           ,1.0,1.0,88.0
935,Harrastukset,2019-05-27 13:42:51.428571411,2019-05-27,2019-05-27,2019-05-27,2.0,-14.51,1147.35,0.0,162.0,           ,1.0,1.0,87.0
936,Hyvinvointi,2019-05-28 20:04:53.877551002,2019-05-28,2019-05-28,2019-05-28,2.0,-10.93,1136.42,0.0,162.0,           ,1.0,1.0,71.0
937,Vakuutukset,2019-05-30 02:26:56.326530593,2019-05-30,2019-05-30,2019-05-30,2.0,-1098.76,37.66,706.0,106.0,OKOYFIHH   ,0.0,0.0,187.0
938,Ruoka_paivittaistavarakauppa,2019-05-31 08:48:58.775510184,2019-05-31,2019-05-31,2019-05-31,2.0,-10.75,26.91,0.0,162.0,           ,1.0,1.0,91.0
939,Tulot,2019-06-03 02:10:54.545454545,2019-06-03,2019-06-03,2019-06-03,2.0,1427.89,1454.8,701.0,520.0,           ,1.0,1.0,176.0
940,Luottojen_maksut,2019-06-03 04:21:49.090909090,2019-06-03,2019-06-03,2019-06-03,2.0,-61.61,1393.19,706.0,106.0,OKOYFIHH   ,1.0,0.0,188.0
941,Tulot,2019-06-04 06:32:43.636363635,2019-06-04,2019-06-04,2019-06-04,2.0,-56.87,1336.32,706.0,106.0,OKOYFIHH   ,0.0,0.0,186.0
942,Terveys,2019-06-05 08:43:38.181818180,2019-06-05,2019-06-05,2019-06-05,2.0,260.97,1597.29,701.0,521.0,           ,1.0,1.0,183.0
943,Asuminen,2019-06-06 10:54:32.727272725,2019-06-06,2019-06-06,2019-06-06,2.0,-13.96,1583.33,706.0,106.0,OKOYFIHH   ,0.0,0.0,186.0
944,Liikkuminen,2019-06-06 15:16:21.818181815,2019-06-06,2019-06-07,2019-06-06,2.0,-746.92,836.41,706.0,106.0,POPFFI22   ,1.0,0.0,190.0
945,Vakuutukset,2019-06-07 13:05:27.272727270,2019-06-07,2019-06-07,2019-06-07,2.0,-429.43,406.98,706.0,106.0,OKOYFIHH   ,0.0,0.0,187.0
946,Asuminen,2019-06-10 19:38:10.909090905,2019-06-10,2019-06-10,2019-06-10,2.0,-136.0,270.98,706.0,106.0,OKOYFIHH   ,0.0,0.0,195.0
947,Ruoka_paivittaistavarakauppa,2019-06-11 17:27:16.363636360,2019-06-11,2019-06-11,2019-06-11,2.0,-3.44,267.54,0.0,162.0,           ,1.0,1.0,115.0
948,Hyvinvointijakauneus,2019-06-11 21:49:05.454545450,2019-06-11,2019-06-11,2019-06-11,2.0,-15.27,252.27,0.0,162.0,           ,1.0,1.0,65.0
949,Muut,2019-06-11 23:59:59.999999995,2019-06-11,2019-06-11,2019-06-10,2.0,-50.9,201.37,0.0,162.0,           ,1.0,1.0,63.0
950,Ruoka_paivittaistavarakauppa,2019-06-13 02:10:54.545454540,2019-06-13,2019-06-13,2019-06-13,2.0,-7.45,193.92,0.0,162.0,           ,1.0,1.0,64.0
951,Ruoka_paivittaistavarakauppa,2019-06-14 04:21:49.090909085,2019-06-14,2019-06-14,2019-06-14,2.0,-0.54,193.38,0.0,162.0,           ,1.0,1.0,115.0
952,Ravintolat_kahvilat,2019-06-17 08:43:38.181818175,2019-06-17,2019-06-17,2019-06-17,2.0,-9.44,183.94,0.0,162.0,           ,1.0,1.0,115.0
953,Tulot,2019-06-18 06:32:43.636363630,2019-06-18,2019-06-18,2019-06-18,2.0,519.54,703.48,0.0,505.0,           ,1.0,1.0,163.0
954,Ravintolat_kahvilat,2019-06-18 10:54:32.727272720,2019-06-18,2019-06-18,2019-06-18,2.0,-11.82,691.66,0.0,162.0,           ,1.0,1.0,74.0
955,Asuminen,2019-06-18 13:05:27.272727265,2019-06-18,2019-06-19,2019-06-18,2.0,-11.89,679.77,706.0,106.0,OKOYFIHH   ,0.0,0.0,186.0
956,Lemmikit,2019-06-20 15:16:21.818181810,2019-06-20,2019-06-20,2019-06-20,2.0,-26.75,653.02,706.0,106.0,OKOYFIHH   ,0.0,0.0,195.0
957,Ruoka_paivittaistavarakauppa,2019-06-21 17:27:16.363636355,2019-06-21,2019-06-21,2019-06-21,2.0,-6.9,646.12,0.0,162.0,           ,1.0,1.0,75.0
958,Ravintolat_kahvilat,2019-06-21 19:38:10.909090900,2019-06-21,2019-06-21,2019-06-21,2.0,-6.85,639.27,0.0,162.0,           ,1.0,1.0,83.0
959,Tulot,2019-06-23 21:49:05.454545445,2019-06-23,2019-06-23,2019-06-23,2.0,63.57,702.84,0.0,505.0,           ,1.0,1.0,161.0
960,Liikkuminen,2019-06-24 23:59:59.999999990,2019-06-24,2019-06-24,2019-06-24,2.0,-74.4,628.44,0.0,162.0,           ,1.0,1.0,54.0
961,Tulot,2019-06-26 02:10:54.545454535,2019-06-26,2019-06-26,2019-06-26,2.0,49.25,677.69,710.0,506.0,           ,1.0,1.0,211.0
962,Asuminen,2019-06-27 04:21:49.090909080,2019-06-27,2019-06-27,2019-06-27,2.0,-15.91,661.78,706.0,106.0,NDEAFIHH   ,0.0,0.0,186.0
963,Shoppailu,2019-06-27 06:32:43.636363625,2019-06-27,2019-06-28,2019-06-27,2.0,-4.11,657.67,0.0,162.0,           ,1.0,1.0,70.0
964,Vakuutukset,2019-06-28 08:43:38.181818170,2019-06-28,2019-06-28,2019-06-27,2.0,-281.85,375.82,706.0,106.0,OKOYFIHH   ,0.0,0.0,190.0
965,Ruoka_paivittaistavarakauppa,2019-06-28 10:54:32.727272715,2019-06-28,2019-06-28,2019-06-28,2.0,-33.79,342.03,0.0,162.0,           ,1.0,1.0,71.0
966,Tulot,2019-07-01 16:43:08.764044943,2019-07-01,2019-07-01,2019-07-01,2.0,170.26,512.29,701.0,521.0,           ,1.0,1.0,183.0
967,Asuminen,2019-07-02 09:26:17.528089886,2019-07-02,2019-07-02,2019-07-02,2.0,-37.31,474.98,706.0,106.0,OKOYFIHH   ,0.0,0.0,188.0
968,Tulot,2019-07-03 02:09:26.292134829,2019-07-03,2019-07-03,2019-07-03,2.0,1411.99,1886.97,701.0,520.0,           ,1.0,1.0,176.0
969,Ruoka_paivittaistavarakauppa,2019-07-03 18:52:35.056179772,2019-07-03,2019-07-03,2019-07-03,2.0,-6.55,1880.42,0.0,162.0,           ,1.0,1.0,26.0
970,Saastot_sijoitukset,2019-07-04 11:35:43.820224715,2019-07-04,2019-07-04,2019-07-04,2.0,-15.52,1864.9,0.0,162.0,           ,1.0,1.0,78.0
971,Asuminen,2019-07-05 04:18:52.584269658,2019-07-05,2019-07-05,2019-07-05,2.0,-20.78,1844.12,706.0,106.0,NDEAFIHH   ,0.0,0.0,190.0
972,Ruoka_paivittaistavarakauppa,2019-07-05 21:02:01.348314601,2019-07-05,2019-07-05,2019-07-05,2.0,-21.68,1822.44,0.0,162.0,           ,1.0,1.0,106.0
973,Muut,2019-07-08 01:20:53.932584259,2019-07-08,2019-07-08,2019-07-08,2.0,-8.49,1813.95,0.0,162.0,           ,1.0,1.0,52.0
974,Hyvinvointijakauneus,2019-07-08 06:28:18.876404487,2019-07-08,2019-07-08,2019-07-08,2.0,-128.79,1685.16,0.0,162.0,           ,1.0,1.0,60.0
975,Liikkuminen,2019-07-08 13:45:10.112359544,2019-07-08,2019-07-08,2019-07-08,2.0,-6.66,1678.5,0.0,162.0,           ,1.0,1.0,74.0
976,Tulot,2019-07-08 15:54:36.404494373,2019-07-08,2019-07-08,2019-07-08,2.0,1694.13,3372.63,0.0,505.0,           ,1.0,1.0,161.0
977,Lemmikit,2019-07-08 23:11:27.640449430,2019-07-08,2019-07-08,2019-07-08,2.0,-38.63,3334.0,0.0,162.0,           ,1.0,1.0,45.0
978,Ruoka_paivittaistavarakauppa,2019-07-09 08:37:45.168539316,2019-07-09,2019-07-09,2019-07-09,2.0,-74.27,3259.73,0.0,162.0,           ,1.0,1.0,28.0
979,Tulot,2019-07-09 10:47:11.460674145,2019-07-09,2019-07-09,2019-07-09,2.0,671.08,3930.81,0.0,505.0,           ,1.0,1.0,161.0
980,Muut,2019-07-10 18:04:02.696629202,2019-07-10,2019-07-10,2019-07-10,2.0,-213.6,3717.21,0.0,163.0,           ,1.0,1.0,153.0
981,Asuminen,2019-07-12 03:30:20.224719088,2019-07-12,2019-07-12,2019-07-12,2.0,-366.16,3351.05,706.0,106.0,OKOYFIHH   ,0.0,0.0,188.0
982,Tulot,2019-07-12 12:56:37.752808974,2019-07-12,2019-07-12,2019-07-12,2.0,-13.04,3338.01,0.0,162.0,           ,1.0,1.0,50.0
983,Ruoka_paivittaistavarakauppa,2019-07-12 20:13:28.988764031,2019-07-12,2019-07-12,2019-07-12,2.0,-47.98,3290.03,0.0,162.0,           ,1.0,1.0,117.0
984,Ravintolat_kahvilat,2019-07-15 05:39:46.516853917,2019-07-15,2019-07-15,2019-07-15,2.0,-7.11,3282.92,0.0,162.0,           ,1.0,1.0,136.0
985,Liikkuminen,2019-07-15 15:06:04.044943803,2019-07-15,2019-07-15,2019-07-15,2.0,-87.83,3195.09,706.0,106.0,OKOYFIHH   ,0.0,0.0,187.0
986,Ravintolat_kahvilat,2019-07-15 22:22:55.280898860,2019-07-15,2019-07-15,2019-07-15,2.0,-17.74,3177.35,0.0,162.0,           ,1.0,1.0,33.0
987,Ravintolat_kahvilat,2019-07-16 00:32:21.573033689,2019-07-16,2019-07-16,2019-07-16,2.0,-2.23,3175.12,0.0,162.0,           ,1.0,1.0,116.0
988,Asuminen,2019-07-16 07:49:12.808988746,2019-07-16,2019-07-16,2019-07-16,2.0,-48.44,3126.68,706.0,106.0,OKOYFIHH   ,0.0,0.0,188.0
989,Hyvinvointi,2019-07-17 17:15:30.337078632,2019-07-17,2019-07-17,2019-07-17,2.0,-14.26,3112.42,0.0,162.0,           ,1.0,1.0,61.0
990,Kulttuuri_viihde,2019-07-18 09:58:39.101123575,2019-07-18,2019-07-18,2019-07-18,2.0,-66.07,3046.35,0.0,162.0,           ,1.0,1.0,73.0
991,Liikkuminen,2019-07-19 02:41:47.865168518,2019-07-19,2019-07-19,2019-07-19,2.0,-8.73,3037.62,0.0,162.0,           ,1.0,1.0,116.0
992,Kulttuuri_viihde,2019-07-19 19:24:56.629213461,2019-07-19,2019-07-19,2019-07-19,2.0,-114.84,2922.78,0.0,162.0,           ,1.0,1.0,45.0
993,Ruoka_paivittaistavarakauppa,2019-07-22 04:51:14.157303347,2019-07-22,2019-07-24,2019-07-22,2.0,-27.51,2895.27,0.0,162.0,           ,1.0,1.0,146.0
994,Liikkuminen,2019-07-22 12:08:05.393258404,2019-07-22,2019-07-22,2019-07-22,2.0,-86.12,2809.15,0.0,162.0,           ,1.0,1.0,124.0
995,Ravintolat_kahvilat,2019-07-22 14:17:31.685393233,2019-07-22,2019-07-22,2019-07-22,2.0,-42.66,2766.49,0.0,162.0,           ,1.0,1.0,105.0
996,Ruoka_paivittaistavarakauppa,2019-07-22 21:34:22.921348290,2019-07-22,2019-07-22,2019-07-22,2.0,-4.58,2761.91,0.0,162.0,           ,1.0,1.0,150.0
997,Tulot,2019-07-23 07:00:40.449438176,2019-07-23,2019-07-24,2019-07-23,2.0,1155.81,3917.72,0.0,505.0,           ,1.0,1.0,161.0
998,Liikkuminen,2019-07-24 16:26:57.977528062,2019-07-24,2019-07-24,2019-07-24,2.0,-123.25,3794.47,0.0,162.0,           ,1.0,1.0,136.0
999,Tulot,2019-07-24 23:43:49.213483119,2019-07-24,2019-07-24,2019-07-24,2.0,7.25,3801.72,0.0,505.0,           ,1.0,1.0,161.0
1000,Ravintolat_kahvilat,2019-07-25 01:53:15.505617948,2019-07-25,2019-07-26,2019-07-25,2.0,-50.92,3750.8,0.0,162.0,           ,1.0,1.0,105.0
1001,Tulot,2019-07-25 09:10:06.741573005,2019-07-25,2019-07-25,2019-07-25,2.0,2.6,3753.4,0.0,505.0,           ,1.0,1.0,162.0
1002,Ruoka_paivittaistavarakauppa,2019-07-25 11:19:33.033707834,2019-07-25,2019-07-25,2019-07-25,2.0,-43.35,3710.05,0.0,162.0,           ,1.0,1.0,102.0
1003,Terveys,2019-07-25 18:36:24.269662891,2019-07-25,2019-07-25,2019-07-25,2.0,-41.9,3668.15,0.0,162.0,           ,1.0,1.0,146.0
1004,Ruoka_paivittaistavarakauppa,2019-07-29 04:02:41.797752777,2019-07-29,2019-07-29,2019-07-29,2.0,-12.76,3655.39,0.0,162.0,           ,1.0,1.0,151.0
1005,Ravintolat_kahvilat,2019-07-29 13:28:59.325842663,2019-07-29,2019-07-29,2019-07-29,2.0,-158.52,3496.87,0.0,162.0,           ,1.0,1.0,84.0
1006,Lapset,2019-07-29 20:45:50.561797720,2019-07-29,2019-07-29,2019-07-29,2.0,-49.74,3447.13,0.0,162.0,           ,1.0,1.0,81.0
1007,Lemmikit,2019-07-30 06:12:08.089887606,2019-07-30,2019-07-30,2019-07-30,2.0,-253.2,3193.93,706.0,129.0,OKOYFIHH   ,0.0,0.0,203.0
1008,Ruoka_paivittaistavarakauppa,2019-07-30 15:38:25.617977492,2019-07-30,2019-07-30,2019-07-30,2.0,-3.49,3190.44,0.0,162.0,           ,1.0,1.0,75.0
1009,Ravintolat_kahvilat,2019-07-30 22:55:16.853932549,2019-07-30,2019-07-30,2019-07-30,2.0,-2.47,3187.97,0.0,162.0,           ,1.0,1.0,75.0
1010,Tulot,2019-08-01 13:24:19.459459459,2019-08-01,2019-08-01,2019-08-01,2.0,4.78,3192.75,0.0,505.0,           ,1.0,1.0,161.0
1011,Liikkuminen,2019-08-01 19:01:37.297297295,2019-08-01,2019-08-01,2019-08-01,2.0,-69.64,3123.11,0.0,162.0,           ,1.0,1.0,63.0
1012,Tulot,2019-08-02 02:48:38.918918918,2019-08-02,2019-08-02,2019-08-02,2.0,819.95,3943.06,0.0,505.0,           ,1.0,1.0,161.0
1013,Matkailu,2019-08-02 05:37:17.837837836,2019-08-02,2019-08-02,2019-08-02,2.0,-19.14,3923.92,706.0,129.0,OKOYFIHH   ,0.0,0.0,199.0
1014,Tulot,2019-08-02 08:25:56.756756754,2019-08-02,2019-08-02,2019-08-02,2.0,97.15,4021.07,701.0,520.0,           ,1.0,1.0,176.0
1015,Luottojen_maksut,2019-08-02 16:12:58.378378377,2019-08-02,2019-08-02,2019-08-02,2.0,-9.4,4011.67,0.0,162.0,           ,1.0,1.0,126.0
1016,Luottojen_maksut,2019-08-05 11:14:35.675675672,2019-08-05,2019-08-05,2019-08-05,2.0,-821.55,3190.12,0.0,106.0,OKOYFIHH   ,0.0,0.0,19.0
1017,Liikkuminen,2019-08-05 16:51:53.513513508,2019-08-05,2019-08-05,2019-08-05,2.0,-10.26,3179.86,0.0,162.0,           ,1.0,1.0,105.0
1018,Lapset,2019-08-05 21:50:16.216216213,2019-08-05,2019-08-05,2019-08-05,2.0,-23.61,3156.25,0.0,162.0,           ,1.0,1.0,78.0
1019,Luokittelemattomat,2019-08-06 14:03:14.594594590,2019-08-06,2019-08-06,2019-08-06,2.0,-54.58,3101.67,706.0,106.0,OKOYFIHH   ,1.0,0.0,195.0
1020,Ruoka_paivittaistavarakauppa,2019-08-06 19:40:32.432432426,2019-08-06,2019-08-06,2019-08-06,2.0,-10.85,3090.82,0.0,162.0,           ,1.0,1.0,75.0
1021,Muut,2019-08-07 00:38:55.135135131,2019-08-07,2019-08-07,2019-08-07,2.0,-161.08,2929.74,0.0,163.0,           ,1.0,1.0,153.0
1022,Muut,2019-08-07 03:27:34.054054049,2019-08-07,2019-08-07,2019-08-07,2.0,-288.16,2641.58,0.0,163.0,           ,1.0,1.0,153.0
1023,Ruoka_paivittaistavarakauppa,2019-08-07 06:16:12.972972967,2019-08-07,2019-08-07,2019-08-07,2.0,-17.28,2624.3,0.0,162.0,           ,1.0,1.0,106.0
1024,Kulttuuri_viihde,2019-08-09 09:04:51.891891885,2019-08-09,2019-08-09,2019-08-09,2.0,-49.18,2575.12,0.0,162.0,           ,1.0,1.0,88.0
1025,Liikkuminen,2019-08-09 22:29:11.351351344,2019-08-09,2019-08-09,2019-08-09,2.0,-18.74,2556.38,0.0,162.0,           ,1.0,1.0,79.0
1026,Tulot,2019-08-10 11:53:30.810810803,2019-08-10,2019-08-10,2019-08-10,2.0,1235.84,3792.22,0.0,505.0,           ,1.0,1.0,161.0
1027,Ruoka_paivittaistavarakauppa,2019-08-12 01:17:50.270270262,2019-08-12,2019-08-12,2019-08-12,2.0,-9.74,3782.48,0.0,162.0,           ,1.0,1.0,126.0
1028,Ruoka_paivittaistavarakauppa,2019-08-12 04:06:29.189189180,2019-08-12,2019-08-12,2019-08-12,2.0,-133.9,3648.58,0.0,162.0,           ,1.0,1.0,128.0
1029,Saastot_sijoitukset,2019-08-12 06:55:08.108108098,2019-08-12,2019-08-12,2019-08-12,2.0,-9.84,3638.74,0.0,162.0,           ,1.0,1.0,28.0
1030,Ravintolat_kahvilat,2019-08-12 17:30:48.648648639,2019-08-12,2019-08-12,2019-08-12,2.0,-2.66,3636.08,0.0,162.0,           ,1.0,1.0,147.0
1031,Tulot,2019-08-13 09:43:47.027027016,2019-08-13,2019-08-13,2019-08-13,2.0,-233.4,3402.68,0.0,162.0,           ,1.0,1.0,117.0
1032,Kulttuuri_viihde,2019-08-13 14:42:09.729729721,2019-08-13,2019-08-13,2019-08-13,2.0,-54.5,3348.18,0.0,162.0,           ,1.0,1.0,94.0
1033,Muut,2019-08-14 20:19:27.567567557,2019-08-14,2019-08-14,2019-08-14,2.0,-65.9,3282.28,0.0,163.0,           ,1.0,1.0,152.0
1034,Ruoka_paivittaistavarakauppa,2019-08-14 23:08:06.486486475,2019-08-14,2019-08-14,2019-08-14,2.0,-5.3,3276.98,0.0,162.0,           ,1.0,1.0,121.0
1035,Ravintolat_kahvilat,2019-08-15 12:32:25.945945934,2019-08-15,2019-08-15,2019-08-15,2.0,-1.57,3275.41,0.0,162.0,           ,1.0,1.0,72.0
1036,Liikkuminen,2019-08-16 01:56:45.405405393,2019-08-16,2019-08-16,2019-08-16,2.0,-16.25,3259.16,0.0,162.0,           ,1.0,1.0,27.0
1037,Tulot,2019-08-16 15:21:04.864864852,2019-08-16,2019-08-16,2019-08-16,2.0,-132.56,3126.6,0.0,162.0,           ,1.0,1.0,75.0
1038,Tulot,2019-08-17 04:45:24.324324311,2019-08-17,2019-08-17,2019-08-17,2.0,499.13,3625.73,0.0,505.0,           ,1.0,1.0,162.0
1039,Muut,2019-08-17 18:09:43.783783770,2019-08-17,2019-08-17,2019-08-17,2.0,-27.56,3598.17,0.0,163.0,           ,1.0,1.0,154.0
1040,Ruoka_paivittaistavarakauppa,2019-08-19 07:34:03.243243229,2019-08-19,2019-08-19,2019-08-19,2.0,-1.13,3597.04,0.0,162.0,           ,1.0,1.0,83.0
1041,Liikkuminen,2019-08-19 10:22:42.162162147,2019-08-19,2019-08-19,2019-08-19,2.0,-37.11,3559.93,0.0,162.0,           ,1.0,1.0,146.0
1042,Ravintolat_kahvilat,2019-08-19 20:58:22.702702688,2019-08-19,2019-08-19,2019-08-19,2.0,-2.29,3557.64,0.0,162.0,           ,1.0,1.0,113.0
1043,Luokittelemattomat,2019-08-19 23:47:01.621621606,2019-08-19,2019-08-19,2019-08-16,2.0,-12.15,3545.49,0.0,162.0,           ,1.0,1.0,79.0
1044,Tulot,2019-08-20 13:11:21.081081065,2019-08-20,2019-08-20,2019-08-19,2.0,231.98,3777.47,0.0,505.0,           ,1.0,1.0,163.0
1045,Tulot,2019-08-20 15:59:59.999999983,2019-08-20,2019-08-20,2019-08-20,2.0,130.99,3908.46,701.0,520.0,           ,1.0,1.0,178.0
1046,Luokittelemattomat,2019-08-21 02:35:40.540540524,2019-08-21,2019-08-21,2019-08-21,2.0,-3.6,3904.86,0.0,162.0,           ,1.0,1.0,85.0
1047,Ruoka_paivittaistavarakauppa,2019-08-21 05:24:19.459459442,2019-08-21,2019-08-22,2019-08-21,2.0,-33.16,3871.7,0.0,162.0,           ,1.0,1.0,135.0
1048,Luokittelemattomat,2019-08-21 18:48:38.918918901,2019-08-21,2019-08-21,2019-08-21,2.0,-21.15,3850.55,0.0,162.0,           ,1.0,1.0,150.0
1049,Ravintolat_kahvilat,2019-08-22 21:37:17.837837819,2019-08-22,2019-08-22,2019-08-22,2.0,-3.81,3846.74,0.0,162.0,           ,1.0,1.0,91.0
1050,Asuminen,2019-08-23 08:12:58.378378360,2019-08-23,2019-08-23,2019-08-23,2.0,-78.04,3768.7,0.0,162.0,           ,1.0,1.0,94.0
1051,Vakuutukset,2019-08-23 11:01:37.297297278,2019-08-23,2019-08-23,2019-08-23,2.0,-246.17,3522.53,706.0,106.0,OKOYFIHH   ,0.0,0.0,193.0
1052,Ravintolat_kahvilat,2019-08-26 03:14:35.675675655,2019-08-26,2019-08-26,2019-08-26,2.0,-5.12,3517.41,0.0,162.0,           ,1.0,1.0,45.0
1053,Ruoka_paivittaistavarakauppa,2019-08-26 13:50:16.216216196,2019-08-26,2019-08-28,2019-08-26,2.0,-7.21,3510.2,0.0,162.0,           ,1.0,1.0,73.0
1054,Ruoka_paivittaistavarakauppa,2019-08-26 16:38:55.135135114,2019-08-26,2019-08-26,2019-08-26,2.0,-8.59,3501.61,0.0,162.0,           ,1.0,1.0,75.0
1055,Ruoka_paivittaistavarakauppa,2019-08-27 00:25:56.756756737,2019-08-27,2019-08-27,2019-08-27,2.0,-24.32,3477.29,0.0,162.0,           ,1.0,1.0,114.0
1056,Shoppailu,2019-08-27 06:03:14.594594573,2019-08-27,2019-08-27,2019-08-27,2.0,-94.93,3382.36,0.0,162.0,           ,1.0,1.0,75.0
1057,Muut,2019-08-27 22:16:12.972972950,2019-08-27,2019-08-27,2019-08-27,2.0,-77.54,3304.82,0.0,163.0,           ,1.0,1.0,152.0
1058,Saastot_sijoitukset,2019-08-28 11:40:32.432432409,2019-08-28,2019-08-28,2019-08-28,2.0,-1.63,3303.19,0.0,162.0,           ,1.0,1.0,101.0
1059,Tulot,2019-08-28 19:27:34.054054032,2019-08-28,2019-08-28,2019-08-30,2.0,481.78,3784.97,0.0,505.0,           ,1.0,1.0,163.0
1060,Harrastukset,2019-08-29 01:04:51.891891868,2019-08-29,2019-08-29,2019-08-29,2.0,-39.46,3745.51,0.0,162.0,           ,1.0,1.0,47.0
1061,Muut,2019-08-29 08:51:53.513513491,2019-08-29,2019-08-29,2019-08-28,2.0,-51.61,3693.9,0.0,163.0,           ,1.0,1.0,152.0
1062,Ruoka_paivittaistavarakauppa,2019-08-29 14:29:11.351351327,2019-08-29,2019-08-29,2019-08-29,2.0,-5.01,3688.89,0.0,162.0,           ,1.0,1.0,87.0
1063,Matkailu,2019-08-30 03:53:30.810810786,2019-08-30,2019-08-30,2019-08-30,2.0,-204.86,3484.03,706.0,129.0,OKOYFIHH   ,0.0,0.0,196.0
1064,Luottojen_maksut,2019-08-30 17:17:50.270270245,2019-08-30,2019-08-30,2019-08-30,2.0,-188.6,3295.43,706.0,147.0,OKOYFIHH   ,0.0,0.0,210.0
1065,Tulot,2019-09-02 15:27:07.397260272,2019-09-02,2019-09-02,2019-09-02,2.0,604.12,3899.55,701.0,520.0,           ,1.0,1.0,181.0
1066,Tulot,2019-09-02 19:43:33.698630136,2019-09-02,2019-09-02,2019-09-02,2.0,1032.75,4932.3,701.0,520.0,           ,1.0,1.0,177.0
1067,Liikkuminen,2019-09-03 11:10:41.095890408,2019-09-03,2019-09-03,2019-09-03,2.0,-19.05,4913.25,0.0,162.0,           ,1.0,1.0,57.0
1068,Luottojen_maksut,2019-09-04 06:54:14.794520544,2019-09-04,2019-09-04,2019-09-04,2.0,-681.25,4232.0,0.0,106.0,OKOYFIHH   ,0.0,0.0,18.0
1069,Ruoka_paivittaistavarakauppa,2019-09-04 22:21:22.191780816,2019-09-04,2019-09-04,2019-09-04,2.0,-11.69,4220.31,0.0,162.0,           ,1.0,1.0,27.0
1070,Muut,2019-09-05 02:37:48.493150680,2019-09-05,2019-09-05,2019-09-05,2.0,-73.87,4146.44,0.0,163.0,           ,1.0,1.0,154.0
1071,Ruoka_paivittaistavarakauppa,2019-09-06 13:48:29.589041088,2019-09-06,2019-09-06,2019-09-06,2.0,-32.34,4114.1,0.0,162.0,           ,1.0,1.0,77.0
1072,Ravintolat_kahvilat,2019-09-06 18:04:55.890410952,2019-09-06,2019-09-06,2019-09-06,2.0,-12.21,4101.89,0.0,162.0,           ,1.0,1.0,105.0
1073,Liikkuminen,2019-09-09 05:15:36.986301360,2019-09-09,2019-09-09,2019-09-09,2.0,-52.99,4048.9,0.0,162.0,           ,1.0,1.0,99.0
1074,Liikkuminen,2019-09-09 09:32:03.287671224,2019-09-09,2019-09-09,2019-09-09,2.0,-98.18,3950.72,0.0,162.0,           ,1.0,1.0,60.0
1075,Matkailu,2019-09-10 00:59:10.684931496,2019-09-10,2019-09-10,2019-09-10,2.0,-6.64,3944.08,0.0,162.0,           ,1.0,1.0,108.0
1076,Muut,2019-09-10 16:26:18.082191768,2019-09-10,2019-09-10,2019-09-10,2.0,-94.31,3849.77,0.0,163.0,           ,1.0,1.0,155.0
1077,Saastot_sijoitukset,2019-09-10 20:42:44.383561632,2019-09-10,2019-09-10,2019-09-10,2.0,-7.35,3842.42,0.0,162.0,           ,1.0,1.0,93.0
1078,Ruoka_paivittaistavarakauppa,2019-09-12 07:53:25.479452040,2019-09-12,2019-09-12,2019-09-12,2.0,-27.38,3815.04,0.0,162.0,           ,1.0,1.0,90.0
1079,Ruoka_paivittaistavarakauppa,2019-09-13 03:36:59.178082176,2019-09-13,2019-09-13,2019-09-13,2.0,-17.57,3797.47,0.0,162.0,           ,1.0,1.0,41.0
1080,Tulot,2019-09-13 12:09:51.780821904,2019-09-13,2019-09-13,2019-09-13,2.0,1284.78,5082.25,701.0,520.0,           ,1.0,1.0,177.0
1081,Ruoka_paivittaistavarakauppa,2019-09-16 14:47:40.273972584,2019-09-16,2019-09-16,2019-09-16,2.0,-92.76,4989.49,0.0,162.0,           ,1.0,1.0,75.0
1082,Ravintolat_kahvilat,2019-09-16 19:04:06.575342448,2019-09-16,2019-09-16,2019-09-16,2.0,-6.15,4983.34,0.0,162.0,           ,1.0,1.0,93.0
1083,Ravintolat_kahvilat,2019-09-16 23:20:32.876712312,2019-09-16,2019-09-16,2019-09-16,2.0,-1.58,4981.76,0.0,162.0,           ,1.0,1.0,45.0
1084,Ravintolat_kahvilat,2019-09-18 06:14:47.671232856,2019-09-18,2019-09-18,2019-09-18,2.0,-24.53,4957.23,0.0,162.0,           ,1.0,1.0,75.0
1085,Ravintolat_kahvilat,2019-09-18 10:31:13.972602720,2019-09-18,2019-09-18,2019-09-18,2.0,-23.26,4933.97,0.0,162.0,           ,1.0,1.0,97.0
1086,Lapset,2019-09-19 01:58:21.369862992,2019-09-19,2019-09-19,2019-09-19,2.0,-48.69,4885.28,0.0,162.0,           ,1.0,1.0,37.0
1087,Ravintolat_kahvilat,2019-09-19 21:41:55.068493128,2019-09-19,2019-09-19,2019-09-19,2.0,-40.73,4844.55,0.0,162.0,           ,1.0,1.0,146.0
1088,Muut,2019-09-20 17:25:28.767123264,2019-09-20,2019-09-20,2019-09-20,2.0,-80.34,4764.21,0.0,163.0,           ,1.0,1.0,153.0
1089,Ruoka_paivittaistavarakauppa,2019-09-23 00:19:43.561643808,2019-09-23,2019-09-23,2019-09-23,2.0,-6.41,4757.8,0.0,162.0,           ,1.0,1.0,42.0
1090,Ruoka_paivittaistavarakauppa,2019-09-23 04:36:09.863013672,2019-09-23,2019-09-23,2019-09-23,2.0,-50.97,4706.83,0.0,162.0,           ,1.0,1.0,95.0
1091,Saastot_sijoitukset,2019-09-23 08:52:36.164383536,2019-09-23,2019-09-23,2019-09-23,2.0,-56.67,4650.16,0.0,162.0,           ,1.0,1.0,111.0
1092,Ruoka_paivittaistavarakauppa,2019-09-23 13:09:02.465753400,2019-09-23,2019-09-23,2019-09-23,2.0,-43.44,4606.72,0.0,162.0,           ,1.0,1.0,128.0
1093,Ruoka_paivittaistavarakauppa,2019-09-23 20:03:17.260273944,2019-09-23,2019-09-23,2019-09-23,2.0,-29.43,4577.29,0.0,162.0,           ,1.0,1.0,57.0
1094,Ruoka_paivittaistavarakauppa,2019-09-24 11:30:24.657534216,2019-09-24,2019-09-24,2019-09-24,2.0,-20.29,4557.0,0.0,162.0,           ,1.0,1.0,34.0
1095,Terveys,2019-09-24 15:46:50.958904080,2019-09-24,2019-09-24,2019-09-24,2.0,-32.35,4524.65,0.0,162.0,           ,1.0,1.0,57.0
1096,Ravintolat_kahvilat,2019-09-26 02:57:32.054794488,2019-09-26,2019-09-26,2019-09-26,2.0,-88.54,4436.11,0.0,162.0,           ,1.0,1.0,77.0
1097,Ruoka_paivittaistavarakauppa,2019-09-27 07:13:58.356164352,2019-09-27,2019-09-27,2019-09-27,2.0,-22.64,4413.47,0.0,162.0,           ,1.0,1.0,116.0
1098,Liikkuminen,2019-09-27 18:24:39.452054760,2019-09-27,2019-09-27,2019-09-27,2.0,-18.66,4394.81,0.0,162.0,           ,1.0,1.0,95.0
1099,Shoppailu,2019-09-27 22:41:05.753424624,2019-09-27,2019-09-27,2019-09-27,2.0,-3.48,4391.33,0.0,162.0,           ,1.0,1.0,111.0
1100,Muut,2019-09-30 14:08:13.150684896,2019-09-30,2019-09-30,2019-09-30,2.0,-23.55,4367.78,0.0,163.0,           ,1.0,1.0,152.0
1101,Asuminen,2019-10-01 22:53:32.307692307,2019-10-01,2019-10-01,2019-09-30,2.0,-320.54,4047.24,706.0,129.0,NDEAFIHH   ,0.0,0.0,201.0
1102,Liikkuminen,2019-10-02 21:47:04.615384614,2019-10-02,2019-10-02,2019-10-02,2.0,-8.89,4038.35,0.0,162.0,           ,1.0,1.0,105.0
1103,Ravintolat_kahvilat,2019-10-03 20:40:36.923076921,2019-10-03,2019-10-03,2019-10-03,2.0,-17.02,4021.33,0.0,162.0,           ,1.0,1.0,81.0
1104,Ruoka_paivittaistavarakauppa,2019-10-04 19:34:09.230769228,2019-10-04,2019-10-04,2019-10-04,2.0,-13.8,4007.53,0.0,162.0,           ,1.0,1.0,90.0
1105,Shoppailu,2019-10-07 15:08:18.461538456,2019-10-07,2019-10-08,2019-10-07,2.0,-96.6,3910.93,706.0,129.0,OKOYFIHH   ,0.0,0.0,204.0
1106,Ravintolat_kahvilat,2019-10-07 16:14:46.153846149,2019-10-07,2019-10-07,2019-10-07,2.0,-3.18,3907.75,0.0,162.0,           ,1.0,1.0,57.0
1107,Ruoka_paivittaistavarakauppa,2019-10-07 17:21:13.846153842,2019-10-07,2019-10-07,2019-10-07,2.0,-12.84,3894.91,0.0,162.0,           ,1.0,1.0,79.0
1108,Ruoka_paivittaistavarakauppa,2019-10-07 18:27:41.538461535,2019-10-07,2019-10-07,2019-10-07,2.0,-45.21,3849.7,0.0,162.0,           ,1.0,1.0,70.0
1109,Tulot,2019-10-08 14:01:50.769230763,2019-10-08,2019-10-08,2019-10-07,2.0,4.69,3854.39,710.0,588.0,           ,0.0,1.0,216.0
1110,Ruoka_paivittaistavarakauppa,2019-10-10 12:55:23.076923070,2019-10-10,2019-10-10,2019-10-10,2.0,-46.08,3808.31,0.0,162.0,           ,1.0,1.0,57.0
1111,Ravintolat_kahvilat,2019-10-11 11:48:55.384615377,2019-10-11,2019-10-11,2019-10-11,2.0,-5.45,3802.86,0.0,162.0,           ,1.0,1.0,37.0
1112,Liikkuminen,2019-10-14 08:29:32.307692298,2019-10-14,2019-10-14,2019-10-14,2.0,-7.98,3794.88,0.0,162.0,           ,1.0,1.0,26.0
1113,Lemmikit,2019-10-14 09:35:59.999999991,2019-10-14,2019-10-14,2019-10-14,2.0,-5.3,3789.58,0.0,162.0,           ,1.0,1.0,112.0
1114,Muut,2019-10-14 10:42:27.692307684,2019-10-14,2019-10-15,2019-10-14,2.0,-93.92,3695.66,0.0,163.0,           ,1.0,1.0,154.0
1115,Muut,2019-10-15 07:23:04.615384605,2019-10-15,2019-10-15,2019-10-15,2.0,-50.56,3645.1,0.0,162.0,           ,1.0,1.0,112.0
1116,Muut,2019-10-16 06:16:36.923076912,2019-10-16,2019-10-16,2019-10-16,2.0,-82.71,3562.39,0.0,163.0,           ,1.0,1.0,152.0
1117,Ruoka_paivittaistavarakauppa,2019-10-17 05:10:09.230769219,2019-10-17,2019-10-17,2019-10-17,2.0,-8.16,3554.23,0.0,162.0,           ,1.0,1.0,103.0
1118,Lemmikit,2019-10-18 02:57:13.846153833,2019-10-18,2019-10-18,2019-10-18,2.0,-15.22,3539.01,0.0,162.0,           ,1.0,1.0,89.0
1119,Muut,2019-10-18 04:03:41.538461526,2019-10-18,2019-10-18,2019-10-18,2.0,-53.23,3485.78,0.0,163.0,           ,1.0,1.0,152.0
1120,Ruoka_paivittaistavarakauppa,2019-10-21 00:44:18.461538447,2019-10-21,2019-10-21,2019-10-21,2.0,-14.99,3470.79,0.0,162.0,           ,1.0,1.0,26.0
1121,Ruoka_paivittaistavarakauppa,2019-10-21 01:50:46.153846140,2019-10-21,2019-10-21,2019-10-21,2.0,-8.3,3462.49,0.0,162.0,           ,1.0,1.0,70.0
1122,Ruoka_paivittaistavarakauppa,2019-10-21 23:37:50.769230754,2019-10-21,2019-10-23,2019-10-21,2.0,-31.33,3431.16,0.0,162.0,           ,1.0,1.0,105.0
1123,Ruoka_paivittaistavarakauppa,2019-10-22 22:31:23.076923061,2019-10-22,2019-10-22,2019-10-22,2.0,-4.04,3427.12,0.0,162.0,           ,1.0,1.0,26.0
1124,Hyvinvointi,2019-10-24 20:18:27.692307675,2019-10-24,2019-10-24,2019-10-24,2.0,-15.88,3411.24,0.0,162.0,           ,1.0,1.0,139.0
1125,Ruoka_paivittaistavarakauppa,2019-10-25 18:05:32.307692289,2019-10-25,2019-10-25,2019-10-25,2.0,-3.41,3407.83,0.0,162.0,           ,1.0,1.0,85.0
1126,Vakuutukset,2019-10-25 19:11:59.999999982,2019-10-25,2019-10-25,2019-10-25,2.0,-134.15,3273.68,706.0,129.0,OKOYFIHH   ,0.0,0.0,197.0
1127,Tulot,2019-10-25 21:24:55.384615368,2019-10-25,2019-10-25,2019-10-22,2.0,527.4,3801.08,701.0,506.0,           ,1.0,1.0,173.0
1128,Ruoka_paivittaistavarakauppa,2019-10-28 15:52:36.923076903,2019-10-28,2019-10-28,2019-10-28,2.0,-3.38,3797.7,0.0,162.0,           ,1.0,1.0,84.0
1129,Ruoka_paivittaistavarakauppa,2019-10-28 16:59:04.615384596,2019-10-28,2019-10-28,2019-10-28,2.0,-29.96,3767.74,0.0,162.0,           ,1.0,1.0,149.0
1130,Ruoka_paivittaistavarakauppa,2019-10-30 13:39:41.538461517,2019-10-30,2019-10-30,2019-10-30,2.0,-22.84,3744.9,0.0,162.0,           ,1.0,1.0,91.0
1131,Ravintolat_kahvilat,2019-10-30 14:46:09.230769210,2019-10-30,2019-10-30,2019-10-30,2.0,-8.44,3736.46,0.0,162.0,           ,1.0,1.0,131.0
1132,Muut,2019-10-31 12:33:13.846153824,2019-10-31,2019-10-31,2019-10-31,2.0,-24.41,3712.05,0.0,163.0,           ,1.0,1.0,152.0
1133,Ravintolat_kahvilat,2019-11-01 03:25:42.857142856,2019-11-01,2019-11-01,2019-11-01,2.0,-24.69,3687.36,0.0,162.0,           ,1.0,1.0,123.0
1134,Ruoka_paivittaistavarakauppa,2019-11-01 13:42:51.428571428,2019-11-01,2019-11-01,2019-11-01,2.0,-2.06,3685.3,0.0,162.0,           ,1.0,1.0,75.0
1135,Tulot,2019-11-01 17:08:34.285714284,2019-11-01,2019-11-01,2019-11-01,2.0,272.96,3958.26,701.0,506.0,           ,1.0,1.0,174.0
1136,Lapset,2019-11-03 06:51:25.714285712,2019-11-03,2019-11-03,2019-11-03,2.0,-62.21,3896.05,0.0,106.0,OKOYFIHH   ,0.0,0.0,20.0
1137,Asuminen,2019-11-03 20:34:17.142857140,2019-11-03,2019-11-03,2019-11-03,2.0,-36.11,3859.94,0.0,129.0,OKOYFIHH   ,0.0,0.0,24.0
1138,Kulttuuri_viihde,2019-11-04 10:17:08.571428568,2019-11-04,2019-11-04,2019-11-04,2.0,-31.38,3828.56,0.0,129.0,OKOYFIHH   ,0.0,0.0,25.0
1139,Tulot,2019-11-04 23:59:59.999999996,2019-11-04,2019-11-04,2019-11-04,2.0,124.74,3953.3,710.0,506.0,           ,1.0,1.0,215.0
1140,Muut,2019-11-05 13:42:51.428571424,2019-11-05,2019-11-05,2019-11-05,2.0,-58.75,3894.55,0.0,163.0,           ,1.0,1.0,152.0
1141,Tulot,2019-11-06 03:25:42.857142852,2019-11-06,2019-11-06,2019-11-06,2.0,2.34,3896.89,710.0,588.0,           ,0.0,1.0,216.0
1142,Ravintolat_kahvilat,2019-11-06 17:08:34.285714280,2019-11-06,2019-11-06,2019-11-06,2.0,-5.47,3891.42,0.0,162.0,           ,1.0,1.0,41.0
1143,Hyvinvointijakauneus,2019-11-07 06:51:25.714285708,2019-11-07,2019-11-07,2019-11-07,2.0,-20.42,3871.0,0.0,162.0,           ,1.0,1.0,71.0
1144,Liikkuminen,2019-11-07 10:17:08.571428564,2019-11-07,2019-11-07,2019-11-07,2.0,-90.95,3780.05,0.0,162.0,           ,1.0,1.0,45.0
1145,Ravintolat_kahvilat,2019-11-07 20:34:17.142857136,2019-11-07,2019-11-07,2019-11-07,2.0,-3.63,3776.42,0.0,162.0,           ,1.0,1.0,79.0
1146,Liikkuminen,2019-11-07 23:59:59.999999992,2019-11-07,2019-11-07,2019-11-07,2.0,-3.78,3772.64,0.0,162.0,           ,1.0,1.0,123.0
1147,Ruoka_paivittaistavarakauppa,2019-11-11 03:25:42.857142848,2019-11-11,2019-11-11,2019-11-11,2.0,-17.85,3754.79,0.0,162.0,           ,1.0,1.0,26.0
1148,Ruoka_paivittaistavarakauppa,2019-11-11 06:51:25.714285704,2019-11-11,2019-11-13,2019-11-11,2.0,-6.99,3747.8,0.0,162.0,           ,1.0,1.0,136.0
1149,Muut,2019-11-11 13:42:51.428571420,2019-11-11,2019-11-11,2019-11-11,2.0,-16.28,3731.52,0.0,162.0,           ,1.0,1.0,146.0
1150,Asuminen,2019-11-11 17:08:34.285714276,2019-11-11,2019-11-11,2019-11-11,2.0,-23.49,3708.03,0.0,162.0,           ,1.0,1.0,116.0
1151,Ravintolat_kahvilat,2019-11-11 20:34:17.142857132,2019-11-11,2019-11-11,2019-11-11,2.0,-9.4,3698.63,0.0,162.0,           ,1.0,1.0,84.0
1152,Shoppailu,2019-11-12 03:25:42.857142844,2019-11-12,2019-11-12,2019-11-12,2.0,-23.74,3674.89,0.0,162.0,           ,1.0,1.0,103.0
1153,Saastot_sijoitukset,2019-11-12 10:17:08.571428560,2019-11-12,2019-11-12,2019-11-12,2.0,-74.23,3600.66,0.0,162.0,           ,1.0,1.0,90.0
1154,Ruoka_paivittaistavarakauppa,2019-11-12 23:59:59.999999988,2019-11-12,2019-11-12,2019-11-12,2.0,-50.84,3549.82,0.0,162.0,           ,1.0,1.0,72.0
1155,Luottojen_maksut,2019-11-13 17:08:34.285714272,2019-11-13,2019-11-13,2019-11-13,2.0,-34.93,3514.89,706.0,129.0,OKOYFIHH   ,0.0,0.0,196.0
1156,Matkailu,2019-11-14 13:42:51.428571416,2019-11-14,2019-11-14,2019-11-14,2.0,-3201.94,312.95,0.0,163.0,           ,1.0,1.0,152.0
1157,Luokittelemattomat,2019-11-15 06:51:25.714285700,2019-11-15,2019-11-15,2019-11-15,2.0,-39.44,273.51,706.0,129.0,OKOYFIHH   ,0.0,0.0,197.0
1158,Luokittelemattomat,2019-11-15 10:17:08.571428556,2019-11-15,2019-11-15,2019-11-15,2.0,-57.93,215.58,706.0,106.0,NDEAFIHH   ,1.0,0.0,191.0
1159,Muut,2019-11-15 20:34:17.142857128,2019-11-15,2019-11-15,2019-11-15,2.0,-56.72,158.86,0.0,163.0,           ,1.0,1.0,153.0
1160,Ravintolat_kahvilat,2019-11-15 23:59:59.999999984,2019-11-15,2019-11-15,2019-11-15,2.0,-6.48,152.38,0.0,162.0,           ,1.0,1.0,27.0
1161,Ruoka_paivittaistavarakauppa,2019-11-18 03:25:42.857142840,2019-11-18,2019-11-18,2019-11-18,2.0,-44.1,108.28,0.0,162.0,           ,1.0,1.0,70.0
1162,Liikkuminen,2019-11-18 13:42:51.428571412,2019-11-18,2019-11-18,2019-11-18,2.0,-84.16,24.12,0.0,162.0,           ,1.0,1.0,65.0
1163,Ravintolat_kahvilat,2019-11-18 17:08:34.285714268,2019-11-18,2019-11-18,2019-11-18,2.0,-2.48,21.64,0.0,162.0,           ,1.0,1.0,70.0
1164,Liikkuminen,2019-11-19 06:51:25.714285696,2019-11-19,2019-11-19,2019-11-19,2.0,-17.26,4.38,0.0,162.0,           ,1.0,1.0,102.0
1165,Ruoka_paivittaistavarakauppa,2019-11-19 20:34:17.142857124,2019-11-19,2019-11-19,2019-11-19,2.0,-3.44,0.94,0.0,162.0,           ,1.0,1.0,105.0
1166,Vakuutukset,2019-11-20 03:25:42.857142836,2019-11-20,2019-11-20,2019-11-20,2.0,-3.87,-2.93,0.0,106.0,NDEAFIHH   ,0.0,0.0,15.0
1167,Lapset,2019-11-20 10:17:08.571428552,2019-11-20,2019-11-20,2019-11-20,2.0,-10.18,-13.11,0.0,162.0,           ,1.0,1.0,73.0
1168,Tulot,2019-11-20 13:42:51.428571408,2019-11-20,2019-11-21,2019-11-20,2.0,152.15,139.04,0.0,574.0,           ,1.0,1.0,171.0
1169,Asuminen,2019-11-20 23:59:59.999999980,2019-11-20,2019-11-20,2019-11-20,2.0,-87.72,51.32,706.0,129.0,OKOYFIHH   ,0.0,0.0,196.0
1170,Hyvinvointi,2019-11-22 06:51:25.714285692,2019-11-22,2019-11-22,2019-11-22,2.0,-11.61,39.71,706.0,129.0,OKOYFIHH   ,0.0,0.0,196.0
1171,Tulot,2019-11-22 17:08:34.285714264,2019-11-22,2019-11-22,2019-11-22,2.0,488.75,528.46,701.0,506.0,           ,1.0,1.0,172.0
1172,Muut,2019-11-22 20:34:17.142857120,2019-11-22,2019-11-22,2019-11-22,2.0,-124.02,404.44,0.0,163.0,           ,1.0,1.0,152.0
1173,Tulot,2019-11-25 10:17:08.571428548,2019-11-25,2019-11-25,2019-11-25,2.0,2.12,406.56,710.0,506.0,           ,1.0,1.0,214.0
1174,Matkailu,2019-11-25 13:42:51.428571404,2019-11-25,2019-11-25,2019-11-25,2.0,-21.53,385.03,0.0,162.0,           ,1.0,1.0,65.0
1175,Terveys,2019-11-26 03:25:42.857142832,2019-11-26,2019-11-26,2019-11-26,2.0,-9.81,375.22,0.0,162.0,           ,1.0,1.0,131.0
1176,Asuminen,2019-11-26 10:17:08.571428544,2019-11-26,2019-11-26,2019-11-26,2.0,-42.93,332.29,0.0,162.0,           ,1.0,1.0,143.0
1177,Ruoka_paivittaistavarakauppa,2019-11-26 17:08:34.285714260,2019-11-26,2019-11-26,2019-11-26,2.0,-28.53,303.76,0.0,162.0,           ,1.0,1.0,74.0
1178,Ruoka_paivittaistavarakauppa,2019-11-26 23:59:59.999999976,2019-11-26,2019-11-26,2019-11-26,2.0,-17.73,286.03,0.0,162.0,           ,1.0,1.0,136.0
1179,Ruoka_paivittaistavarakauppa,2019-11-27 06:51:25.714285688,2019-11-27,2019-11-27,2019-11-27,2.0,-18.17,267.86,0.0,162.0,           ,1.0,1.0,56.0
1180,Harrastukset,2019-11-27 20:34:17.142857116,2019-11-27,2019-11-27,2019-11-27,2.0,-3.37,264.49,0.0,162.0,           ,1.0,1.0,105.0
1181,Ruoka_paivittaistavarakauppa,2019-11-28 13:42:51.428571400,2019-11-28,2019-11-28,2019-11-28,2.0,-6.04,258.45,0.0,162.0,           ,1.0,1.0,97.0
1182,Liikkuminen,2019-11-28 23:59:59.999999972,2019-11-28,2019-11-28,2019-11-28,2.0,-17.85,240.6,0.0,162.0,           ,1.0,1.0,112.0
1183,Vakuutukset,2019-11-29 03:25:42.857142828,2019-11-29,2019-11-29,2019-11-29,2.0,-47.6,193.0,0.0,106.0,OKOYFIHH   ,0.0,0.0,1.0
1184,Tulot,2019-11-29 17:08:34.285714256,2019-11-29,2019-11-29,2019-11-29,2.0,3379.26,3572.26,701.0,506.0,           ,1.0,1.0,172.0
1185,Ruoka_paivittaistavarakauppa,2019-12-02 10:12:24.827586206,2019-12-02,2019-12-02,2019-12-02,2.0,-46.69,3525.57,0.0,162.0,           ,1.0,1.0,118.0
1186,Asuminen,2019-12-02 17:06:12.413793103,2019-12-02,2019-12-02,2019-12-02,2.0,-17.11,3508.46,706.0,129.0,OKOYFIHH   ,0.0,0.0,199.0
1187,Ruoka_paivittaistavarakauppa,2019-12-03 03:18:37.241379309,2019-12-03,2019-12-03,2019-12-03,2.0,-31.28,3477.18,0.0,162.0,           ,1.0,1.0,37.0
1188,Ruoka_paivittaistavarakauppa,2019-12-03 20:24:49.655172412,2019-12-03,2019-12-03,2019-12-03,2.0,-69.95,3407.23,0.0,162.0,           ,1.0,1.0,37.0
1189,Ruoka_paivittaistavarakauppa,2019-12-04 13:31:02.068965515,2019-12-04,2019-12-04,2019-12-04,2.0,-5.39,3401.84,0.0,162.0,           ,1.0,1.0,50.0
1190,Ruoka_paivittaistavarakauppa,2019-12-05 06:37:14.482758618,2019-12-05,2019-12-05,2019-12-05,2.0,-37.61,3364.23,0.0,162.0,           ,1.0,1.0,131.0
1191,Ruoka_paivittaistavarakauppa,2019-12-05 16:49:39.310344824,2019-12-05,2019-12-05,2019-12-05,2.0,-9.94,3354.29,0.0,162.0,           ,1.0,1.0,94.0
1192,Ruoka_paivittaistavarakauppa,2019-12-05 23:43:26.896551721,2019-12-05,2019-12-05,2019-12-05,2.0,-19.65,3334.64,0.0,162.0,           ,1.0,1.0,146.0
1193,Tulot,2019-12-06 20:08:16.551724133,2019-12-06,2019-12-06,2019-12-06,2.0,1908.29,5242.93,701.0,506.0,           ,1.0,1.0,173.0
1194,Liikkuminen,2019-12-09 03:02:04.137931030,2019-12-09,2019-12-09,2019-12-09,2.0,-55.07,5187.86,0.0,162.0,           ,1.0,1.0,57.0
1195,Ruoka_paivittaistavarakauppa,2019-12-09 09:55:51.724137927,2019-12-09,2019-12-09,2019-12-09,2.0,-8.76,5179.1,0.0,162.0,           ,1.0,1.0,91.0
1196,Lemmikit,2019-12-09 13:14:28.965517236,2019-12-09,2019-12-09,2019-12-09,2.0,-40.67,5138.43,0.0,162.0,           ,1.0,1.0,134.0
1197,Saastot_sijoitukset,2019-12-10 06:20:41.379310339,2019-12-10,2019-12-10,2019-12-10,2.0,-1.42,5137.01,0.0,162.0,           ,1.0,1.0,83.0
1198,Liikkuminen,2019-12-10 23:26:53.793103442,2019-12-10,2019-12-10,2019-12-10,2.0,-20.05,5116.96,0.0,162.0,           ,1.0,1.0,94.0
1199,Luokittelemattomat,2019-12-12 09:39:18.620689648,2019-12-12,2019-12-12,2019-12-12,2.0,-29.13,5087.83,706.0,129.0,NDEAFIHH   ,0.0,0.0,196.0
1200,Liikkuminen,2019-12-12 19:51:43.448275854,2019-12-12,2019-12-12,2019-12-12,2.0,-8.93,5078.9,0.0,162.0,           ,1.0,1.0,128.0
1201,Muut,2019-12-13 02:45:31.034482751,2019-12-13,2019-12-13,2019-12-13,2.0,-135.39,4943.51,0.0,163.0,           ,1.0,1.0,153.0
1202,Tulot,2019-12-13 16:33:06.206896545,2019-12-13,2019-12-13,2019-12-13,2.0,3201.52,8145.03,701.0,506.0,           ,1.0,1.0,173.0
1203,Asuminen,2019-12-16 06:04:08.275862060,2019-12-16,2019-12-16,2019-12-16,2.0,-43.64,8101.39,0.0,106.0,OKOYFIHH   ,0.0,0.0,9.0
1204,Ruoka_paivittaistavarakauppa,2019-12-16 12:57:55.862068957,2019-12-16,2019-12-16,2019-12-16,2.0,-9.2,8092.19,0.0,162.0,           ,1.0,1.0,73.0
1205,Muut,2019-12-16 16:16:33.103448266,2019-12-16,2019-12-16,2019-12-16,2.0,-111.33,7980.86,0.0,162.0,           ,1.0,1.0,57.0
1206,Saastot_sijoitukset,2019-12-16 23:10:20.689655163,2019-12-16,2019-12-16,2019-12-16,2.0,-31.4,7949.46,0.0,162.0,           ,1.0,1.0,103.0
1207,Ruoka_paivittaistavarakauppa,2019-12-18 02:28:57.931034472,2019-12-18,2019-12-18,2019-12-18,2.0,-31.34,7918.12,0.0,162.0,           ,1.0,1.0,30.0
1208,Hyvinvointi,2019-12-18 09:22:45.517241369,2019-12-18,2019-12-18,2019-12-18,2.0,-3.08,7915.04,0.0,162.0,           ,1.0,1.0,54.0
1209,Muut,2019-12-18 19:35:10.344827575,2019-12-18,2019-12-18,2019-12-18,2.0,-0.69,7914.35,0.0,162.0,           ,1.0,1.0,108.0
1210,Vakuutukset,2019-12-20 05:47:35.172413781,2019-12-20,2019-12-20,2019-12-20,2.0,-5123.49,2790.86,0.0,106.0,OKOYFIHH   ,0.0,0.0,1.0
1211,Asuminen,2019-12-20 12:41:22.758620678,2019-12-20,2019-12-20,2019-12-20,2.0,-291.88,2498.98,0.0,106.0,NDEAFIHH   ,0.0,0.0,22.0
1212,Liikkuminen,2019-12-20 15:59:59.999999987,2019-12-20,2019-12-20,2019-12-16,2.0,-18.18,2480.8,0.0,162.0,           ,1.0,1.0,88.0
1213,Muut,2019-12-20 22:53:47.586206884,2019-12-20,2019-12-20,2019-12-20,2.0,-399.72,2081.08,0.0,163.0,           ,1.0,1.0,152.0
1214,Ruoka_paivittaistavarakauppa,2019-12-23 02:12:24.827586193,2019-12-23,2019-12-23,2019-12-23,2.0,-5.34,2075.74,0.0,162.0,           ,1.0,1.0,75.0
1215,Lapset,2019-12-23 09:06:12.413793090,2019-12-23,2019-12-23,2019-12-23,2.0,-127.37,1948.37,706.0,129.0,DABAFIHH   ,0.0,0.0,200.0
1216,Luottojen_maksut,2019-12-23 19:18:37.241379296,2019-12-23,2019-12-23,2019-12-23,2.0,-21.89,1926.48,0.0,162.0,           ,1.0,1.0,96.0
1217,Luokittelemattomat,2019-12-25 12:24:49.655172399,2019-12-25,2019-12-25,2019-12-25,2.0,-25.1,1901.38,0.0,162.0,           ,1.0,1.0,72.0
1218,Ruoka_paivittaistavarakauppa,2019-12-26 05:31:02.068965502,2019-12-26,2019-12-26,2019-12-26,2.0,-26.16,1875.22,0.0,162.0,           ,1.0,1.0,27.0
1219,Terveys,2019-12-26 22:37:14.482758605,2019-12-26,2019-12-26,2019-12-26,2.0,-28.16,1847.06,0.0,162.0,           ,1.0,1.0,76.0
1220,Ruoka_paivittaistavarakauppa,2019-12-27 01:55:51.724137914,2019-12-27,2019-12-27,2019-12-27,2.0,-51.66,1795.4,0.0,162.0,           ,1.0,1.0,107.0
1221,Ruoka_paivittaistavarakauppa,2019-12-27 08:49:39.310344811,2019-12-27,2019-12-27,2019-12-27,2.0,-2.95,1792.45,0.0,162.0,           ,1.0,1.0,102.0
1222,Ravintolat_kahvilat,2019-12-27 15:43:26.896551708,2019-12-27,2019-12-27,2019-12-27,2.0,-5.16,1787.29,0.0,162.0,           ,1.0,1.0,89.0
1223,Liikkuminen,2019-12-30 05:14:28.965517223,2019-12-30,2019-12-30,2019-12-30,2.0,-37.07,1750.22,0.0,162.0,           ,1.0,1.0,139.0
1224,Luokittelemattomat,2019-12-30 12:08:16.551724120,2019-12-30,2019-12-30,2019-12-30,2.0,-89.35,1660.87,0.0,106.0,NDEAFIHH   ,0.0,0.0,11.0
1225,Ruoka_paivittaistavarakauppa,2019-12-30 19:02:04.137931017,2019-12-30,2019-12-30,2019-12-30,2.0,-3.26,1657.61,0.0,162.0,           ,1.0,1.0,126.0
1226,Luokittelemattomat,2019-12-30 22:20:41.379310326,2019-12-30,2019-12-30,2019-12-30,2.0,-4.74,1652.87,0.0,162.0,           ,1.0,1.0,102.0
1227,Saastot_sijoitukset,2019-12-31 15:26:53.793103429,2019-12-31,2019-12-31,2019-12-31,2.0,-75.45,1577.42,706.0,129.0,SBANFIHH   ,0.0,0.0,196.0
1228,Lapset,2020-01-01 12:17:51.074380165,2020-01-01,2020-01-01,2020-01-01,2.0,-16.62,1560.8,706.0,106.0,OKOYFIHH   ,0.0,0.0,190.0
1229,Harrastukset,2020-01-02 00:35:42.148760330,2020-01-02,2020-01-02,2020-01-02,2.0,-53.15,1507.65,706.0,129.0,OKOYFIHH   ,0.0,0.0,199.0
1230,Ruoka_paivittaistavarakauppa,2020-01-02 12:53:33.223140495,2020-01-02,2020-01-02,2020-01-02,2.0,-28.49,1479.16,0.0,162.0,           ,1.0,1.0,94.0
1231,Liikkuminen,2020-01-03 01:11:24.297520660,2020-01-03,2020-01-03,2020-01-03,2.0,-23.96,1455.2,0.0,162.0,           ,1.0,1.0,116.0
1232,Shoppailu,2020-01-03 01:47:06.446280990,2020-01-03,2020-01-03,2020-01-03,2.0,-201.97,1253.23,706.0,129.0,ESSEFIHX   ,0.0,0.0,199.0
1233,Ravintolat_kahvilat,2020-01-03 13:29:15.371900825,2020-01-03,2020-01-03,2020-01-03,2.0,-6.39,1246.84,0.0,162.0,           ,1.0,1.0,94.0
1234,Luokittelemattomat,2020-01-03 14:04:57.520661155,2020-01-03,2020-01-03,2020-01-03,2.0,-17.13,1229.71,706.0,129.0,OKOYFIHH   ,0.0,0.0,196.0
1235,Shoppailu,2020-01-06 02:22:48.595041320,2020-01-06,2020-01-06,2020-01-06,2.0,-59.5,1170.21,0.0,162.0,           ,1.0,1.0,121.0
1236,Luokittelemattomat,2020-01-06 02:58:30.743801650,2020-01-06,2020-01-08,2020-01-06,2.0,-29.07,1141.14,0.0,106.0,OKOYFIHH   ,0.0,0.0,8.0
1237,Liikkuminen,2020-01-06 14:40:39.669421485,2020-01-06,2020-01-06,2020-01-06,2.0,-20.85,1120.29,0.0,162.0,           ,1.0,1.0,83.0
1238,Luokittelemattomat,2020-01-06 15:16:21.818181815,2020-01-06,2020-01-06,2020-01-06,2.0,-898.62,221.67,0.0,106.0,DABAFIHH   ,1.0,0.0,8.0
1239,Ruoka_paivittaistavarakauppa,2020-01-07 03:34:12.892561980,2020-01-07,2020-01-08,2020-01-07,2.0,-10.84,210.83,0.0,162.0,           ,1.0,1.0,70.0
1240,Ruoka_paivittaistavarakauppa,2020-01-07 15:52:03.966942145,2020-01-07,2020-01-07,2020-01-07,2.0,-27.56,183.27,0.0,162.0,           ,1.0,1.0,81.0
1241,Muut,2020-01-08 16:27:46.115702475,2020-01-08,2020-01-08,2020-01-08,2.0,-65.64,117.63,0.0,163.0,           ,1.0,1.0,152.0
1242,Ravintolat_kahvilat,2020-01-08 18:14:52.561983465,2020-01-08,2020-01-08,2020-01-08,2.0,-10.14,107.49,0.0,162.0,           ,1.0,1.0,110.0
1243,Ruoka_paivittaistavarakauppa,2020-01-09 04:09:55.041322310,2020-01-09,2020-01-09,2020-01-09,2.0,-24.68,82.81,0.0,162.0,           ,1.0,1.0,90.0
1244,Ruoka_paivittaistavarakauppa,2020-01-09 04:45:37.190082640,2020-01-09,2020-01-09,2020-01-09,2.0,-18.81,64.0,0.0,162.0,           ,1.0,1.0,85.0
1245,Ruoka_paivittaistavarakauppa,2020-01-09 17:03:28.264462805,2020-01-09,2020-01-10,2020-01-09,2.0,-69.42,-5.42,0.0,162.0,           ,1.0,1.0,83.0
1246,Ravintolat_kahvilat,2020-01-10 05:21:19.338842970,2020-01-10,2020-01-10,2020-01-10,2.0,-4.93,-10.35,0.0,162.0,           ,1.0,1.0,26.0
1247,Hyvinvointijakauneus,2020-01-10 05:57:01.487603300,2020-01-10,2020-01-10,2020-01-10,2.0,-3.66,-14.01,0.0,162.0,           ,1.0,1.0,126.0
1248,Asuminen,2020-01-10 17:39:10.413223135,2020-01-10,2020-01-10,2020-01-10,2.0,-55.2,-69.21,706.0,129.0,OKOYFIHH   ,0.0,0.0,197.0
1249,Lemmikit,2020-01-13 06:32:43.636363630,2020-01-13,2020-01-13,2020-01-13,2.0,-10.98,-80.19,0.0,162.0,           ,1.0,1.0,99.0
1250,Ruoka_paivittaistavarakauppa,2020-01-13 07:08:25.785123960,2020-01-13,2020-01-13,2020-01-13,2.0,-11.97,-92.16,0.0,162.0,           ,1.0,1.0,26.0
1251,Liikkuminen,2020-01-13 19:26:16.859504125,2020-01-13,2020-01-13,2020-01-13,2.0,-66.71,-158.87,0.0,106.0,NDEAFIHH   ,0.0,0.0,18.0
1252,Ruoka_paivittaistavarakauppa,2020-01-14 18:50:34.710743795,2020-01-14,2020-01-14,2020-01-14,2.0,-1.68,-160.55,0.0,162.0,           ,1.0,1.0,149.0
1253,Ruoka_paivittaistavarakauppa,2020-01-14 20:01:59.008264455,2020-01-14,2020-01-14,2020-01-14,2.0,-3.37,-163.92,0.0,162.0,           ,1.0,1.0,121.0
1254,Harrastukset,2020-01-15 07:44:07.933884290,2020-01-15,2020-01-15,2020-01-15,2.0,-93.14,-257.06,706.0,129.0,OKOYFIHH   ,0.0,0.0,200.0
1255,Tulot,2020-01-15 08:19:50.082644620,2020-01-15,2020-01-15,2020-01-15,2.0,34.7,-222.36,710.0,506.0,           ,1.0,1.0,213.0
1256,Vakuutukset,2020-01-15 20:37:41.157024785,2020-01-15,2020-01-15,2020-01-15,2.0,-17.23,-239.59,706.0,129.0,DABAFIHH   ,0.0,0.0,201.0
1257,Luottojen_maksut,2020-01-16 08:55:32.231404950,2020-01-16,2020-01-16,2020-01-16,2.0,-20.05,-259.64,706.0,129.0,NDEAFIHH   ,0.0,0.0,199.0
1258,Luokittelemattomat,2020-01-16 09:31:14.380165280,2020-01-16,2020-01-16,2020-01-16,2.0,-4.55,-264.19,0.0,162.0,           ,1.0,1.0,136.0
1259,Liikkuminen,2020-01-16 21:49:05.454545445,2020-01-16,2020-01-16,2020-01-16,2.0,-4.3,-268.49,0.0,162.0,           ,1.0,1.0,99.0
1260,Tulot,2020-01-17 10:06:56.528925610,2020-01-17,2020-01-17,2020-01-17,2.0,554.81,286.32,0.0,505.0,           ,1.0,1.0,162.0
1261,Kulttuuri_viihde,2020-01-17 21:13:23.305785115,2020-01-17,2020-01-17,2020-01-17,2.0,-11.44,274.88,0.0,162.0,           ,1.0,1.0,136.0
1262,Harrastukset,2020-01-19 22:24:47.603305775,2020-01-19,2020-01-19,2020-01-19,2.0,-116.26,158.62,0.0,106.0,OKOYFIHH   ,0.0,0.0,20.0
1263,Saastot_sijoitukset,2020-01-20 10:42:38.677685940,2020-01-20,2020-01-21,2020-01-20,2.0,-10.83,147.79,0.0,162.0,           ,1.0,1.0,56.0
1264,Shoppailu,2020-01-20 11:18:20.826446270,2020-01-20,2020-01-20,2020-01-20,2.0,-13.28,134.51,0.0,162.0,           ,1.0,1.0,55.0
1265,Liikkuminen,2020-01-20 23:00:29.752066105,2020-01-20,2020-01-20,2020-01-20,2.0,-8.03,126.48,0.0,162.0,           ,1.0,1.0,114.0
1266,Ruoka_paivittaistavarakauppa,2020-01-20 23:36:11.900826435,2020-01-20,2020-01-20,2020-01-20,2.0,-12.9,113.58,0.0,162.0,           ,1.0,1.0,121.0
1267,Liikkuminen,2020-01-22 00:11:54.049586765,2020-01-22,2020-01-22,2020-01-22,2.0,-35.52,78.06,0.0,162.0,           ,1.0,1.0,84.0
1268,Luokittelemattomat,2020-01-22 11:54:02.975206600,2020-01-22,2020-01-22,2020-01-22,2.0,-18.63,59.43,0.0,106.0,NDEAFIHH   ,0.0,0.0,4.0
1269,Luokittelemattomat,2020-01-22 12:29:45.123966930,2020-01-22,2020-01-22,2020-01-22,2.0,-2.36,57.07,0.0,162.0,           ,1.0,1.0,85.0
1270,Asuminen,2020-01-22 13:05:27.272727260,2020-01-22,2020-01-22,2020-01-22,2.0,-16.32,40.75,706.0,129.0,DABAFIHH   ,0.0,0.0,202.0
1271,Matkailu,2020-01-23 14:16:51.570247920,2020-01-23,2020-01-23,2020-01-23,2.0,-3.04,37.71,0.0,162.0,           ,1.0,1.0,143.0
1272,Muut,2020-01-24 00:47:36.198347095,2020-01-24,2020-01-24,2020-01-24,2.0,-36.51,1.2,0.0,163.0,           ,1.0,1.0,155.0
1273,Ruoka_paivittaistavarakauppa,2020-01-24 01:23:18.347107425,2020-01-24,2020-01-24,2020-01-24,2.0,-29.16,-27.96,0.0,162.0,           ,1.0,1.0,83.0
1274,Ruoka_paivittaistavarakauppa,2020-01-24 13:41:09.421487590,2020-01-24,2020-01-24,2020-01-24,2.0,-1.13,-29.09,0.0,162.0,           ,1.0,1.0,102.0
1275,Lapset,2020-01-27 01:59:00.495867755,2020-01-27,2020-01-27,2020-01-27,2.0,-1.11,-30.2,0.0,162.0,           ,1.0,1.0,113.0
1276,Vakuutukset,2020-01-27 03:10:24.793388415,2020-01-27,2020-01-27,2020-01-27,2.0,-4.43,-34.63,706.0,129.0,OKOYFIHH   ,0.0,0.0,197.0
1277,Lapset,2020-01-27 04:21:49.090909075,2020-01-27,2020-01-27,2020-01-27,2.0,-41.12,-75.75,0.0,162.0,           ,1.0,1.0,103.0
1278,Tulot,2020-01-27 14:52:33.719008250,2020-01-27,2020-01-27,2020-01-27,2.0,282.09,206.34,710.0,506.0,           ,1.0,1.0,211.0
1279,Luottojen_maksut,2020-01-27 15:28:15.867768580,2020-01-27,2020-01-27,2020-01-27,2.0,-18.12,188.22,0.0,162.0,           ,1.0,1.0,84.0
1280,Ruoka_paivittaistavarakauppa,2020-01-28 02:34:42.644628085,2020-01-28,2020-01-29,2020-01-28,2.0,-4.63,183.59,0.0,162.0,           ,1.0,1.0,60.0
1281,Muut,2020-01-28 03:46:06.942148745,2020-01-28,2020-01-28,2020-01-28,2.0,-10.19,173.4,706.0,129.0,DABAFIHH   ,0.0,0.0,196.0
1282,Matkailu,2020-01-28 16:03:58.016528910,2020-01-28,2020-01-28,2020-01-28,2.0,-60.62,112.78,706.0,106.0,DABAFIHH   ,1.0,0.0,187.0
1283,Ruoka_paivittaistavarakauppa,2020-01-29 04:57:31.239669405,2020-01-29,2020-01-29,2020-01-29,2.0,-3.78,109.0,0.0,162.0,           ,1.0,1.0,27.0
1284,Ruoka_paivittaistavarakauppa,2020-01-29 05:33:13.388429735,2020-01-29,2020-01-29,2020-01-29,2.0,-3.83,105.17,0.0,162.0,           ,1.0,1.0,26.0
1285,Matkailu,2020-01-29 16:39:40.165289240,2020-01-29,2020-01-29,2020-01-29,2.0,-1.79,103.38,0.0,162.0,           ,1.0,1.0,129.0
1286,Liikkuminen,2020-01-29 17:15:22.314049570,2020-01-29,2020-01-29,2020-01-29,2.0,-73.61,29.77,0.0,162.0,           ,1.0,1.0,37.0
1287,Asuminen,2020-01-31 17:51:04.462809900,2020-01-31,2020-01-31,2020-01-31,2.0,-24.96,4.81,706.0,129.0,OKOYFIHH   ,0.0,0.0,199.0
1288,Ruoka_paivittaistavarakauppa,2020-02-03 00:50:31.578947368,2020-02-03,2020-02-03,2020-02-03,2.0,-5.72,-0.91,0.0,162.0,           ,1.0,1.0,132.0
1289,Tulot,2020-02-04 00:25:15.789473684,2020-02-04,2020-02-04,2020-02-04,2.0,164.24,163.33,701.0,520.0,           ,1.0,1.0,177.0
1290,Lemmikit,2020-02-04 01:15:47.368421052,2020-02-04,2020-02-04,2020-02-04,2.0,-27.35,135.98,0.0,162.0,           ,1.0,1.0,126.0
1291,Ruoka_paivittaistavarakauppa,2020-02-04 01:41:03.157894736,2020-02-04,2020-02-04,2020-02-04,2.0,-5.97,130.01,0.0,162.0,           ,1.0,1.0,137.0
1292,Asuminen,2020-02-04 02:06:18.947368420,2020-02-04,2020-02-04,2020-02-04,2.0,-8.71,121.3,0.0,162.0,           ,1.0,1.0,97.0
1293,Tulot,2020-02-07 02:31:34.736842104,2020-02-07,2020-02-07,2020-02-07,2.0,34.67,155.97,0.0,506.0,           ,1.0,1.0,164.0
1294,Ravintolat_kahvilat,2020-02-07 02:56:50.526315788,2020-02-07,2020-02-07,2020-02-07,2.0,-4.64,151.33,0.0,162.0,           ,1.0,1.0,26.0
1295,Asuminen,2020-02-09 03:22:06.315789472,2020-02-09,2020-02-09,2020-02-09,2.0,-20.25,131.08,0.0,106.0,OKOYFIHH   ,0.0,0.0,17.0
1296,Luokittelemattomat,2020-02-10 03:47:22.105263156,2020-02-10,2020-02-10,2020-02-10,2.0,-156.13,-25.05,0.0,106.0,OKOYFIHH   ,1.0,0.0,2.0
1297,Luokittelemattomat,2020-02-11 04:12:37.894736840,2020-02-11,2020-02-11,2020-02-11,2.0,-17.06,-42.11,0.0,106.0,OKOYFIHH   ,1.0,0.0,14.0
1298,Ruoka_paivittaistavarakauppa,2020-02-11 04:37:53.684210524,2020-02-11,2020-02-11,2020-02-11,2.0,-0.94,-43.05,0.0,162.0,           ,1.0,1.0,73.0
1299,Ruoka_paivittaistavarakauppa,2020-02-13 05:28:25.263157892,2020-02-13,2020-02-13,2020-02-13,2.0,-116.71,-159.76,706.0,129.0,OKOYFIHH   ,0.0,0.0,196.0
1300,Ruoka_paivittaistavarakauppa,2020-02-14 05:03:09.473684208,2020-02-14,2020-02-14,2020-02-14,2.0,-0.35,-160.11,0.0,162.0,           ,1.0,1.0,116.0
1301,Muut,2020-02-15 05:53:41.052631576,2020-02-15,2020-02-17,2020-02-15,2.0,-14.14,-174.25,0.0,163.0,           ,1.0,1.0,154.0
1302,Liikkuminen,2020-02-17 06:18:56.842105260,2020-02-17,2020-02-17,2020-02-17,2.0,-21.68,-195.93,0.0,162.0,           ,1.0,1.0,77.0
1303,Asuminen,2020-02-17 06:44:12.631578944,2020-02-17,2020-02-17,2020-02-17,2.0,-68.6,-264.53,706.0,129.0,OKOYFIHH   ,0.0,0.0,199.0
1304,Ruoka_paivittaistavarakauppa,2020-02-18 07:09:28.421052628,2020-02-18,2020-02-18,2020-02-18,2.0,-1.53,-266.06,0.0,162.0,           ,1.0,1.0,70.0
1305,Ruoka_paivittaistavarakauppa,2020-02-19 07:34:44.210526312,2020-02-19,2020-02-19,2020-02-19,2.0,-1.85,-267.91,0.0,162.0,           ,1.0,1.0,83.0
1306,Tulot,2020-02-19 07:59:59.999999996,2020-02-19,2020-02-19,2020-02-19,2.0,-91.25,-359.16,706.0,129.0,OKOYFIHH   ,0.0,0.0,196.0
1307,Lapset,2020-02-19 08:50:31.578947364,2020-02-19,2020-02-19,2020-02-19,2.0,-0.94,-360.1,0.0,162.0,           ,1.0,1.0,60.0
1308,Asuminen,2020-02-20 08:25:15.789473680,2020-02-20,2020-02-20,2020-02-20,2.0,-16.07,-376.17,706.0,129.0,DABAFIHH   ,0.0,0.0,204.0
1309,Ruoka_paivittaistavarakauppa,2020-02-24 09:15:47.368421048,2020-02-24,2020-02-24,2020-02-24,2.0,-2.93,-379.1,0.0,162.0,           ,1.0,1.0,71.0
1310,Ruoka_paivittaistavarakauppa,2020-02-24 09:41:03.157894732,2020-02-24,2020-02-24,2020-02-24,2.0,-15.44,-394.54,0.0,162.0,           ,1.0,1.0,136.0
1311,Ruoka_paivittaistavarakauppa,2020-02-25 10:06:18.947368416,2020-02-25,2020-02-25,2020-02-25,2.0,-12.09,-406.63,0.0,162.0,           ,1.0,1.0,104.0
1312,Ruoka_paivittaistavarakauppa,2020-02-27 10:31:34.736842100,2020-02-27,2020-02-27,2020-02-27,2.0,-43.18,-449.81,0.0,162.0,           ,1.0,1.0,83.0
1313,Lapset,2020-02-27 10:56:50.526315784,2020-02-27,2020-02-27,2020-02-27,2.0,-9.73,-459.54,0.0,162.0,           ,1.0,1.0,50.0
1314,Tulot,2020-02-28 11:22:06.315789468,2020-02-28,2020-02-28,2020-02-28,2.0,-36.15,-495.69,706.0,129.0,OKOYFIHH   ,0.0,0.0,196.0
1315,Luokittelemattomat,2020-02-28 11:47:22.105263152,2020-02-28,2020-02-28,2020-02-28,2.0,-0.67,-496.36,0.0,162.0,           ,1.0,1.0,27.0
1316,Tulot,2020-03-02 05:10:35.294117647,2020-03-02,2020-03-02,2020-03-02,2.0,659.95,163.59,701.0,520.0,           ,1.0,1.0,176.0
1317,Ruoka_paivittaistavarakauppa,2020-03-03 10:21:10.588235294,2020-03-03,2020-03-03,2020-03-03,2.0,-16.15,147.44,0.0,162.0,           ,1.0,1.0,71.0
1318,Ruoka_paivittaistavarakauppa,2020-03-04 15:31:45.882352941,2020-03-04,2020-03-04,2020-03-04,2.0,-4.94,142.5,0.0,162.0,           ,1.0,1.0,86.0
1319,Ruoka_paivittaistavarakauppa,2020-03-06 20:42:21.176470588,2020-03-06,2020-03-06,2020-03-06,2.0,-21.45,121.05,0.0,162.0,           ,1.0,1.0,79.0
1320,Vakuutukset,2020-03-09 01:52:56.470588235,2020-03-09,2020-03-09,2020-03-09,2.0,-42.68,78.37,706.0,129.0,OKOYFIHH   ,0.0,0.0,200.0
1321,Ruoka_paivittaistavarakauppa,2020-03-09 07:03:31.764705882,2020-03-09,2020-03-09,2020-03-09,2.0,-3.67,74.7,0.0,162.0,           ,1.0,1.0,48.0
1322,Ravintolat_kahvilat,2020-03-09 12:14:07.058823529,2020-03-09,2020-03-12,2020-03-09,2.0,-22.1,52.6,0.0,162.0,           ,1.0,1.0,75.0
1323,Luokittelemattomat,2020-03-09 17:24:42.352941176,2020-03-09,2020-03-09,2020-03-09,2.0,-67.8,-15.2,706.0,106.0,NDEAFIHH   ,0.0,0.0,189.0
1324,Ruoka_paivittaistavarakauppa,2020-03-11 22:35:17.647058823,2020-03-11,2020-03-11,2020-03-11,2.0,-7.61,-22.81,0.0,162.0,           ,1.0,1.0,76.0
1325,Muut,2020-03-13 03:45:52.941176470,2020-03-13,2020-03-13,2020-03-13,2.0,-31.56,-54.37,0.0,163.0,           ,1.0,1.0,153.0
1326,Luottojen_maksut,2020-03-13 08:56:28.235294117,2020-03-13,2020-03-13,2020-03-13,2.0,-1.35,-55.72,0.0,162.0,           ,1.0,1.0,76.0
1327,Ravintolat_kahvilat,2020-03-16 14:07:03.529411764,2020-03-16,2020-03-16,2020-03-16,2.0,-14.79,-70.51,0.0,162.0,           ,1.0,1.0,70.0
1328,Ruoka_paivittaistavarakauppa,2020-03-16 19:17:38.823529411,2020-03-16,2020-03-16,2020-03-16,2.0,-0.82,-71.33,0.0,162.0,           ,1.0,1.0,116.0
1329,Ravintolat_kahvilat,2020-03-18 00:28:14.117647058,2020-03-18,2020-03-18,2020-03-18,2.0,-11.48,-82.81,0.0,162.0,           ,1.0,1.0,53.0
1330,Ruoka_paivittaistavarakauppa,2020-03-19 05:38:49.411764705,2020-03-19,2020-03-19,2020-03-19,2.0,-6.36,-89.17,0.0,162.0,           ,1.0,1.0,65.0
1331,Tulot,2020-03-20 10:49:24.705882352,2020-03-20,2020-03-20,2020-03-20,2.0,109.33,20.16,0.0,506.0,           ,1.0,1.0,167.0
1332,Ruoka_paivittaistavarakauppa,2020-03-23 07:31:45.882352940,2020-03-23,2020-03-23,2020-03-23,2.0,-6.72,13.44,0.0,162.0,           ,1.0,1.0,27.0
1333,Ruoka_paivittaistavarakauppa,2020-03-23 15:59:59.999999999,2020-03-23,2020-03-23,2020-03-23,2.0,-2.54,10.9,0.0,162.0,           ,1.0,1.0,81.0
1334,Harrastukset,2020-03-23 21:10:35.294117646,2020-03-23,2020-03-23,2020-03-23,2.0,-21.22,-10.32,0.0,162.0,           ,1.0,1.0,45.0
1335,Luottojen_maksut,2020-03-25 02:21:10.588235293,2020-03-25,2020-03-26,2020-03-25,2.0,-3.54,-13.86,0.0,162.0,           ,1.0,1.0,60.0
1336,Lemmikit,2020-03-25 12:42:21.176470587,2020-03-25,2020-03-25,2020-03-25,2.0,-3.54,-17.4,0.0,162.0,           ,1.0,1.0,54.0
1337,Liikkuminen,2020-03-27 17:52:56.470588234,2020-03-27,2020-03-27,2020-03-26,2.0,-8.23,-25.63,0.0,162.0,           ,1.0,1.0,126.0
1338,Ruoka_paivittaistavarakauppa,2020-03-30 04:14:07.058823528,2020-03-30,2020-03-30,2020-03-30,2.0,-1.5,-27.13,0.0,162.0,           ,1.0,1.0,54.0
1339,Ruoka_paivittaistavarakauppa,2020-03-30 23:03:31.764705881,2020-03-30,2020-03-30,2020-03-30,2.0,-6.09,-33.22,0.0,162.0,           ,1.0,1.0,70.0
1340,Asuminen,2020-03-31 09:24:42.352941175,2020-03-31,2020-03-31,2020-03-30,2.0,-52.96,-86.18,706.0,129.0,OKOYFIHH   ,0.0,0.0,196.0
1341,Tulot,2020-04-01 18:13:40.253164556,2020-04-01,2020-04-01,2020-04-01,2.0,952.31,866.13,701.0,520.0,           ,1.0,1.0,179.0
1342,Liikkuminen,2020-04-02 12:27:20.506329112,2020-04-02,2020-04-02,2020-04-02,2.0,-15.23,850.9,0.0,162.0,           ,1.0,1.0,26.0
1343,Luokittelemattomat,2020-04-03 06:41:00.759493668,2020-04-03,2020-04-03,2020-04-03,2.0,-48.91,801.99,0.0,106.0,OKOYFIHH   ,0.0,0.0,13.0
1344,Vakuutukset,2020-04-03 19:08:21.265822780,2020-04-03,2020-04-03,2020-04-03,2.0,-317.51,484.48,706.0,106.0,SBANFIHH   ,0.0,0.0,195.0
1345,Ruoka_paivittaistavarakauppa,2020-04-06 00:54:41.012658224,2020-04-06,2020-04-06,2020-04-06,2.0,-11.05,473.43,0.0,162.0,           ,1.0,1.0,79.0
1346,Ruoka_paivittaistavarakauppa,2020-04-06 07:35:41.772151892,2020-04-06,2020-04-07,2020-04-06,2.0,-3.3,470.13,0.0,162.0,           ,1.0,1.0,136.0
1347,Ravintolat_kahvilat,2020-04-06 13:22:01.518987336,2020-04-06,2020-04-06,2020-04-06,2.0,-8.31,461.82,0.0,162.0,           ,1.0,1.0,83.0
1348,Vakuutukset,2020-04-07 01:49:22.025316448,2020-04-07,2020-04-07,2020-04-07,2.0,-15.07,446.75,706.0,129.0,NDEAFIHH   ,0.0,0.0,200.0
1349,Liikkuminen,2020-04-07 14:16:42.531645560,2020-04-07,2020-04-07,2020-04-07,2.0,-4.8,441.95,0.0,162.0,           ,1.0,1.0,125.0
1350,Ravintolat_kahvilat,2020-04-07 20:03:02.278481004,2020-04-07,2020-04-07,2020-04-07,2.0,-63.84,378.11,0.0,162.0,           ,1.0,1.0,60.0
1351,Liikkuminen,2020-04-09 08:30:22.784810116,2020-04-09,2020-04-09,2020-04-09,2.0,-4.0,374.11,0.0,162.0,           ,1.0,1.0,50.0
1352,Hyvinvointi,2020-04-10 02:44:03.037974672,2020-04-10,2020-04-10,2020-04-10,2.0,-70.6,303.51,0.0,162.0,           ,1.0,1.0,73.0
1353,Tulot,2020-04-10 09:25:03.797468340,2020-04-10,2020-04-10,2020-04-10,2.0,-274.09,29.42,706.0,129.0,SBANFIHH   ,0.0,0.0,202.0
1354,Matkailu,2020-04-10 15:11:23.544303784,2020-04-10,2020-04-10,2020-04-10,2.0,-47.76,-18.34,706.0,129.0,DABAFIHH   ,0.0,0.0,200.0
1355,Muut,2020-04-10 20:57:43.291139228,2020-04-10,2020-04-10,2020-04-10,2.0,-24.75,-43.09,0.0,163.0,           ,1.0,1.0,152.0
1356,Ravintolat_kahvilat,2020-04-13 03:38:44.050632896,2020-04-13,2020-04-13,2020-04-13,2.0,-10.33,-53.42,0.0,162.0,           ,1.0,1.0,101.0
1357,Ruoka_paivittaistavarakauppa,2020-04-13 21:52:24.303797452,2020-04-13,2020-04-13,2020-04-13,2.0,-2.89,-56.31,0.0,162.0,           ,1.0,1.0,95.0
1358,Luokittelemattomat,2020-04-14 04:33:25.063291120,2020-04-14,2020-04-15,2020-04-14,2.0,-9.88,-66.19,0.0,162.0,           ,1.0,1.0,99.0
1359,Harrastukset,2020-04-14 16:06:04.556962008,2020-04-14,2020-04-15,2020-04-14,2.0,-6.97,-73.16,706.0,106.0,DABAFIHH   ,0.0,0.0,194.0
1360,Luottojen_maksut,2020-04-15 10:19:44.810126564,2020-04-15,2020-04-15,2020-04-15,2.0,-23.97,-97.13,0.0,106.0,OKOYFIHH   ,0.0,0.0,22.0
1361,Ruoka_paivittaistavarakauppa,2020-04-16 22:47:05.316455676,2020-04-16,2020-04-17,2020-04-16,2.0,-6.84,-103.97,0.0,162.0,           ,1.0,1.0,139.0
1362,Matkailu,2020-04-17 11:14:25.822784788,2020-04-17,2020-04-17,2020-04-17,2.0,-19.77,-123.74,706.0,106.0,DABAFIHH   ,0.0,0.0,188.0
1363,Lemmikit,2020-04-17 17:00:45.569620232,2020-04-17,2020-04-17,2020-04-17,2.0,-16.61,-140.35,0.0,162.0,           ,1.0,1.0,129.0
1364,Muut,2020-04-18 23:41:46.329113900,2020-04-18,2020-04-18,2020-04-18,2.0,-6.24,-146.59,0.0,163.0,           ,1.0,1.0,153.0
1365,Lapset,2020-04-20 05:28:06.075949344,2020-04-20,2020-04-20,2020-04-20,2.0,-10.73,-157.32,0.0,162.0,           ,1.0,1.0,28.0
1366,Ruoka_paivittaistavarakauppa,2020-04-20 17:55:26.582278456,2020-04-20,2020-04-20,2020-04-20,2.0,-4.46,-161.78,0.0,162.0,           ,1.0,1.0,37.0
1367,Luokittelemattomat,2020-04-22 12:09:06.835443012,2020-04-22,2020-04-22,2020-04-22,2.0,-4.88,-166.66,0.0,162.0,           ,1.0,1.0,116.0
1368,Ruoka_paivittaistavarakauppa,2020-04-23 00:36:27.341772124,2020-04-23,2020-04-23,2020-04-23,2.0,-3.54,-170.2,0.0,162.0,           ,1.0,1.0,91.0
1369,Ruoka_paivittaistavarakauppa,2020-04-23 06:22:47.088607568,2020-04-23,2020-04-23,2020-04-23,2.0,-5.8,-176.0,0.0,162.0,           ,1.0,1.0,120.0
1370,Lapset,2020-04-23 18:50:07.594936680,2020-04-23,2020-04-23,2020-04-23,2.0,-1.83,-177.83,0.0,162.0,           ,1.0,1.0,38.0
1371,Asuminen,2020-04-24 07:17:28.101265792,2020-04-24,2020-04-24,2020-04-24,2.0,-40.57,-218.4,706.0,129.0,OKOYFIHH   ,0.0,0.0,200.0
1372,Asuminen,2020-04-24 13:03:47.848101236,2020-04-24,2020-04-24,2020-04-21,2.0,-11.23,-229.63,706.0,129.0,OKOYFIHH   ,0.0,0.0,196.0
1373,Lapset,2020-04-27 08:12:09.113924016,2020-04-27,2020-04-27,2020-04-27,2.0,-8.06,-237.69,0.0,162.0,           ,1.0,1.0,45.0
1374,Ruoka_paivittaistavarakauppa,2020-04-27 13:58:28.860759460,2020-04-27,2020-04-27,2020-04-27,2.0,-1.24,-238.93,0.0,162.0,           ,1.0,1.0,146.0
1375,Shoppailu,2020-04-27 19:44:48.607594904,2020-04-27,2020-04-27,2020-04-27,2.0,-4.45,-243.38,0.0,162.0,           ,1.0,1.0,113.0
1376,Ruoka_paivittaistavarakauppa,2020-04-28 01:31:08.354430348,2020-04-28,2020-04-28,2020-04-28,2.0,-4.46,-247.84,0.0,162.0,           ,1.0,1.0,45.0
1377,Muut,2020-04-28 20:39:29.620253128,2020-04-28,2020-04-29,2020-04-28,2.0,-33.7,-281.54,0.0,163.0,           ,1.0,1.0,152.0
1378,Asuminen,2020-04-29 02:25:49.367088572,2020-04-29,2020-04-29,2020-04-29,2.0,-10.85,-292.39,706.0,129.0,DABAFIHH   ,0.0,0.0,196.0
1379,Liikkuminen,2020-04-30 14:53:09.873417684,2020-04-30,2020-04-30,2020-04-30,2.0,-9.03,-301.42,0.0,106.0,OKOYFIHH   ,1.0,0.0,20.0
1380,Lemmikit,2020-05-01 14:52:23.661971829,2020-05-01,2020-05-01,2020-05-01,2.0,-8.52,-309.94,0.0,162.0,           ,1.0,1.0,127.0
1381,Liikkuminen,2020-05-01 17:54:55.774647886,2020-05-01,2020-05-01,2020-05-01,2.0,-1.7,-311.64,0.0,162.0,           ,1.0,1.0,84.0
1382,Tulot,2020-05-01 20:57:27.887323943,2020-05-01,2020-05-01,2020-05-01,2.0,76.95,-234.69,701.0,520.0,           ,1.0,1.0,176.0
1383,Ruoka_paivittaistavarakauppa,2020-05-04 11:49:51.549295772,2020-05-04,2020-05-04,2020-05-04,2.0,-2.7,-237.39,0.0,162.0,           ,1.0,1.0,120.0
1384,Ravintolat_kahvilat,2020-05-05 08:47:19.436619715,2020-05-05,2020-05-05,2020-05-05,2.0,-0.76,-238.15,0.0,162.0,           ,1.0,1.0,71.0
1385,Ruoka_paivittaistavarakauppa,2020-05-06 05:44:47.323943658,2020-05-06,2020-05-06,2020-05-06,2.0,-1.91,-240.06,0.0,162.0,           ,1.0,1.0,136.0
1386,Matkailu,2020-05-07 02:42:15.211267601,2020-05-07,2020-05-07,2020-05-07,2.0,-16.65,-256.71,706.0,129.0,NDEAFIHH   ,0.0,0.0,199.0
1387,Liikkuminen,2020-05-07 20:37:10.985915487,2020-05-07,2020-05-07,2020-05-07,2.0,-7.44,-264.15,0.0,162.0,           ,1.0,1.0,126.0
1388,Ravintolat_kahvilat,2020-05-07 23:39:43.098591544,2020-05-07,2020-05-07,2020-05-07,2.0,-7.19,-271.34,0.0,162.0,           ,1.0,1.0,143.0
1389,Asuminen,2020-05-11 11:29:34.647887316,2020-05-11,2020-05-11,2020-05-11,2.0,-9.84,-281.18,706.0,129.0,NDEAFIHH   ,0.0,0.0,197.0
1390,Ruoka_paivittaistavarakauppa,2020-05-11 14:32:06.760563373,2020-05-11,2020-05-11,2020-05-11,2.0,-4.87,-286.05,0.0,162.0,           ,1.0,1.0,106.0
1391,Ruoka_paivittaistavarakauppa,2020-05-11 17:34:38.873239430,2020-05-11,2020-05-11,2020-05-11,2.0,-8.14,-294.19,0.0,162.0,           ,1.0,1.0,137.0
1392,Asuminen,2020-05-12 08:27:02.535211259,2020-05-12,2020-05-12,2020-05-12,2.0,-20.24,-314.43,706.0,129.0,NDEAFIHH   ,0.0,0.0,200.0
1393,Ravintolat_kahvilat,2020-05-13 05:24:30.422535202,2020-05-13,2020-05-13,2020-05-13,2.0,-4.6,-319.03,0.0,162.0,           ,1.0,1.0,40.0
1394,Lemmikit,2020-05-15 02:21:58.309859145,2020-05-15,2020-05-15,2020-05-15,2.0,-38.67,-357.7,0.0,162.0,           ,1.0,1.0,78.0
1395,Ruoka_paivittaistavarakauppa,2020-05-15 17:14:21.971830974,2020-05-15,2020-05-15,2020-05-15,2.0,-3.44,-361.14,0.0,162.0,           ,1.0,1.0,102.0
1396,Ruoka_paivittaistavarakauppa,2020-05-15 20:16:54.084507031,2020-05-15,2020-05-15,2020-05-15,2.0,-2.18,-363.32,0.0,162.0,           ,1.0,1.0,75.0
1397,Muut,2020-05-15 23:19:26.197183088,2020-05-15,2020-05-15,2020-05-15,2.0,-11.11,-374.43,0.0,163.0,           ,1.0,1.0,152.0
1398,Lapset,2020-05-18 11:09:17.746478860,2020-05-18,2020-05-18,2020-05-18,2.0,-4.25,-378.68,0.0,162.0,           ,1.0,1.0,80.0
1399,Asuminen,2020-05-18 14:11:49.859154917,2020-05-18,2020-05-18,2020-05-18,2.0,-19.24,-397.92,706.0,129.0,NDEAFIHH   ,0.0,0.0,196.0
1400,Ruoka_paivittaistavarakauppa,2020-05-19 05:04:13.521126746,2020-05-19,2020-05-20,2020-05-19,2.0,-6.28,-404.2,0.0,162.0,           ,1.0,1.0,82.0
1401,Ruoka_paivittaistavarakauppa,2020-05-19 08:06:45.633802803,2020-05-19,2020-05-19,2020-05-19,2.0,-8.06,-412.26,0.0,162.0,           ,1.0,1.0,28.0
1402,Ruoka_paivittaistavarakauppa,2020-05-20 02:01:41.408450689,2020-05-20,2020-05-20,2020-05-20,2.0,-1.57,-413.83,0.0,162.0,           ,1.0,1.0,116.0
1403,Ruoka_paivittaistavarakauppa,2020-05-21 19:56:37.183098575,2020-05-21,2020-05-21,2020-05-21,2.0,-7.02,-420.85,0.0,162.0,           ,1.0,1.0,101.0
1404,Luottojen_maksut,2020-05-22 16:54:05.070422518,2020-05-22,2020-05-22,2020-05-22,2.0,-832.93,-1253.78,706.0,129.0,OKOYFIHH   ,0.0,0.0,197.0
1405,Ravintolat_kahvilat,2020-05-22 22:59:09.295774632,2020-05-22,2020-05-22,2020-05-22,2.0,-13.17,-1266.95,0.0,162.0,           ,1.0,1.0,30.0
1406,Ruoka_paivittaistavarakauppa,2020-05-25 10:49:00.845070404,2020-05-25,2020-05-25,2020-05-25,2.0,-0.69,-1267.64,0.0,162.0,           ,1.0,1.0,116.0
1407,Harrastukset,2020-05-25 13:51:32.957746461,2020-05-25,2020-05-25,2020-05-25,2.0,-87.82,-1355.46,706.0,129.0,OKOYFIHH   ,0.0,0.0,203.0
1408,Ravintolat_kahvilat,2020-05-26 07:46:28.732394347,2020-05-26,2020-05-26,2020-05-26,2.0,-0.84,-1356.3,0.0,162.0,           ,1.0,1.0,146.0
1409,Ruoka_paivittaistavarakauppa,2020-05-27 01:41:24.507042233,2020-05-27,2020-05-27,2020-05-27,2.0,-17.49,-1373.79,0.0,162.0,           ,1.0,1.0,110.0
1410,Liikkuminen,2020-05-27 04:43:56.619718290,2020-05-27,2020-05-27,2020-05-27,2.0,-4.35,-1378.14,0.0,162.0,           ,1.0,1.0,135.0
1411,Asuminen,2020-05-28 16:33:48.169014062,2020-05-28,2020-05-28,2020-05-28,2.0,-52.15,-1430.29,706.0,129.0,OKOYFIHH   ,0.0,0.0,196.0
1412,Kulttuuri_viihde,2020-05-29 13:31:16.056338005,2020-05-29,2020-05-29,2020-05-29,2.0,-7.92,-1438.21,0.0,162.0,           ,1.0,1.0,101.0
1413,Ruoka_paivittaistavarakauppa,2020-05-29 19:36:20.281690119,2020-05-29,2020-05-29,2020-05-29,2.0,-17.77,-1455.98,0.0,162.0,           ,1.0,1.0,83.0
1414,Ruoka_paivittaistavarakauppa,2020-05-29 22:38:52.394366176,2020-05-29,2020-05-29,2020-05-29,2.0,-19.93,-1475.91,0.0,162.0,           ,1.0,1.0,39.0
1415,Tulot,2020-06-01 17:20:57.831325301,2020-06-01,2020-06-01,2020-06-01,2.0,2910.66,1434.75,701.0,520.0,           ,1.0,1.0,176.0
1416,Ruoka_paivittaistavarakauppa,2020-06-02 10:41:55.662650602,2020-06-02,2020-06-02,2020-06-03,2.0,-24.96,1409.79,0.0,162.0,           ,1.0,1.0,65.0
1417,Ravintolat_kahvilat,2020-06-03 04:02:53.493975903,2020-06-03,2020-06-03,2020-06-03,2.0,-4.33,1405.46,0.0,162.0,           ,1.0,1.0,78.0
1418,Ruoka_paivittaistavarakauppa,2020-06-03 21:23:51.325301204,2020-06-03,2020-06-03,2020-06-03,2.0,-11.78,1393.68,0.0,162.0,           ,1.0,1.0,60.0
1419,Asuminen,2020-06-04 14:44:49.156626505,2020-06-04,2020-06-04,2020-06-04,2.0,-6.62,1387.06,706.0,129.0,DABAFIHH   ,0.0,0.0,203.0
1420,Terveys,2020-06-05 01:26:44.819277107,2020-06-05,2020-06-05,2020-06-05,2.0,-4.22,1382.84,0.0,162.0,           ,1.0,1.0,132.0
1421,Asuminen,2020-06-05 08:05:46.987951806,2020-06-05,2020-06-05,2020-06-05,2.0,-27.36,1355.48,706.0,129.0,DABAFIHH   ,0.0,0.0,199.0
1422,Muut,2020-06-08 05:29:38.313253010,2020-06-08,2020-06-08,2020-06-08,2.0,-5.43,1350.05,0.0,162.0,           ,1.0,1.0,75.0
1423,Harrastukset,2020-06-08 12:08:40.481927709,2020-06-08,2020-06-08,2020-06-08,2.0,-16.46,1333.59,0.0,162.0,           ,1.0,1.0,78.0
1424,Ruoka_paivittaistavarakauppa,2020-06-08 18:47:42.650602408,2020-06-08,2020-06-08,2020-06-08,2.0,-56.29,1277.3,0.0,162.0,           ,1.0,1.0,70.0
1425,Tulot,2020-06-08 22:50:36.144578311,2020-06-08,2020-06-08,2020-06-08,2.0,496.1,1773.4,710.0,506.0,           ,1.0,1.0,213.0
1426,Lemmikit,2020-06-09 16:11:33.975903612,2020-06-09,2020-06-09,2020-06-09,2.0,-18.35,1755.05,0.0,162.0,           ,1.0,1.0,65.0
1427,Ruoka_paivittaistavarakauppa,2020-06-11 02:53:29.638554214,2020-06-11,2020-06-11,2020-06-11,2.0,-30.13,1724.92,0.0,162.0,           ,1.0,1.0,37.0
1428,Ravintolat_kahvilat,2020-06-11 09:32:31.807228913,2020-06-11,2020-06-11,2020-06-11,2.0,-7.63,1717.29,0.0,162.0,           ,1.0,1.0,60.0
1429,Luottojen_maksut,2020-06-11 13:35:25.301204816,2020-06-11,2020-06-12,2020-06-11,2.0,-55.07,1662.22,706.0,129.0,OKOYFIHH   ,0.0,0.0,196.0
1430,Ruoka_paivittaistavarakauppa,2020-06-11 20:14:27.469879515,2020-06-11,2020-06-11,2020-06-11,2.0,-10.6,1651.62,0.0,162.0,           ,1.0,1.0,51.0
1431,Liikkuminen,2020-06-15 00:17:20.963855418,2020-06-15,2020-06-15,2020-06-15,2.0,-79.22,1572.4,706.0,129.0,OKOYFIHH   ,0.0,0.0,196.0
1432,Ravintolat_kahvilat,2020-06-15 06:56:23.132530117,2020-06-15,2020-06-15,2020-06-15,2.0,-25.79,1546.61,0.0,162.0,           ,1.0,1.0,91.0
1433,Ruoka_paivittaistavarakauppa,2020-06-15 10:59:16.626506020,2020-06-15,2020-06-15,2020-06-15,2.0,-6.43,1540.18,0.0,162.0,           ,1.0,1.0,136.0
1434,Saastot_sijoitukset,2020-06-15 17:38:18.795180719,2020-06-15,2020-06-15,2020-06-15,2.0,-50.91,1489.27,0.0,162.0,           ,1.0,1.0,50.0
1435,Liikkuminen,2020-06-16 04:20:14.457831321,2020-06-16,2020-06-16,2020-06-16,2.0,-37.92,1451.35,0.0,162.0,           ,1.0,1.0,113.0
1436,Luokittelemattomat,2020-06-16 15:02:10.120481923,2020-06-16,2020-06-16,2020-06-16,2.0,-166.48,1284.87,0.0,106.0,OKOYFIHH   ,1.0,0.0,20.0
1437,Kulttuuri_viihde,2020-06-16 21:41:12.289156622,2020-06-16,2020-06-16,2020-06-16,2.0,-5.64,1279.23,0.0,162.0,           ,1.0,1.0,28.0
1438,Ravintolat_kahvilat,2020-06-18 05:46:59.277108428,2020-06-18,2020-06-18,2020-06-18,2.0,-18.82,1260.41,0.0,103.0,           ,0.0,1.0,0.0
1439,Kulttuuri_viihde,2020-06-18 08:23:07.951807224,2020-06-18,2020-06-18,2020-06-18,2.0,-2.92,1257.49,0.0,162.0,           ,1.0,1.0,73.0
1440,Kulttuuri_viihde,2020-06-19 01:44:05.783132525,2020-06-19,2020-06-19,2020-06-19,2.0,-96.65,1160.84,0.0,162.0,           ,1.0,1.0,119.0
1441,Ruoka_paivittaistavarakauppa,2020-06-19 19:05:03.614457826,2020-06-19,2020-06-19,2020-06-19,2.0,-8.23,1152.61,0.0,162.0,           ,1.0,1.0,116.0
1442,Tulot,2020-06-21 12:26:01.445783127,2020-06-21,2020-06-21,2020-06-21,2.0,230.55,1383.16,0.0,506.0,           ,1.0,1.0,168.0
1443,Muut,2020-06-21 16:28:54.939759030,2020-06-21,2020-06-21,2020-06-21,2.0,-28.79,1354.37,0.0,163.0,           ,1.0,1.0,154.0
1444,Saastot_sijoitukset,2020-06-22 20:31:48.433734933,2020-06-22,2020-06-22,2020-06-22,2.0,-47.21,1307.16,0.0,162.0,           ,1.0,1.0,26.0
1445,Ruoka_paivittaistavarakauppa,2020-06-22 23:07:57.108433729,2020-06-22,2020-06-22,2020-06-22,2.0,-9.93,1297.23,0.0,162.0,           ,1.0,1.0,137.0
1446,Ruoka_paivittaistavarakauppa,2020-06-23 03:10:50.602409632,2020-06-23,2020-06-23,2020-06-23,2.0,-5.71,1291.52,0.0,162.0,           ,1.0,1.0,116.0
1447,Ravintolat_kahvilat,2020-06-23 09:49:52.771084331,2020-06-23,2020-06-23,2020-06-23,2.0,-2.94,1288.58,0.0,162.0,           ,1.0,1.0,28.0
1448,Tulot,2020-06-25 13:52:46.265060234,2020-06-25,2020-06-25,2020-06-25,2.0,-108.2,1180.38,706.0,129.0,OKOYFIHH   ,0.0,0.0,196.0
1449,Asuminen,2020-06-26 00:34:41.927710836,2020-06-26,2020-06-26,2020-06-26,2.0,-16.46,1163.92,0.0,106.0,OKOYFIHH   ,0.0,0.0,21.0
1450,Luokittelemattomat,2020-06-26 07:13:44.096385535,2020-06-26,2020-06-26,2020-06-26,2.0,-418.49,745.43,0.0,106.0,OKOYFIHH   ,0.0,0.0,5.0
1451,Terveys,2020-06-29 04:37:35.421686739,2020-06-29,2020-06-30,2020-06-29,2.0,-125.12,620.31,0.0,162.0,           ,1.0,1.0,116.0
1452,Liikkuminen,2020-06-29 11:16:37.590361438,2020-06-29,2020-06-29,2020-06-29,2.0,-35.66,584.65,0.0,162.0,           ,1.0,1.0,44.0
1453,Kulttuuri_viihde,2020-06-29 17:55:39.759036137,2020-06-29,2020-06-29,2020-06-29,2.0,-21.28,563.37,0.0,162.0,           ,1.0,1.0,70.0
1454,Harrastukset,2020-06-29 21:58:33.253012040,2020-06-29,2020-06-29,2020-06-29,2.0,-143.48,419.89,706.0,129.0,ESSEFIHX   ,0.0,0.0,196.0
1455,Liikkuminen,2020-06-30 15:19:31.084337341,2020-06-30,2020-06-30,2020-06-30,2.0,-1.36,418.53,0.0,162.0,           ,1.0,1.0,95.0
1456,Saastot_sijoitukset,2020-07-01 11:01:20.000000000,2020-07-01,2020-07-01,2020-07-01,2.0,-260.13,158.4,0.0,192.0,           ,0.0,1.0,160.0
1457,Tulot,2020-07-01 22:02:40.000000000,2020-07-01,2020-07-01,2020-07-01,2.0,148.73,307.13,0.0,506.0,           ,1.0,1.0,164.0
1458,Tulot,2020-07-02 09:04:00.000000000,2020-07-02,2020-07-02,2020-07-02,2.0,891.46,1198.59,701.0,520.0,           ,1.0,1.0,178.0
1459,Muut,2020-07-02 20:05:20.000000000,2020-07-02,2020-07-02,2020-07-02,2.0,-34.18,1164.41,0.0,163.0,           ,1.0,1.0,152.0
1460,Lemmikit,2020-07-03 07:06:40.000000000,2020-07-03,2020-07-03,2020-07-03,2.0,-15.97,1148.44,0.0,162.0,           ,1.0,1.0,130.0
1461,Terveys,2020-07-03 16:10:40.000000000,2020-07-03,2020-07-03,2020-07-03,2.0,-16.47,1131.97,0.0,162.0,           ,1.0,1.0,60.0
1462,Luokittelemattomat,2020-07-03 18:08:00.000000000,2020-07-03,2020-07-03,2020-07-03,2.0,-355.61,776.36,706.0,129.0,OKOYFIHH   ,0.0,0.0,200.0
1463,Luottojen_maksut,2020-07-06 01:14:40.000000000,2020-07-06,2020-07-06,2020-07-06,2.0,-11.61,764.75,0.0,162.0,           ,1.0,1.0,105.0
1464,Ruoka_paivittaistavarakauppa,2020-07-06 03:12:00.000000000,2020-07-06,2020-07-06,2020-07-06,2.0,-12.81,751.94,0.0,162.0,           ,1.0,1.0,71.0
1465,Liikkuminen,2020-07-06 05:09:20.000000000,2020-07-06,2020-07-06,2020-07-06,2.0,-50.77,701.17,0.0,162.0,           ,1.0,1.0,28.0
1466,Liikkuminen,2020-07-06 08:21:20.000000000,2020-07-06,2020-07-06,2020-07-06,2.0,-12.51,688.66,0.0,162.0,           ,1.0,1.0,67.0
1467,Ruoka_paivittaistavarakauppa,2020-07-06 12:16:00.000000000,2020-07-06,2020-07-06,2020-07-06,2.0,-23.62,665.04,0.0,162.0,           ,1.0,1.0,117.0
1468,Ruoka_paivittaistavarakauppa,2020-07-06 14:13:20.000000000,2020-07-06,2020-07-06,2020-07-06,2.0,-10.32,654.72,0.0,162.0,           ,1.0,1.0,83.0
1469,Vakuutukset,2020-07-06 23:17:20.000000000,2020-07-06,2020-07-06,2020-07-06,2.0,-18.16,636.56,706.0,129.0,OKOYFIHH   ,0.0,0.0,196.0
1470,Shoppailu,2020-07-07 10:18:40.000000000,2020-07-07,2020-07-07,2020-07-07,2.0,-6.3,630.26,0.0,162.0,           ,1.0,1.0,94.0
1471,Ruoka_paivittaistavarakauppa,2020-07-07 21:20:00.000000000,2020-07-07,2020-07-07,2020-07-07,2.0,-4.16,626.1,0.0,162.0,           ,1.0,1.0,37.0
1472,Liikkuminen,2020-07-08 17:25:20.000000000,2020-07-08,2020-07-08,2020-07-08,2.0,-62.82,563.28,706.0,129.0,OKOYFIHH   ,0.0,0.0,198.0
1473,Ruoka_paivittaistavarakauppa,2020-07-08 19:22:40.000000000,2020-07-08,2020-07-08,2020-07-08,2.0,-14.88,548.4,0.0,162.0,           ,1.0,1.0,131.0
1474,Ruoka_paivittaistavarakauppa,2020-07-09 06:24:00.000000000,2020-07-09,2020-07-09,2020-07-09,2.0,-8.56,539.84,0.0,162.0,           ,1.0,1.0,136.0
1475,Ruoka_paivittaistavarakauppa,2020-07-09 15:28:00.000000000,2020-07-09,2020-07-09,2020-07-09,2.0,-25.32,514.52,0.0,162.0,           ,1.0,1.0,63.0
1476,Luokittelemattomat,2020-07-10 02:29:20.000000000,2020-07-10,2020-07-10,2020-07-10,2.0,-35.01,479.51,0.0,162.0,           ,1.0,1.0,77.0
1477,Luottojen_maksut,2020-07-10 04:26:40.000000000,2020-07-10,2020-07-10,2020-07-09,2.0,-19.28,460.23,706.0,129.0,OKOYFIHH   ,0.0,0.0,201.0
1478,Ravintolat_kahvilat,2020-07-10 13:30:40.000000000,2020-07-10,2020-07-10,2020-07-10,2.0,-10.34,449.89,0.0,162.0,           ,1.0,1.0,107.0
1479,Ruoka_paivittaistavarakauppa,2020-07-13 00:32:00.000000000,2020-07-13,2020-07-13,2020-07-13,2.0,-9.64,440.25,0.0,162.0,           ,1.0,1.0,86.0
1480,Shoppailu,2020-07-13 05:41:20.000000000,2020-07-13,2020-07-13,2020-07-13,2.0,-9.83,430.42,0.0,162.0,           ,1.0,1.0,94.0
1481,Asuminen,2020-07-13 09:36:00.000000000,2020-07-13,2020-07-13,2020-07-13,2.0,-99.33,331.09,706.0,129.0,OKOYFIHH   ,0.0,0.0,196.0
1482,Harrastukset,2020-07-13 11:33:20.000000000,2020-07-13,2020-07-13,2020-07-13,2.0,-34.73,296.36,0.0,162.0,           ,1.0,1.0,57.0
1483,Asuminen,2020-07-13 20:37:20.000000000,2020-07-13,2020-07-15,2020-07-13,2.0,-7.43,288.93,706.0,129.0,OKOYFIHH   ,0.0,0.0,196.0
1484,Ruoka_paivittaistavarakauppa,2020-07-13 22:34:40.000000000,2020-07-13,2020-07-13,2020-07-13,2.0,-42.29,246.64,0.0,162.0,           ,1.0,1.0,136.0
1485,Tulot,2020-07-14 18:40:00.000000000,2020-07-14,2020-07-14,2020-07-14,2.0,6.57,253.21,710.0,506.0,           ,1.0,1.0,212.0
1486,Ruoka_paivittaistavarakauppa,2020-07-15 10:50:40.000000000,2020-07-15,2020-07-15,2020-07-15,2.0,-8.78,244.43,0.0,162.0,           ,1.0,1.0,50.0
1487,Liikkuminen,2020-07-15 16:42:40.000000000,2020-07-15,2020-07-15,2020-07-15,2.0,-64.35,180.08,0.0,162.0,           ,1.0,1.0,37.0
1488,Lemmikit,2020-07-16 01:46:40.000000000,2020-07-16,2020-07-16,2020-07-16,2.0,-14.31,165.77,0.0,162.0,           ,1.0,1.0,79.0
1489,Ruoka_paivittaistavarakauppa,2020-07-16 03:44:00.000000000,2020-07-16,2020-07-16,2020-07-16,2.0,-17.46,148.31,0.0,162.0,           ,1.0,1.0,107.0
1490,Ruoka_paivittaistavarakauppa,2020-07-16 07:38:40.000000000,2020-07-16,2020-07-16,2020-07-16,2.0,-32.2,116.11,0.0,162.0,           ,1.0,1.0,72.0
1491,Luottojen_maksut,2020-07-16 14:45:20.000000000,2020-07-16,2020-07-16,2020-07-16,2.0,-138.6,-22.49,706.0,129.0,OKOYFIHH   ,0.0,0.0,196.0
1492,Luottojen_maksut,2020-07-16 23:49:20.000000000,2020-07-16,2020-07-16,2020-07-16,2.0,-1.2,-23.69,0.0,162.0,           ,1.0,1.0,29.0
1493,Ravintolat_kahvilat,2020-07-17 12:48:00.000000000,2020-07-17,2020-07-17,2020-07-17,2.0,-6.5,-30.19,0.0,162.0,           ,1.0,1.0,149.0
1494,Ruoka_paivittaistavarakauppa,2020-07-17 21:52:00.000000000,2020-07-17,2020-07-17,2020-07-17,2.0,-2.92,-33.11,0.0,162.0,           ,1.0,1.0,146.0
1495,Liikkuminen,2020-07-20 06:56:00.000000000,2020-07-20,2020-07-20,2020-07-20,2.0,-7.68,-40.79,0.0,162.0,           ,1.0,1.0,136.0
1496,Kulttuuri_viihde,2020-07-20 16:00:00.000000000,2020-07-20,2020-07-20,2020-07-20,2.0,-1.33,-42.12,0.0,162.0,           ,1.0,1.0,67.0
1497,Lapset,2020-07-20 17:57:20.000000000,2020-07-16,2020-07-20,2020-07-20,2.0,-16.88,-59.0,0.0,106.0,OKOYFIHH   ,0.0,0.0,18.0
1498,Ruoka_paivittaistavarakauppa,2020-07-20 19:54:40.000000000,2020-07-20,2020-07-20,2020-07-20,2.0,-3.27,-62.27,0.0,162.0,           ,1.0,1.0,76.0
1499,Ruoka_paivittaistavarakauppa,2020-07-21 04:58:40.000000000,2020-07-21,2020-07-21,2020-07-21,2.0,-5.25,-67.52,0.0,162.0,           ,1.0,1.0,89.0
1500,Ruoka_paivittaistavarakauppa,2020-07-21 08:53:20.000000000,2020-07-21,2020-07-21,2020-07-21,2.0,-2.68,-70.2,0.0,162.0,           ,1.0,1.0,126.0
1501,Tulot,2020-07-22 12:05:20.000000000,2020-07-22,2020-07-22,2020-07-22,2.0,422.09,351.89,701.0,520.0,           ,1.0,1.0,180.0
1502,Ruoka_paivittaistavarakauppa,2020-07-23 01:04:00.000000000,2020-07-23,2020-07-23,2020-07-23,2.0,-3.05,348.84,0.0,192.0,           ,0.0,1.0,159.0
1503,Ravintolat_kahvilat,2020-07-23 03:01:20.000000000,2020-07-23,2020-07-23,2020-07-23,2.0,-22.29,326.55,0.0,162.0,           ,1.0,1.0,78.0
1504,Luokittelemattomat,2020-07-23 10:08:00.000000000,2020-07-23,2020-07-24,2020-07-23,2.0,-157.09,169.46,0.0,106.0,ITELFIHH   ,0.0,0.0,12.0
1505,Vakuutukset,2020-07-23 14:02:40.000000000,2020-07-23,2020-07-23,2020-07-23,2.0,-101.38,68.08,706.0,129.0,SBANFIHH   ,0.0,0.0,196.0
1506,Liikkuminen,2020-07-23 19:12:00.000000000,2020-07-23,2020-07-23,2020-07-23,2.0,-5.33,62.75,0.0,162.0,           ,1.0,1.0,77.0
1507,Harrastukset,2020-07-24 21:09:20.000000000,2020-07-24,2020-07-24,2020-07-24,2.0,-16.53,46.22,0.0,129.0,OKOYFIHH   ,0.0,0.0,23.0
1508,Luottojen_maksut,2020-07-24 23:06:40.000000000,2020-07-24,2020-07-24,2020-07-24,2.0,-12.14,34.08,706.0,106.0,NDEAFIHH   ,0.0,0.0,186.0
1509,Muut,2020-07-27 02:18:40.000000000,2020-07-27,2020-07-29,2020-07-27,2.0,-0.17,33.91,0.0,162.0,           ,1.0,1.0,73.0
1510,Ruoka_paivittaistavarakauppa,2020-07-27 04:16:00.000000000,2020-07-27,2020-07-27,2020-07-27,2.0,-5.29,28.62,0.0,162.0,           ,1.0,1.0,93.0
1511,Liikkuminen,2020-07-27 06:13:20.000000000,2020-07-27,2020-07-27,2020-07-27,2.0,-1.75,26.87,0.0,162.0,           ,1.0,1.0,104.0
1512,Ravintolat_kahvilat,2020-07-27 08:10:40.000000000,2020-07-27,2020-07-27,2020-07-27,2.0,-4.24,22.63,0.0,162.0,           ,1.0,1.0,95.0
1513,Lapset,2020-07-27 13:20:00.000000000,2020-07-27,2020-07-27,2020-07-27,2.0,-5.45,17.18,0.0,162.0,           ,1.0,1.0,145.0
1514,Luottojen_maksut,2020-07-27 15:17:20.000000000,2020-07-27,2020-07-27,2020-07-27,2.0,-21.94,-4.76,706.0,147.0,OKOYFIHH   ,0.0,0.0,208.0
1515,Liikkuminen,2020-07-27 17:14:40.000000000,2020-07-27,2020-07-27,2020-07-27,2.0,-4.81,-9.57,0.0,162.0,           ,1.0,1.0,70.0
1516,Asuminen,2020-07-29 11:22:40.000000000,2020-07-29,2020-07-29,2020-07-29,2.0,-13.11,-22.68,706.0,129.0,OKOYFIHH   ,0.0,0.0,197.0
1517,Liikkuminen,2020-07-29 20:26:40.000000000,2020-07-29,2020-07-29,2020-07-29,2.0,-2.89,-25.57,0.0,162.0,           ,1.0,1.0,111.0
1518,Ravintolat_kahvilat,2020-07-29 22:24:00.000000000,2020-07-29,2020-07-30,2020-07-29,2.0,-7.48,-33.05,0.0,162.0,           ,1.0,1.0,92.0
1519,Muut,2020-07-30 18:29:20.000000000,2020-07-30,2020-07-30,2020-07-30,2.0,-3.96,-37.01,0.0,162.0,           ,1.0,1.0,60.0
1520,Ruoka_paivittaistavarakauppa,2020-07-31 00:21:20.000000000,2020-07-31,2020-07-31,2020-07-31,2.0,-33.0,-70.01,0.0,162.0,           ,1.0,1.0,73.0
1521,Kulttuuri_viihde,2020-07-31 07:28:00.000000000,2020-07-31,2020-07-31,2020-07-31,2.0,-4.8,-74.81,0.0,162.0,           ,1.0,1.0,83.0
1522,Muut,2020-07-31 09:25:20.000000000,2020-07-31,2020-07-31,2020-07-31,2.0,-4.65,-79.46,0.0,162.0,           ,1.0,1.0,146.0
1523,Ruoka_paivittaistavarakauppa,2020-08-03 01:26:09.230769230,2020-08-03,2020-08-03,2020-08-03,2.0,-1.75,-81.21,0.0,162.0,           ,1.0,1.0,72.0
1524,Ruoka_paivittaistavarakauppa,2020-08-03 02:52:18.461538460,2020-08-03,2020-08-03,2020-08-03,2.0,-24.96,-106.17,0.0,162.0,           ,1.0,1.0,66.0
1525,Ruoka_paivittaistavarakauppa,2020-08-03 05:44:36.923076920,2020-08-03,2020-08-04,2020-08-03,2.0,-2.3,-108.47,0.0,162.0,           ,1.0,1.0,113.0
1526,Tulot,2020-08-03 12:43:04.615384615,2020-08-03,2020-08-03,2020-08-03,2.0,1088.69,980.22,701.0,520.0,           ,1.0,1.0,177.0
1527,Liikkuminen,2020-08-03 14:09:13.846153845,2020-08-03,2020-08-04,2020-08-03,2.0,-206.43,773.79,0.0,162.0,           ,1.0,1.0,140.0
1528,Hyvinvointijakauneus,2020-08-03 15:35:23.076923075,2020-08-03,2020-08-03,2020-08-03,2.0,-6.26,767.53,706.0,147.0,OKOYFIHH   ,0.0,0.0,207.0
1529,Luottojen_maksut,2020-08-04 04:18:27.692307690,2020-08-04,2020-08-04,2020-08-04,2.0,-19.01,748.52,706.0,129.0,OKOYFIHH   ,0.0,0.0,196.0
1530,Hyvinvointijakauneus,2020-08-04 17:01:32.307692305,2020-08-04,2020-08-04,2020-08-04,2.0,-16.74,731.78,0.0,162.0,           ,1.0,1.0,37.0
1531,Ravintolat_kahvilat,2020-08-04 18:27:41.538461535,2020-08-04,2020-08-04,2020-08-04,2.0,-8.97,722.81,0.0,162.0,           ,1.0,1.0,72.0
1532,Tulot,2020-08-06 07:10:46.153846150,2020-08-06,2020-08-06,2020-08-06,2.0,1223.99,1946.8,701.0,520.0,           ,1.0,1.0,176.0
1533,Ruoka_paivittaistavarakauppa,2020-08-06 19:53:50.769230765,2020-08-06,2020-08-06,2020-08-06,2.0,-15.44,1931.36,0.0,162.0,           ,1.0,1.0,86.0
1534,Ruoka_paivittaistavarakauppa,2020-08-07 08:36:55.384615380,2020-08-07,2020-08-07,2020-08-07,2.0,-9.96,1921.4,0.0,162.0,           ,1.0,1.0,81.0
1535,Asuminen,2020-08-07 21:19:59.999999995,2020-08-07,2020-08-07,2020-08-07,2.0,-1010.53,910.87,0.0,162.0,           ,1.0,1.0,121.0
1536,Hyvinvointijakauneus,2020-08-07 22:46:09.230769225,2020-08-07,2020-08-07,2020-08-07,2.0,-20.31,890.56,0.0,162.0,           ,1.0,1.0,95.0
1537,Asuminen,2020-08-10 00:12:18.461538455,2020-08-10,2020-08-10,2020-08-10,2.0,-189.54,701.02,706.0,147.0,OKOYFIHH   ,0.0,0.0,206.0
1538,Ruoka_paivittaistavarakauppa,2020-08-10 10:03:04.615384610,2020-08-10,2020-08-10,2020-08-10,2.0,-7.27,693.75,0.0,162.0,           ,1.0,1.0,26.0
1539,Lemmikit,2020-08-10 11:29:13.846153840,2020-08-10,2020-08-10,2020-08-10,2.0,-4.24,689.51,0.0,162.0,           ,1.0,1.0,27.0
1540,Ruoka_paivittaistavarakauppa,2020-08-10 12:55:23.076923070,2020-08-10,2020-08-10,2020-08-10,2.0,-98.82,590.69,0.0,162.0,           ,1.0,1.0,109.0
1541,Ruoka_paivittaistavarakauppa,2020-08-11 01:38:27.692307685,2020-08-11,2020-08-11,2020-08-11,2.0,-14.55,576.14,0.0,162.0,           ,1.0,1.0,29.0
1542,Ruoka_paivittaistavarakauppa,2020-08-11 04:30:46.153846145,2020-08-11,2020-08-11,2020-08-11,2.0,-11.76,564.38,0.0,162.0,           ,1.0,1.0,89.0
1543,Ruoka_paivittaistavarakauppa,2020-08-11 14:21:32.307692300,2020-08-11,2020-08-11,2020-08-11,2.0,-78.41,485.97,0.0,162.0,           ,1.0,1.0,127.0
1544,Matkailu,2020-08-12 03:04:36.923076915,2020-08-12,2020-08-12,2020-08-12,2.0,-33.53,452.44,706.0,147.0,OKOYFIHH   ,0.0,0.0,209.0
1545,Asuminen,2020-08-13 05:56:55.384615375,2020-08-13,2020-08-13,2020-08-13,2.0,-5.15,447.29,0.0,162.0,           ,1.0,1.0,57.0
1546,Luokittelemattomat,2020-08-13 15:47:41.538461530,2020-08-13,2020-08-13,2020-08-13,2.0,-21.01,426.28,0.0,162.0,           ,1.0,1.0,136.0
1547,Liikkuminen,2020-08-13 17:13:50.769230760,2020-08-13,2020-08-13,2020-08-13,2.0,-13.84,412.44,0.0,162.0,           ,1.0,1.0,26.0
1548,Matkailu,2020-08-14 18:39:59.999999990,2020-08-14,2020-08-14,2020-08-14,2.0,-17.15,395.29,706.0,147.0,OKOYFIHH   ,0.0,0.0,205.0
1549,Matkailu,2020-08-16 21:32:18.461538450,2020-08-16,2020-08-16,2020-08-16,2.0,-26.26,369.03,0.0,106.0,OKOYFIHH   ,0.0,0.0,6.0
1550,Ravintolat_kahvilat,2020-08-17 07:23:04.615384605,2020-08-17,2020-08-19,2020-08-17,2.0,-6.55,362.48,0.0,162.0,           ,1.0,1.0,60.0
1551,Ruoka_paivittaistavarakauppa,2020-08-17 08:49:13.846153835,2020-08-17,2020-08-17,2020-08-17,2.0,-14.65,347.83,0.0,162.0,           ,1.0,1.0,50.0
1552,Luottojen_maksut,2020-08-17 10:15:23.076923065,2020-08-17,2020-08-17,2020-08-17,2.0,-16.23,331.6,0.0,106.0,OKOYFIHH   ,1.0,0.0,14.0
1553,Ravintolat_kahvilat,2020-08-17 20:06:09.230769220,2020-08-17,2020-08-17,2020-08-17,2.0,-2.0,329.6,0.0,162.0,           ,1.0,1.0,95.0
1554,Ruoka_paivittaistavarakauppa,2020-08-17 22:58:27.692307680,2020-08-17,2020-08-17,2020-08-17,2.0,-66.82,262.78,0.0,162.0,           ,1.0,1.0,74.0
1555,Ruoka_paivittaistavarakauppa,2020-08-18 11:41:32.307692295,2020-08-18,2020-08-18,2020-08-17,2.0,-13.09,249.69,0.0,162.0,           ,1.0,1.0,68.0
1556,Ruoka_paivittaistavarakauppa,2020-08-19 00:24:36.923076910,2020-08-19,2020-08-19,2020-08-19,2.0,-73.74,175.95,0.0,162.0,           ,1.0,1.0,138.0
1557,Ruoka_paivittaistavarakauppa,2020-08-20 01:50:46.153846140,2020-08-20,2020-08-20,2020-08-20,2.0,-40.25,135.7,0.0,162.0,           ,1.0,1.0,79.0
1558,Saastot_sijoitukset,2020-08-20 03:16:55.384615370,2020-08-20,2020-08-20,2020-08-20,2.0,-1.0,134.7,0.0,162.0,           ,1.0,1.0,119.0
1559,Muut,2020-08-20 13:07:41.538461525,2020-08-20,2020-08-20,2020-08-20,2.0,-7.42,127.28,0.0,163.0,           ,1.0,1.0,152.0
1560,Ravintolat_kahvilat,2020-08-20 14:33:50.769230755,2020-08-20,2020-08-20,2020-08-20,2.0,-6.5,120.78,0.0,162.0,           ,1.0,1.0,92.0
1561,Liikkuminen,2020-08-20 15:59:59.999999985,2020-08-20,2020-08-20,2020-08-20,2.0,-14.45,106.33,0.0,162.0,           ,1.0,1.0,57.0
1562,Luokittelemattomat,2020-08-24 04:43:04.615384600,2020-08-24,2020-08-24,2020-08-24,2.0,-6.59,99.74,0.0,162.0,           ,1.0,1.0,33.0
1563,Ravintolat_kahvilat,2020-08-24 06:09:13.846153830,2020-08-24,2020-08-24,2020-08-24,2.0,-4.44,95.3,0.0,162.0,           ,1.0,1.0,89.0
1564,Ravintolat_kahvilat,2020-08-24 07:35:23.076923060,2020-08-24,2020-08-24,2020-08-24,2.0,-4.44,90.86,0.0,162.0,           ,1.0,1.0,45.0
1565,Ruoka_paivittaistavarakauppa,2020-08-24 17:26:09.230769215,2020-08-24,2020-08-24,2020-08-24,2.0,-1.3,89.56,0.0,162.0,           ,1.0,1.0,50.0
1566,Ruoka_paivittaistavarakauppa,2020-08-24 18:52:18.461538445,2020-08-24,2020-08-25,2020-08-24,2.0,-19.91,69.65,0.0,162.0,           ,1.0,1.0,28.0
1567,Ruoka_paivittaistavarakauppa,2020-08-24 20:18:27.692307675,2020-08-24,2020-08-24,2020-08-24,2.0,-22.4,47.25,0.0,162.0,           ,1.0,1.0,141.0
1568,Ruoka_paivittaistavarakauppa,2020-08-24 23:10:46.153846135,2020-08-24,2020-08-24,2020-08-24,2.0,-7.74,39.51,0.0,162.0,           ,1.0,1.0,73.0
1569,Ravintolat_kahvilat,2020-08-26 00:36:55.384615365,2020-08-26,2020-08-26,2020-08-26,2.0,-7.55,31.96,0.0,162.0,           ,1.0,1.0,81.0
1570,Ruoka_paivittaistavarakauppa,2020-08-26 09:01:32.307692290,2020-08-26,2020-08-26,2020-08-26,2.0,-21.1,10.86,0.0,162.0,           ,1.0,1.0,54.0
1571,Muut,2020-08-27 10:27:41.538461520,2020-08-27,2020-08-27,2020-08-27,2.0,-2.27,8.59,0.0,162.0,           ,1.0,1.0,58.0
1572,Ruoka_paivittaistavarakauppa,2020-08-27 11:53:50.769230750,2020-08-27,2020-08-27,2020-08-27,2.0,-2.12,6.47,0.0,162.0,           ,1.0,1.0,73.0
1573,Lemmikit,2020-08-27 21:44:36.923076905,2020-08-27,2020-08-27,2020-08-27,2.0,-1.4,5.07,0.0,162.0,           ,1.0,1.0,90.0
1574,Ruoka_paivittaistavarakauppa,2020-08-28 02:03:04.615384595,2020-08-28,2020-08-28,2020-08-28,2.0,-2.64,2.43,0.0,162.0,           ,1.0,1.0,70.0
1575,Lapset,2020-08-28 13:19:59.999999980,2020-08-28,2020-08-28,2020-08-28,2.0,-12.83,-10.4,0.0,162.0,           ,1.0,1.0,136.0
1576,Ruoka_paivittaistavarakauppa,2020-08-28 14:46:09.230769210,2020-08-28,2020-08-28,2020-08-28,2.0,-1.31,-11.71,0.0,162.0,           ,1.0,1.0,46.0
1577,Ravintolat_kahvilat,2020-08-31 03:29:13.846153825,2020-08-31,2020-08-31,2020-08-31,2.0,-3.79,-15.5,0.0,162.0,           ,1.0,1.0,55.0
1578,Ravintolat_kahvilat,2020-08-31 04:55:23.076923055,2020-08-31,2020-08-31,2020-08-31,2.0,-0.97,-16.47,0.0,162.0,           ,1.0,1.0,71.0
1579,Kulttuuri_viihde,2020-08-31 16:12:18.461538440,2020-08-31,2020-08-31,2020-08-31,2.0,-3.55,-20.02,0.0,162.0,           ,1.0,1.0,87.0
1580,Ruoka_paivittaistavarakauppa,2020-08-31 17:38:27.692307670,2020-08-31,2020-08-31,2020-08-31,2.0,-3.85,-23.87,0.0,162.0,           ,1.0,1.0,57.0
1581,Tulot,2020-09-01 17:46:40.000000000,2020-09-01,2020-09-02,2020-09-01,2.0,2284.83,2260.96,701.0,520.0,           ,1.0,1.0,182.0
1582,Tulot,2020-09-02 11:33:20.000000000,2020-09-02,2020-09-02,2020-09-02,2.0,1718.83,3979.79,701.0,520.0,           ,1.0,1.0,178.0
1583,Luottojen_maksut,2020-09-03 05:20:00.000000000,2020-09-03,2020-09-03,2020-09-03,2.0,-676.01,3303.78,0.0,172.0,           ,1.0,1.0,158.0
1584,Tulot,2020-09-03 10:40:00.000000000,2020-09-03,2020-09-03,2020-09-03,2.0,1477.54,4781.32,701.0,520.0,           ,1.0,1.0,176.0
1585,Luottojen_maksut,2020-09-03 23:06:40.000000000,2020-09-03,2020-09-03,2020-09-03,2.0,-1002.27,3779.05,0.0,172.0,           ,1.0,1.0,157.0
1586,Tulot,2020-09-04 16:53:20.000000000,2020-09-04,2020-09-04,2020-09-04,2.0,873.17,4652.22,701.0,520.0,           ,1.0,1.0,176.0
1587,Matkailu,2020-09-07 16:00:00.000000000,2020-09-07,2020-09-07,2020-09-07,2.0,-8.77,4643.45,0.0,162.0,           ,1.0,1.0,94.0
1588,Ruoka_paivittaistavarakauppa,2020-09-07 22:13:20.000000000,2020-09-07,2020-09-07,2020-09-07,2.0,-31.36,4612.09,0.0,162.0,           ,1.0,1.0,27.0
1589,Luottojen_maksut,2020-09-08 04:26:40.000000000,2020-09-08,2020-09-08,2020-09-08,2.0,-8.66,4603.43,0.0,162.0,           ,1.0,1.0,70.0
1590,Lemmikit,2020-09-08 09:46:40.000000000,2020-09-08,2020-09-08,2020-09-08,2.0,-10.18,4593.25,0.0,162.0,           ,1.0,1.0,26.0
1591,Muut,2020-09-08 21:20:00.000000000,2020-09-08,2020-09-08,2020-09-08,2.0,-66.37,4526.88,0.0,162.0,           ,1.0,1.0,121.0
1592,Ravintolat_kahvilat,2020-09-10 02:40:00.000000000,2020-09-10,2020-09-10,2020-09-10,2.0,-5.47,4521.41,0.0,162.0,           ,1.0,1.0,106.0
1593,Ruoka_paivittaistavarakauppa,2020-09-10 03:33:20.000000000,2020-09-10,2020-09-10,2020-09-10,2.0,-30.75,4490.66,0.0,162.0,           ,1.0,1.0,109.0
1594,Lemmikit,2020-09-10 20:26:40.000000000,2020-09-10,2020-09-10,2020-09-10,2.0,-32.35,4458.31,0.0,162.0,           ,1.0,1.0,57.0
1595,Ruoka_paivittaistavarakauppa,2020-09-11 08:53:20.000000000,2020-09-11,2020-09-11,2020-09-11,2.0,-93.18,4365.13,0.0,162.0,           ,1.0,1.0,101.0
1596,Liikkuminen,2020-09-11 15:06:40.000000000,2020-09-11,2020-09-11,2020-09-11,2.0,-4.18,4360.95,0.0,162.0,           ,1.0,1.0,94.0
1597,Ravintolat_kahvilat,2020-09-14 01:46:40.000000000,2020-09-14,2020-09-14,2020-09-14,2.0,-23.6,4337.35,0.0,162.0,           ,1.0,1.0,148.0
1598,Ruoka_paivittaistavarakauppa,2020-09-14 08:00:00.000000000,2020-09-14,2020-09-15,2020-09-14,2.0,-7.45,4329.9,0.0,162.0,           ,1.0,1.0,30.0
1599,Ruoka_paivittaistavarakauppa,2020-09-14 14:13:20.000000000,2020-09-14,2020-09-14,2020-09-14,2.0,-44.53,4285.37,0.0,162.0,           ,1.0,1.0,74.0
1600,Luokittelemattomat,2020-09-15 19:33:20.000000000,2020-09-15,2020-09-15,2020-09-15,2.0,-45.73,4239.64,0.0,162.0,           ,1.0,1.0,146.0
1601,Liikkuminen,2020-09-17 13:20:00.000000000,2020-09-17,2020-09-17,2020-09-17,2.0,-40.94,4198.7,0.0,162.0,           ,1.0,1.0,74.0
1602,Ruoka_paivittaistavarakauppa,2020-09-18 00:53:20.000000000,2020-09-18,2020-09-18,2020-09-18,2.0,-5.29,4193.41,0.0,162.0,           ,1.0,1.0,111.0
1603,Ruoka_paivittaistavarakauppa,2020-09-18 07:06:40.000000000,2020-09-18,2020-09-18,2020-09-18,2.0,-51.03,4142.38,0.0,162.0,           ,1.0,1.0,99.0
1604,Ruoka_paivittaistavarakauppa,2020-09-18 18:40:00.000000000,2020-09-18,2020-09-18,2020-09-18,2.0,-39.33,4103.05,0.0,162.0,           ,1.0,1.0,65.0
1605,Ruoka_paivittaistavarakauppa,2020-09-21 00:00:00.000000000,2020-09-21,2020-09-21,2020-09-21,2.0,-2.72,4100.33,0.0,162.0,           ,1.0,1.0,59.0
1606,Kulttuuri_viihde,2020-09-21 06:13:20.000000000,2020-09-21,2020-09-21,2020-09-21,2.0,-7.35,4092.98,0.0,106.0,OKOYFIHH   ,0.0,0.0,10.0
1607,Ruoka_paivittaistavarakauppa,2020-09-21 12:26:40.000000000,2020-09-21,2020-09-21,2020-09-21,2.0,-28.1,4064.88,0.0,162.0,           ,1.0,1.0,63.0
1608,Asuminen,2020-09-21 17:46:40.000000000,2020-09-21,2020-09-21,2020-09-21,2.0,-1179.65,2885.23,0.0,162.0,           ,1.0,1.0,44.0
1609,Tulot,2020-09-22 11:33:20.000000000,2020-09-22,2020-09-22,2020-09-22,2.0,-37.79,2847.44,0.0,162.0,           ,1.0,1.0,87.0
1610,Ravintolat_kahvilat,2020-09-22 16:53:20.000000000,2020-09-22,2020-09-22,2020-09-22,2.0,-1.1,2846.34,0.0,162.0,           ,1.0,1.0,27.0
1611,Liikkuminen,2020-09-23 05:20:00.000000000,2020-09-23,2020-09-23,2020-09-23,2.0,-24.14,2822.2,0.0,162.0,           ,1.0,1.0,94.0
1612,Ruoka_paivittaistavarakauppa,2020-09-24 04:26:40.000000000,2020-09-24,2020-09-24,2020-09-24,2.0,-19.12,2803.08,0.0,162.0,           ,1.0,1.0,37.0
1613,Ruoka_paivittaistavarakauppa,2020-09-24 22:13:20.000000000,2020-09-24,2020-09-24,2020-09-24,2.0,-10.9,2792.18,0.0,162.0,           ,1.0,1.0,122.0
1614,Ruoka_paivittaistavarakauppa,2020-09-24 23:06:40.000000000,2020-09-24,2020-09-24,2020-09-24,2.0,-25.5,2766.68,0.0,162.0,           ,1.0,1.0,88.0
1615,Lemmikit,2020-09-25 10:40:00.000000000,2020-09-25,2020-09-25,2020-09-25,2.0,-3.07,2763.61,0.0,162.0,           ,1.0,1.0,67.0
1616,Ruoka_paivittaistavarakauppa,2020-09-28 03:33:20.000000000,2020-09-28,2020-09-28,2020-09-28,2.0,-41.58,2722.03,0.0,162.0,           ,1.0,1.0,32.0
1617,Kulttuuri_viihde,2020-09-28 09:46:40.000000000,2020-09-28,2020-09-28,2020-09-28,2.0,-79.75,2642.28,0.0,106.0,OKOYFIHH   ,0.0,0.0,13.0
1618,Ravintolat_kahvilat,2020-09-28 15:06:40.000000000,2020-09-28,2020-09-28,2020-09-28,2.0,-1.69,2640.59,0.0,162.0,           ,1.0,1.0,70.0
1619,Ruoka_paivittaistavarakauppa,2020-09-28 16:00:00.000000000,2020-09-28,2020-09-28,2020-09-28,2.0,-16.86,2623.73,0.0,162.0,           ,1.0,1.0,87.0
1620,Tulot,2020-09-29 21:20:00.000000000,2020-09-29,2020-10-01,2020-09-29,2.0,112.36,2736.09,710.0,506.0,           ,1.0,1.0,211.0
1621,Ruoka_paivittaistavarakauppa,2020-10-02 01:13:13.220338983,2020-10-02,2020-10-02,2020-10-02,2.0,-159.67,2576.42,0.0,162.0,           ,1.0,1.0,134.0
1622,Ruoka_paivittaistavarakauppa,2020-10-02 02:26:26.440677966,2020-10-02,2020-10-02,2020-10-02,2.0,-15.89,2560.53,0.0,162.0,           ,1.0,1.0,142.0
1623,Tulot,2020-10-05 03:39:39.661016949,2020-10-05,2020-10-05,2020-10-05,2.0,355.11,2915.64,701.0,520.0,           ,1.0,1.0,176.0
1624,Luottojen_maksut,2020-10-05 04:52:52.881355932,2020-10-05,2020-10-05,2020-10-05,2.0,-274.68,2640.96,0.0,172.0,           ,1.0,1.0,157.0
1625,Luottojen_maksut,2020-10-06 07:19:19.322033898,2020-10-06,2020-10-07,2020-10-06,2.0,-385.76,2255.2,0.0,172.0,           ,1.0,1.0,157.0
1626,Tulot,2020-10-07 06:06:06.101694915,2020-10-07,2020-10-07,2020-10-07,2.0,965.81,3221.01,701.0,520.0,           ,1.0,1.0,176.0
1627,Tulot,2020-10-07 09:45:45.762711864,2020-10-07,2020-10-07,2020-10-07,2.0,938.76,4159.77,701.0,520.0,           ,1.0,1.0,178.0
1628,Luottojen_maksut,2020-10-08 08:32:32.542372881,2020-10-08,2020-10-08,2020-10-08,2.0,-283.18,3876.59,0.0,172.0,           ,1.0,1.0,157.0
1629,Liikkuminen,2020-10-12 10:58:58.983050847,2020-10-12,2020-10-12,2020-10-12,2.0,-12.28,3864.31,0.0,162.0,           ,1.0,1.0,109.0
1630,Ravintolat_kahvilat,2020-10-12 12:12:12.203389830,2020-10-12,2020-10-12,2020-10-12,2.0,-19.41,3844.9,0.0,162.0,           ,1.0,1.0,69.0
1631,Ruoka_paivittaistavarakauppa,2020-10-12 13:25:25.423728813,2020-10-12,2020-10-12,2020-10-12,2.0,-16.16,3828.74,0.0,162.0,           ,1.0,1.0,37.0
1632,Ruoka_paivittaistavarakauppa,2020-10-12 14:38:38.644067796,2020-10-12,2020-10-12,2020-10-12,2.0,-11.08,3817.66,0.0,162.0,           ,1.0,1.0,54.0
1633,Ruoka_paivittaistavarakauppa,2020-10-12 15:51:51.864406779,2020-10-12,2020-10-12,2020-10-12,2.0,-48.66,3769.0,0.0,162.0,           ,1.0,1.0,138.0
1634,Saastot_sijoitukset,2020-10-15 19:31:31.525423728,2020-10-15,2020-10-16,2020-10-15,2.0,-4.6,3764.4,0.0,162.0,           ,1.0,1.0,120.0
1635,Ravintolat_kahvilat,2020-10-16 17:05:05.084745762,2020-10-16,2020-10-16,2020-10-16,2.0,-23.72,3740.68,0.0,162.0,           ,1.0,1.0,94.0
1636,Ruoka_paivittaistavarakauppa,2020-10-16 18:18:18.305084745,2020-10-16,2020-10-16,2020-10-16,2.0,-7.51,3733.17,0.0,162.0,           ,1.0,1.0,133.0
1637,Ruoka_paivittaistavarakauppa,2020-10-19 20:44:44.745762711,2020-10-19,2020-10-19,2020-10-19,2.0,-1.51,3731.66,0.0,162.0,           ,1.0,1.0,105.0
1638,Ravintolat_kahvilat,2020-10-19 21:57:57.966101694,2020-10-19,2020-10-19,2020-10-19,2.0,-3.99,3727.67,0.0,162.0,           ,1.0,1.0,72.0
1639,Muut,2020-10-20 23:11:11.186440677,2020-10-20,2020-10-20,2020-10-20,2.0,-5.87,3721.8,0.0,162.0,           ,1.0,1.0,77.0
1640,Ruoka_paivittaistavarakauppa,2020-10-22 00:24:24.406779660,2020-10-22,2020-10-22,2020-10-22,2.0,-11.43,3710.37,0.0,162.0,           ,1.0,1.0,122.0
1641,Ruoka_paivittaistavarakauppa,2020-10-22 01:37:37.627118643,2020-10-22,2020-10-22,2020-10-22,2.0,-10.69,3699.68,0.0,162.0,           ,1.0,1.0,78.0
1642,Liikkuminen,2020-10-23 02:50:50.847457626,2020-10-23,2020-10-23,2020-10-23,2.0,-90.56,3609.12,0.0,162.0,           ,1.0,1.0,65.0
1643,Tulot,2020-10-23 04:04:04.067796609,2020-10-23,2020-10-23,2020-10-23,2.0,-14.33,3594.79,0.0,162.0,           ,1.0,1.0,125.0
1644,Ravintolat_kahvilat,2020-10-26 05:17:17.288135592,2020-10-26,2020-10-26,2020-10-26,2.0,-10.05,3584.74,0.0,162.0,           ,1.0,1.0,76.0
1645,Liikkuminen,2020-10-27 06:30:30.508474575,2020-10-27,2020-10-27,2020-10-27,2.0,-2.77,3581.97,0.0,162.0,           ,1.0,1.0,87.0
1646,Luokittelemattomat,2020-10-28 07:43:43.728813558,2020-10-28,2020-10-28,2020-10-28,2.0,-217.71,3364.26,0.0,106.0,OKOYFIHH   ,1.0,0.0,4.0
1647,Luokittelemattomat,2020-10-29 08:56:56.949152541,2020-10-29,2020-10-29,2020-10-29,2.0,-369.92,2994.34,0.0,106.0,OKOYFIHH   ,1.0,0.0,7.0
1648,Ravintolat_kahvilat,2020-10-30 10:10:10.169491524,2020-10-30,2020-10-30,2020-10-30,2.0,-19.05,2975.29,0.0,162.0,           ,1.0,1.0,105.0
1649,Ravintolat_kahvilat,2020-10-30 11:23:23.389830507,2020-10-30,2020-10-30,2020-10-30,2.0,-15.97,2959.32,0.0,162.0,           ,1.0,1.0,87.0
1650,Tulot,2020-11-02 02:10:54.545454545,2020-11-02,2020-11-02,2020-11-02,2.0,1507.86,4467.18,701.0,520.0,           ,1.0,1.0,176.0
1651,Ruoka_paivittaistavarakauppa,2020-11-03 04:21:49.090909090,2020-11-03,2020-11-03,2020-11-03,2.0,-35.32,4431.86,0.0,162.0,           ,1.0,1.0,123.0
1652,Asuminen,2020-11-04 06:32:43.636363635,2020-11-04,2020-11-04,2020-11-04,2.0,-400.81,4031.05,0.0,162.0,           ,1.0,1.0,28.0
1653,Hyvinvointi,2020-11-05 08:43:38.181818180,2020-11-05,2020-11-05,2020-11-05,2.0,-96.35,3934.7,0.0,106.0,DABAFIHH   ,0.0,0.0,2.0
1654,Tulot,2020-11-06 10:54:32.727272725,2020-11-06,2020-11-06,2020-11-06,2.0,186.85,4121.55,701.0,520.0,           ,1.0,1.0,177.0
1655,Tulot,2020-11-06 13:05:27.272727270,2020-11-06,2020-11-06,2020-11-06,2.0,35.36,4156.91,701.0,520.0,           ,1.0,1.0,180.0
1656,Luottojen_maksut,2020-11-09 15:16:21.818181815,2020-11-09,2020-11-09,2020-11-09,2.0,-825.53,3331.38,0.0,172.0,           ,1.0,1.0,157.0
1657,Luottojen_maksut,2020-11-09 17:27:16.363636360,2020-11-09,2020-11-09,2020-11-09,2.0,-204.62,3126.76,0.0,172.0,           ,1.0,1.0,158.0
1658,Tulot,2020-11-10 19:38:10.909090905,2020-11-10,2020-11-10,2020-11-10,2.0,1504.65,4631.41,701.0,520.0,           ,1.0,1.0,178.0
1659,Ruoka_paivittaistavarakauppa,2020-11-10 21:49:05.454545450,2020-11-10,2020-11-10,2020-11-10,2.0,-8.12,4623.29,0.0,162.0,           ,1.0,1.0,99.0
1660,Ruoka_paivittaistavarakauppa,2020-11-12 23:59:59.999999995,2020-11-12,2020-11-12,2020-11-12,2.0,-133.42,4489.87,0.0,162.0,           ,1.0,1.0,83.0
1661,Tulot,2020-11-13 04:21:49.090909085,2020-11-13,2020-11-13,2020-11-13,2.0,882.86,5372.73,701.0,520.0,           ,1.0,1.0,177.0
1662,Hyvinvointijakauneus,2020-11-15 02:10:54.545454540,2020-11-15,2020-11-15,2020-11-15,2.0,-23.65,5349.08,0.0,106.0,OKOYFIHH   ,0.0,0.0,3.0
1663,Ruoka_paivittaistavarakauppa,2020-11-16 06:32:43.636363630,2020-11-16,2020-11-16,2020-11-16,2.0,-4.69,5344.39,0.0,162.0,           ,1.0,1.0,104.0
1664,Muut,2020-11-17 08:43:38.181818175,2020-11-17,2020-11-17,2020-11-17,2.0,-22.29,5322.1,0.0,162.0,           ,1.0,1.0,87.0
1665,Tulot,2020-11-19 10:54:32.727272720,2020-11-19,2020-11-19,2020-11-19,2.0,1498.24,6820.34,0.0,506.0,           ,1.0,1.0,166.0
1666,Vakuutukset,2020-11-19 13:05:27.272727265,2020-11-19,2020-11-19,2020-11-19,2.0,-91.37,6728.97,0.0,106.0,OKOYFIHH   ,0.0,0.0,16.0
1667,Ruoka_paivittaistavarakauppa,2020-11-20 15:16:21.818181810,2020-11-20,2020-11-20,2020-11-20,2.0,-41.3,6687.67,0.0,162.0,           ,1.0,1.0,136.0
1668,Liikkuminen,2020-11-23 17:27:16.363636355,2020-11-23,2020-11-23,2020-11-23,2.0,-28.29,6659.38,0.0,162.0,           ,1.0,1.0,95.0
1669,Liikkuminen,2020-11-23 19:38:10.909090900,2020-11-23,2020-11-23,2020-11-23,2.0,-13.02,6646.36,0.0,162.0,           ,1.0,1.0,99.0
1670,Lapset,2020-11-23 21:49:05.454545445,2020-11-23,2020-11-23,2020-11-23,2.0,-30.16,6616.2,0.0,106.0,OKOYFIHH   ,0.0,0.0,8.0
1671,Luokittelemattomat,2020-11-24 23:59:59.999999990,2020-11-24,2020-11-24,2020-11-24,2.0,-88.6,6527.6,0.0,106.0,OKOYFIHH   ,1.0,0.0,2.0
1672,Muut,2020-11-25 02:10:54.545454535,2020-11-25,2020-11-25,2020-11-25,2.0,-60.53,6467.07,0.0,163.0,           ,1.0,1.0,152.0
1673,Hyvinvointijakauneus,2020-11-27 04:21:49.090909080,2020-11-27,2020-11-30,2020-11-27,2.0,-8.82,6458.25,0.0,162.0,           ,1.0,1.0,84.0
1674,Ravintolat_kahvilat,2020-11-27 06:32:43.636363625,2020-11-27,2020-11-27,2020-11-27,2.0,-10.15,6448.1,0.0,162.0,           ,1.0,1.0,60.0
1675,Ravintolat_kahvilat,2020-11-30 08:43:38.181818170,2020-11-30,2020-11-30,2020-11-30,2.0,-49.81,6398.29,0.0,162.0,           ,1.0,1.0,31.0
1676,Ruoka_paivittaistavarakauppa,2020-11-30 10:54:32.727272715,2020-11-30,2020-11-30,2020-11-30,2.0,-5.02,6393.27,0.0,162.0,           ,1.0,1.0,37.0
1677,Tulot,2020-12-01 09:28:39.745222929,2020-12-01,2020-12-01,2020-12-01,2.0,1384.09,7777.36,701.0,520.0,           ,1.0,1.0,182.0
1678,Terveys,2020-12-01 18:57:19.490445858,2020-12-01,2020-12-01,2020-12-01,2.0,125.4,7902.76,701.0,520.0,           ,1.0,1.0,176.0
1679,Ravintolat_kahvilat,2020-12-02 04:25:59.235668787,2020-12-02,2020-12-02,2020-12-02,2.0,-61.13,7841.63,0.0,162.0,           ,1.0,1.0,60.0
1680,Ruoka_paivittaistavarakauppa,2020-12-02 13:54:38.980891716,2020-12-02,2020-12-02,2020-12-04,2.0,-30.45,7811.18,0.0,162.0,           ,1.0,1.0,95.0
1681,Luottojen_maksut,2020-12-02 23:23:18.726114645,2020-12-02,2020-12-02,2020-12-02,2.0,-31.54,7779.64,0.0,162.0,           ,1.0,1.0,109.0
1682,Tulot,2020-12-03 08:51:58.471337574,2020-12-03,2020-12-03,2020-12-03,2.0,-365.28,7414.36,0.0,192.0,           ,0.0,1.0,159.0
1683,Ruoka_paivittaistavarakauppa,2020-12-03 18:20:38.216560503,2020-12-03,2020-12-03,2020-12-03,2.0,-19.33,7395.03,0.0,192.0,           ,0.0,1.0,159.0
1684,Tulot,2020-12-04 03:49:17.961783432,2020-12-04,2020-12-04,2020-12-04,2.0,24.8,7419.83,710.0,506.0,           ,1.0,1.0,213.0
1685,Asuminen,2020-12-04 08:15:17.197452219,2020-12-04,2020-12-04,2020-12-04,2.0,-18.91,7400.92,0.0,106.0,OKOYFIHH   ,0.0,0.0,6.0
1686,Matkailu,2020-12-04 13:17:57.707006361,2020-12-04,2020-12-04,2020-12-04,2.0,-27.95,7372.97,0.0,162.0,           ,1.0,1.0,83.0
1687,Muut,2020-12-04 17:43:56.942675148,2020-12-04,2020-12-04,2020-12-04,2.0,-20.22,7352.75,0.0,106.0,OKOYFIHH   ,0.0,0.0,18.0
1688,Luottojen_maksut,2020-12-04 22:46:37.452229290,2020-12-04,2020-12-04,2020-12-04,2.0,-32.86,7319.89,0.0,162.0,           ,1.0,1.0,146.0
1689,Ruoka_paivittaistavarakauppa,2020-12-07 03:12:36.687898077,2020-12-07,2020-12-07,2020-12-07,2.0,-51.4,7268.49,0.0,162.0,           ,1.0,1.0,46.0
1690,Ruoka_paivittaistavarakauppa,2020-12-07 07:38:35.923566864,2020-12-07,2020-12-07,2020-12-07,2.0,-16.92,7251.57,0.0,162.0,           ,1.0,1.0,148.0
1691,Ruoka_paivittaistavarakauppa,2020-12-07 12:41:16.433121006,2020-12-07,2020-12-07,2020-12-07,2.0,-37.87,7213.7,0.0,162.0,           ,1.0,1.0,110.0
1692,Tulot,2020-12-07 16:30:34.394904438,2020-12-07,2020-12-07,2020-12-07,2.0,465.54,7679.24,701.0,520.0,           ,1.0,1.0,176.0
1693,Ruoka_paivittaistavarakauppa,2020-12-07 17:07:15.668789793,2020-12-07,2020-12-07,2020-12-07,2.0,-6.07,7673.17,0.0,162.0,           ,1.0,1.0,28.0
1694,Ruoka_paivittaistavarakauppa,2020-12-07 22:09:56.178343935,2020-12-07,2020-12-07,2020-12-07,2.0,-23.33,7649.84,0.0,162.0,           ,1.0,1.0,36.0
1695,Ravintolat_kahvilat,2020-12-08 02:35:55.414012722,2020-12-08,2020-12-08,2020-12-08,2.0,-4.28,7645.56,0.0,162.0,           ,1.0,1.0,91.0
1696,Ruoka_paivittaistavarakauppa,2020-12-08 12:04:35.159235651,2020-12-08,2020-12-08,2020-12-08,2.0,-10.78,7634.78,0.0,162.0,           ,1.0,1.0,126.0
1697,Muut,2020-12-08 21:33:14.904458580,2020-12-08,2020-12-08,2020-12-08,2.0,-10.6,7624.18,0.0,162.0,           ,1.0,1.0,100.0
1698,Liikkuminen,2020-12-09 07:01:54.649681509,2020-12-09,2020-12-09,2020-12-09,2.0,-43.65,7580.53,0.0,162.0,           ,1.0,1.0,50.0
1699,Ruoka_paivittaistavarakauppa,2020-12-10 11:27:53.885350296,2020-12-10,2020-12-10,2020-12-10,2.0,-52.07,7528.46,0.0,162.0,           ,1.0,1.0,45.0
1700,Muut,2020-12-10 20:19:52.356687870,2020-12-10,2020-12-10,2020-12-10,2.0,-539.32,6989.14,0.0,162.0,           ,1.0,1.0,146.0
1701,Muut,2020-12-10 20:56:33.630573225,2020-12-10,2020-12-10,2020-12-10,2.0,-232.12,6757.02,0.0,163.0,           ,1.0,1.0,152.0
1702,Ruoka_paivittaistavarakauppa,2020-12-11 01:59:14.140127367,2020-12-11,2020-12-11,2020-12-11,2.0,-3.37,6753.65,0.0,162.0,           ,1.0,1.0,79.0
1703,Ruoka_paivittaistavarakauppa,2020-12-11 06:25:13.375796154,2020-12-11,2020-12-11,2020-12-11,2.0,-66.78,6686.87,0.0,162.0,           ,1.0,1.0,83.0
1704,Ruoka_paivittaistavarakauppa,2020-12-11 15:53:53.121019083,2020-12-11,2020-12-11,2020-12-11,2.0,-14.58,6672.29,0.0,162.0,           ,1.0,1.0,104.0
1705,Ravintolat_kahvilat,2020-12-14 00:45:51.592356657,2020-12-14,2020-12-15,2020-12-14,2.0,-13.92,6658.37,0.0,162.0,           ,1.0,1.0,65.0
1706,Liikkuminen,2020-12-14 01:22:32.866242012,2020-12-14,2020-12-14,2020-12-14,2.0,-30.31,6628.06,0.0,162.0,           ,1.0,1.0,70.0
1707,Ruoka_paivittaistavarakauppa,2020-12-14 05:48:32.101910799,2020-12-14,2020-12-14,2020-12-14,2.0,-17.38,6610.68,0.0,162.0,           ,1.0,1.0,105.0
1708,Ruoka_paivittaistavarakauppa,2020-12-14 10:14:31.337579586,2020-12-14,2020-12-14,2020-12-14,2.0,-54.11,6556.57,0.0,162.0,           ,1.0,1.0,74.0
1709,Asuminen,2020-12-14 10:51:12.611464941,2020-12-14,2020-12-14,2020-12-14,2.0,-3.27,6553.3,0.0,162.0,           ,1.0,1.0,57.0
1710,Harrastukset,2020-12-14 15:17:11.847133728,2020-12-14,2020-12-15,2020-12-14,2.0,-124.83,6428.47,0.0,162.0,           ,1.0,1.0,98.0
1711,Tulot,2020-12-14 19:43:11.082802515,2020-12-14,2020-12-14,2020-12-14,2.0,74.41,6502.88,710.0,506.0,           ,1.0,1.0,214.0
1712,Asuminen,2020-12-15 05:11:50.828025444,2020-12-15,2020-12-15,2020-12-15,2.0,-1881.98,4620.9,0.0,106.0,DABAFIHH   ,0.0,0.0,21.0
1713,Matkailu,2020-12-15 14:40:30.573248373,2020-12-15,2020-12-15,2020-12-15,2.0,-16.15,4604.75,0.0,106.0,OKOYFIHH   ,0.0,0.0,22.0
1714,Ruoka_paivittaistavarakauppa,2020-12-15 19:06:29.808917160,2020-12-15,2020-12-15,2020-12-15,2.0,-6.31,4598.44,0.0,162.0,           ,1.0,1.0,138.0
1715,Ruoka_paivittaistavarakauppa,2020-12-17 00:09:10.318471302,2020-12-17,2020-12-17,2020-12-17,2.0,-157.38,4441.06,0.0,162.0,           ,1.0,1.0,57.0
1716,Shoppailu,2020-12-17 09:37:50.063694231,2020-12-17,2020-12-17,2020-12-17,2.0,-6.45,4434.61,0.0,162.0,           ,1.0,1.0,122.0
1717,Tulot,2020-12-17 14:03:49.299363018,2020-12-17,2020-12-17,2020-12-17,2.0,227.78,4662.39,0.0,506.0,           ,1.0,1.0,164.0
1718,Ruoka_paivittaistavarakauppa,2020-12-18 03:58:28.280254734,2020-12-18,2020-12-18,2020-12-18,2.0,-96.21,4566.18,0.0,162.0,           ,1.0,1.0,138.0
1719,Ravintolat_kahvilat,2020-12-18 04:35:09.554140089,2020-12-18,2020-12-18,2020-12-18,2.0,-16.12,4550.06,0.0,162.0,           ,1.0,1.0,65.0
1720,Liikkuminen,2020-12-18 09:01:08.789808876,2020-12-18,2020-12-18,2020-12-17,2.0,-8.5,4541.56,0.0,162.0,           ,1.0,1.0,136.0
1721,Ravintolat_kahvilat,2020-12-18 13:27:08.025477663,2020-12-18,2020-12-18,2020-12-18,2.0,-38.76,4502.8,0.0,162.0,           ,1.0,1.0,101.0
1722,Ruoka_paivittaistavarakauppa,2020-12-18 18:29:48.535031805,2020-12-18,2020-12-18,2020-12-18,2.0,-14.52,4488.28,0.0,162.0,           ,1.0,1.0,65.0
1723,Muut,2020-12-18 22:55:47.770700592,2020-12-18,2020-12-18,2020-12-18,2.0,-8.07,4480.21,0.0,162.0,           ,1.0,1.0,71.0
1724,Harrastukset,2020-12-18 23:32:29.044585947,2020-12-18,2020-12-18,2020-12-18,2.0,-126.34,4353.87,706.0,129.0,OKOYFIHH   ,0.0,0.0,196.0
1725,Ravintolat_kahvilat,2020-12-21 03:21:47.006369379,2020-12-21,2020-12-21,2020-12-21,2.0,-8.64,4345.23,0.0,162.0,           ,1.0,1.0,57.0
1726,Matkailu,2020-12-21 08:24:27.515923521,2020-12-21,2020-12-21,2020-12-21,2.0,-197.4,4147.83,0.0,163.0,           ,1.0,1.0,154.0
1727,Saastot_sijoitukset,2020-12-21 12:50:26.751592308,2020-12-21,2020-12-21,2020-12-21,2.0,-37.55,4110.28,0.0,162.0,           ,1.0,1.0,28.0
1728,Muut,2020-12-21 17:16:25.987261095,2020-12-21,2020-12-21,2020-12-21,2.0,-12.83,4097.45,0.0,162.0,           ,1.0,1.0,79.0
1729,Luokittelemattomat,2020-12-21 17:53:07.261146450,2020-12-21,2020-12-21,2020-12-21,2.0,-24.18,4073.27,0.0,162.0,           ,1.0,1.0,146.0
1730,Ruoka_paivittaistavarakauppa,2020-12-21 22:19:06.496815237,2020-12-21,2020-12-21,2020-12-21,2.0,-24.69,4048.58,0.0,162.0,           ,1.0,1.0,78.0
1731,Shoppailu,2020-12-22 07:47:46.242038166,2020-12-22,2020-12-22,2020-12-22,2.0,-17.15,4031.43,0.0,162.0,           ,1.0,1.0,74.0
1732,Ruoka_paivittaistavarakauppa,2020-12-23 06:34:23.694267456,2020-12-23,2020-12-24,2020-12-23,2.0,-108.36,3923.07,0.0,162.0,           ,1.0,1.0,121.0
1733,Ruoka_paivittaistavarakauppa,2020-12-23 21:42:25.222929882,2020-12-23,2020-12-23,2020-12-23,2.0,-14.5,3908.57,0.0,162.0,           ,1.0,1.0,43.0
1734,Luokittelemattomat,2020-12-24 02:45:05.732484024,2020-12-24,2020-12-24,2020-12-24,2.0,-3.92,3904.65,0.0,162.0,           ,1.0,1.0,98.0
1735,Tulot,2020-12-24 07:11:04.968152811,2020-12-24,2020-12-24,2020-12-23,2.0,13.87,3918.52,0.0,570.0,           ,1.0,1.0,169.0
1736,Ravintolat_kahvilat,2020-12-24 12:13:45.477706953,2020-12-24,2020-12-24,2020-12-24,2.0,-3.62,3914.9,0.0,162.0,           ,1.0,1.0,97.0
1737,Matkailu,2020-12-24 16:03:03.439490385,2020-12-24,2020-12-24,2020-12-24,2.0,-28.02,3886.88,0.0,162.0,           ,1.0,1.0,90.0
1738,Ruoka_paivittaistavarakauppa,2020-12-24 21:05:43.949044527,2020-12-24,2020-12-24,2020-12-24,2.0,-56.58,3830.3,0.0,162.0,           ,1.0,1.0,86.0
1739,Saastot_sijoitukset,2020-12-25 11:37:04.203821598,2020-12-25,2020-12-25,2020-12-25,2.0,-20.23,3810.07,0.0,162.0,           ,1.0,1.0,28.0
1740,Tulot,2020-12-25 16:39:44.713375740,2020-12-25,2020-12-25,2020-12-25,2.0,-244.91,3565.16,0.0,129.0,OKOYFIHH   ,0.0,0.0,23.0
1741,Hyvinvointi,2020-12-26 02:08:24.458598669,2020-12-26,2020-12-29,2020-12-26,2.0,-50.5,3514.66,0.0,106.0,OKOYFIHH   ,0.0,0.0,1.0
1742,Shoppailu,2020-12-28 01:31:43.184713314,2020-12-28,2020-12-28,2020-12-28,2.0,-72.95,3441.71,0.0,162.0,           ,1.0,1.0,62.0
1743,Tulot,2020-12-28 05:57:42.420382101,2020-12-28,2020-12-28,2020-12-28,2.0,1482.25,4923.96,0.0,506.0,           ,1.0,1.0,165.0
1744,Ruoka_paivittaistavarakauppa,2020-12-28 11:00:22.929936243,2020-12-28,2020-12-28,2020-12-28,2.0,-33.77,4890.19,0.0,162.0,           ,1.0,1.0,70.0
1745,Matkailu,2020-12-28 15:26:22.165605030,2020-12-28,2020-12-28,2020-12-28,2.0,-21.2,4868.99,0.0,162.0,           ,1.0,1.0,92.0
1746,Ruoka_paivittaistavarakauppa,2020-12-28 20:29:02.675159172,2020-12-28,2020-12-28,2020-12-28,2.0,-2.47,4866.52,0.0,162.0,           ,1.0,1.0,84.0
1747,Ruoka_paivittaistavarakauppa,2020-12-29 09:47:00.382165533,2020-12-29,2020-12-29,2020-12-29,2.0,-16.85,4849.67,0.0,162.0,           ,1.0,1.0,120.0
1748,Shoppailu,2020-12-29 10:23:41.656050888,2020-12-29,2020-12-29,2020-12-29,2.0,-28.16,4821.51,0.0,162.0,           ,1.0,1.0,125.0
1749,Ruoka_paivittaistavarakauppa,2020-12-30 00:18:20.636942604,2020-12-30,2020-12-30,2020-12-30,2.0,-27.38,4794.13,0.0,162.0,           ,1.0,1.0,146.0
1750,Ruoka_paivittaistavarakauppa,2020-12-30 00:55:01.910827959,2020-12-30,2020-12-30,2020-12-30,2.0,-60.71,4733.42,0.0,162.0,           ,1.0,1.0,49.0
1751,Ruoka_paivittaistavarakauppa,2020-12-30 14:49:40.891719675,2020-12-30,2020-12-30,2020-12-30,2.0,-28.25,4705.17,0.0,162.0,           ,1.0,1.0,26.0
1752,Luokittelemattomat,2020-12-30 19:52:21.401273817,2020-12-30,2020-12-30,2020-12-30,2.0,-16.53,4688.64,0.0,162.0,           ,1.0,1.0,128.0
1753,Liikkuminen,2020-12-31 05:21:01.146496746,2020-12-31,2020-12-31,2020-12-31,2.0,-21.45,4667.19,0.0,162.0,           ,1.0,1.0,45.0
1754,Ravintolat_kahvilat,2020-12-31 19:15:40.127388462,2020-12-31,2020-12-31,2020-12-31,2.0,-9.97,4657.22,0.0,162.0,           ,1.0,1.0,94.0
1755,Tulot,2019-01-01 00:00:00.000000000,2019-01-02,2019-01-01,2019-01-01,3.0,52.2,42499.68,701.0,520.0,           ,1.0,1.0,198.0
1756,Ruoka_paivittaistavarakauppa,2019-02-04 19:02:04.137931032,2019-02-04,2019-02-04,2019-02-04,3.0,-24.59,42475.09,0.0,162.0,           ,1.0,1.0,170.0
1757,Tulot,2019-02-04 20:41:22.758620688,2019-02-04,2019-02-04,2019-02-04,3.0,242.35,42717.44,710.0,588.0,           ,0.0,1.0,234.0
1758,Tulot,2019-02-04 22:20:41.379310344,2019-02-04,2019-02-04,2019-02-04,3.0,1418.3,44135.74,710.0,588.0,           ,0.0,1.0,235.0
1759,Liikkuminen,2019-02-08 17:22:45.517241376,2019-02-08,2019-02-08,2019-02-08,3.0,-4.98,44130.76,0.0,162.0,           ,1.0,1.0,81.0
1760,Ravintolat_kahvilat,2019-02-11 15:43:26.896551720,2019-02-11,2019-02-11,2019-02-11,3.0,-267.7,43863.06,706.0,129.0,SBANFIHH   ,0.0,0.0,211.0
1761,Tulot,2019-02-13 12:24:49.655172408,2019-02-13,2019-02-13,2019-02-13,3.0,137.11,44000.17,710.0,588.0,           ,0.0,1.0,235.0
1762,Luottojen_maksut,2019-02-13 14:04:08.275862064,2019-02-13,2019-02-13,2019-02-13,3.0,-148.35,43851.82,706.0,106.0,DABAFIHH   ,0.0,0.0,204.0
1763,Tulot,2019-02-15 10:45:31.034482752,2019-02-15,2019-02-15,2019-02-15,3.0,9250.78,53102.6,710.0,588.0,           ,0.0,1.0,235.0
1764,Muut,2019-02-18 09:06:12.413793096,2019-02-18,2019-02-18,2019-02-18,3.0,-5.23,53097.37,0.0,103.0,           ,0.0,1.0,0.0
1765,Asuminen,2019-02-20 07:26:53.793103440,2019-02-20,2019-02-20,2019-02-20,3.0,-6.46,53090.91,706.0,129.0,OKOYFIHH   ,0.0,0.0,215.0
1766,Tulot,2019-02-21 05:47:35.172413784,2019-02-21,2019-02-21,2019-02-21,3.0,2255.48,55346.39,710.0,588.0,           ,0.0,1.0,234.0
1767,Tulot,2019-02-25 04:08:16.551724128,2019-02-25,2019-02-25,2019-02-25,3.0,832.96,56179.35,710.0,588.0,           ,0.0,1.0,234.0
1768,Tulot,2019-02-26 02:28:57.931034472,2019-02-26,2019-02-26,2019-02-26,3.0,668.83,56848.18,710.0,588.0,           ,0.0,1.0,234.0
1769,Matkailu,2019-02-27 00:49:39.310344816,2019-02-27,2019-02-27,2019-02-27,3.0,-73.17,56775.01,0.0,163.0,           ,1.0,1.0,173.0
1770,Tulot,2019-03-06 15:16:21.818181818,2019-03-06,2019-03-06,2019-03-06,3.0,201.85,56976.86,701.0,520.0,           ,1.0,1.0,197.0
1771,Tulot,2019-03-12 06:32:43.636363636,2019-03-12,2019-03-12,2019-03-12,3.0,248.85,57225.71,710.0,588.0,           ,0.0,1.0,233.0
1772,Asuminen,2019-03-18 21:49:05.454545454,2019-03-18,2019-03-18,2019-03-18,3.0,-122.41,57103.3,0.0,162.0,           ,1.0,1.0,64.0
1773,Tulot,2019-03-22 13:05:27.272727272,2019-03-22,2019-03-22,2019-03-22,3.0,367.77,57471.07,710.0,506.0,           ,1.0,1.0,225.0
1774,Asuminen,2019-03-29 04:21:49.090909090,2019-03-29,2019-03-29,2019-03-29,3.0,-191.15,57279.92,706.0,129.0,NDEAFIHH   ,0.0,0.0,219.0
1775,Tulot,2019-04-01 19:43:33.698630136,2019-04-01,2019-04-03,2019-04-01,3.0,243.39,57523.31,710.0,588.0,           ,0.0,1.0,234.0
1776,Tulot,2019-04-02 15:27:07.397260272,2019-04-02,2019-04-02,2019-04-02,3.0,167.24,57690.55,710.0,588.0,           ,0.0,1.0,233.0
1777,Tulot,2019-04-03 11:10:41.095890408,2019-04-03,2019-04-03,2019-04-03,3.0,199.81,57890.36,710.0,588.0,           ,0.0,1.0,236.0
1778,Tulot,2019-04-04 06:54:14.794520544,2019-04-04,2019-04-04,2019-04-04,3.0,1158.48,59048.84,710.0,588.0,           ,0.0,1.0,233.0
1779,Tulot,2019-04-05 02:37:48.493150680,2019-04-05,2019-04-05,2019-04-05,3.0,109.03,59157.87,710.0,588.0,           ,0.0,1.0,233.0
1780,Ravintolat_kahvilat,2019-04-05 18:04:55.890410952,2019-04-05,2019-04-05,2019-04-05,3.0,-60.83,59097.04,0.0,162.0,           ,1.0,1.0,71.0
1781,Tulot,2019-04-05 22:21:22.191780816,2019-04-05,2019-04-05,2019-04-05,3.0,254.85,59351.89,710.0,588.0,           ,0.0,1.0,234.0
1782,Terveys,2019-04-08 09:32:03.287671224,2019-04-08,2019-04-08,2019-04-08,3.0,59.24,59411.13,710.0,588.0,           ,0.0,1.0,233.0
1783,Tulot,2019-04-09 05:15:36.986301360,2019-04-09,2019-04-09,2019-04-09,3.0,203.81,59614.94,710.0,588.0,           ,0.0,1.0,233.0
1784,Ravintolat_kahvilat,2019-04-09 13:48:29.589041088,2019-04-09,2019-04-09,2019-04-09,3.0,-50.2,59564.74,0.0,162.0,           ,1.0,1.0,44.0
1785,Tulot,2019-04-10 00:59:10.684931496,2019-04-10,2019-04-10,2019-04-10,3.0,428.08,59992.82,710.0,588.0,           ,0.0,1.0,234.0
1786,Tulot,2019-04-10 20:42:44.383561632,2019-04-10,2019-04-10,2019-04-10,3.0,9.72,60002.54,710.0,588.0,           ,0.0,1.0,233.0
1787,Tulot,2019-04-11 16:26:18.082191768,2019-04-11,2019-04-11,2019-04-11,3.0,633.5,60636.04,710.0,588.0,           ,0.0,1.0,233.0
1788,Shoppailu,2019-04-12 12:09:51.780821904,2019-04-12,2019-04-12,2019-04-12,3.0,-24.7,60611.34,0.0,162.0,           ,1.0,1.0,103.0
1789,Tulot,2019-04-15 03:36:59.178082176,2019-04-15,2019-04-15,2019-04-15,3.0,263.51,60874.85,710.0,588.0,           ,0.0,1.0,233.0
1790,Muut,2019-04-15 07:53:25.479452040,2019-04-15,2019-04-15,2019-04-15,3.0,-2.29,60872.56,0.0,103.0,           ,0.0,1.0,0.0
1791,Tulot,2019-04-15 19:04:06.575342448,2019-04-15,2019-04-16,2019-04-15,3.0,178.32,61050.88,710.0,588.0,           ,0.0,1.0,236.0
1792,Asuminen,2019-04-16 10:31:13.972602720,2019-04-16,2019-04-16,2019-04-16,3.0,-33.93,61016.95,706.0,147.0,OKOYFIHH   ,0.0,0.0,221.0
1793,Lemmikit,2019-04-16 14:47:40.273972584,2019-04-16,2019-04-16,2019-04-16,3.0,-6.69,61010.26,0.0,162.0,           ,1.0,1.0,102.0
1794,Tulot,2019-04-16 23:20:32.876712312,2019-04-16,2019-04-16,2019-04-16,3.0,99.76,61110.02,710.0,588.0,           ,0.0,1.0,234.0
1795,Ruoka_paivittaistavarakauppa,2019-04-18 06:14:47.671232856,2019-04-18,2019-04-18,2019-04-15,3.0,-36.57,61073.45,0.0,162.0,           ,1.0,1.0,67.0
1796,Ruoka_paivittaistavarakauppa,2019-04-19 01:58:21.369862992,2019-04-19,2019-04-19,2019-04-19,3.0,-9.05,61064.4,0.0,162.0,           ,1.0,1.0,153.0
1797,Asuminen,2019-04-19 21:41:55.068493128,2019-04-19,2019-04-19,2019-04-19,3.0,-9.13,61055.27,706.0,129.0,DABAFIHH   ,0.0,0.0,217.0
1798,Tulot,2019-04-22 08:52:36.164383536,2019-04-22,2019-04-22,2019-04-22,3.0,274.81,61330.08,710.0,588.0,           ,0.0,1.0,233.0
1799,Luokittelemattomat,2019-04-22 13:09:02.465753400,2019-04-22,2019-04-22,2019-04-22,3.0,-16.43,61313.65,0.0,162.0,           ,1.0,1.0,146.0
1800,Asuminen,2019-04-22 17:25:28.767123264,2019-04-22,2019-04-22,2019-04-22,3.0,-104.49,61209.16,706.0,129.0,DABAFIHH   ,0.0,0.0,215.0
1801,Tulot,2019-04-23 04:36:09.863013672,2019-04-23,2019-04-23,2019-04-23,3.0,333.2,61542.36,710.0,588.0,           ,0.0,1.0,233.0
1802,Tulot,2019-04-23 20:03:17.260273944,2019-04-23,2019-04-23,2019-04-23,3.0,2738.4,64280.76,710.0,588.0,           ,0.0,1.0,233.0
1803,Asuminen,2019-04-24 00:19:43.561643808,2019-04-24,2019-04-24,2019-04-24,3.0,-25.17,64255.59,706.0,129.0,OKOYFIHH   ,0.0,0.0,211.0
1804,Tulot,2019-04-24 15:46:50.958904080,2019-04-24,2019-04-24,2019-04-24,3.0,1376.81,65632.4,710.0,588.0,           ,0.0,1.0,233.0
1805,Ruoka_paivittaistavarakauppa,2019-04-26 07:13:58.356164352,2019-04-26,2019-04-26,2019-04-25,3.0,-7.79,65624.61,0.0,162.0,           ,1.0,1.0,112.0
1806,Luokittelemattomat,2019-04-26 11:30:24.657534216,2019-04-26,2019-04-26,2019-04-26,3.0,-30.98,65593.63,0.0,162.0,           ,1.0,1.0,48.0
1807,Asuminen,2019-04-29 02:57:32.054794488,2019-04-29,2019-04-29,2019-04-29,3.0,-40.8,65552.83,0.0,162.0,           ,1.0,1.0,148.0
1808,Tulot,2019-04-29 18:24:39.452054760,2019-04-29,2019-04-29,2019-04-29,3.0,959.38,66512.21,710.0,588.0,           ,0.0,1.0,233.0
1809,Ravintolat_kahvilat,2019-04-29 22:41:05.753424624,2019-04-29,2019-04-29,2019-04-29,3.0,-2.96,66509.25,0.0,162.0,           ,1.0,1.0,98.0
1810,Ravintolat_kahvilat,2019-04-30 14:08:13.150684896,2019-04-30,2019-04-30,2019-04-30,3.0,-1.6,66507.65,0.0,162.0,           ,1.0,1.0,113.0
1811,Asuminen,2019-05-01 19:50:24.000000000,2019-05-01,2019-05-01,2019-05-01,3.0,-155.62,66352.03,706.0,147.0,OKOYFIHH   ,0.0,0.0,222.0
1812,Lemmikit,2019-05-02 15:40:48.000000000,2019-05-02,2019-05-02,2019-05-02,3.0,-45.54,66306.49,0.0,162.0,           ,1.0,1.0,106.0
1813,Terveys,2019-05-03 07:21:36.000000000,2019-05-03,2019-05-03,2019-05-03,3.0,-77.56,66228.93,706.0,129.0,OKOYFIHH   ,0.0,0.0,211.0
1814,Tulot,2019-05-03 11:31:12.000000000,2019-05-03,2019-05-03,2019-05-03,3.0,427.31,66656.24,710.0,588.0,           ,0.0,1.0,233.0
1815,Liikkuminen,2019-05-03 23:02:24.000000000,2019-05-03,2019-05-03,2019-05-03,3.0,-93.56,66562.68,0.0,162.0,           ,1.0,1.0,111.0
1816,Ruoka_paivittaistavarakauppa,2019-05-06 03:12:00.000000000,2019-05-06,2019-05-06,2019-05-06,3.0,-0.91,66561.77,0.0,162.0,           ,1.0,1.0,124.0
1817,Asuminen,2019-05-06 18:52:48.000000000,2019-05-06,2019-05-06,2019-05-06,3.0,-141.3,66420.47,706.0,129.0,OKOYFIHH   ,0.0,0.0,211.0
1818,Tulot,2019-05-07 14:43:12.000000000,2019-05-07,2019-05-07,2019-05-07,3.0,184.14,66604.61,710.0,588.0,           ,0.0,1.0,233.0
1819,Asuminen,2019-05-08 10:33:36.000000000,2019-05-08,2019-05-08,2019-05-08,3.0,-47.34,66557.27,706.0,129.0,OKOYFIHH   ,0.0,0.0,211.0
1820,Ruoka_paivittaistavarakauppa,2019-05-09 06:24:00.000000000,2019-05-09,2019-05-09,2019-05-09,3.0,-4.92,66552.35,0.0,162.0,           ,1.0,1.0,90.0
1821,Ruoka_paivittaistavarakauppa,2019-05-09 17:55:12.000000000,2019-05-09,2019-05-09,2019-05-09,3.0,-70.11,66482.24,0.0,162.0,           ,1.0,1.0,54.0
1822,Asuminen,2019-05-10 02:14:24.000000000,2019-05-10,2019-05-10,2019-05-10,3.0,-36.08,66446.16,706.0,129.0,DABAFIHH   ,0.0,0.0,212.0
1823,Tulot,2019-05-10 22:04:48.000000000,2019-05-10,2019-05-10,2019-05-10,3.0,10.63,66456.79,710.0,588.0,           ,0.0,1.0,234.0
1824,Ruoka_paivittaistavarakauppa,2019-05-13 05:26:24.000000000,2019-05-13,2019-05-13,2019-05-13,3.0,-15.95,66440.84,0.0,162.0,           ,1.0,1.0,109.0
1825,Liikkuminen,2019-05-13 09:36:00.000000000,2019-05-13,2019-05-13,2019-05-13,3.0,-23.16,66417.68,706.0,129.0,OKOYFIHH   ,0.0,0.0,211.0
1826,Liikkuminen,2019-05-14 01:16:48.000000000,2019-05-14,2019-05-14,2019-05-14,3.0,-124.62,66293.06,0.0,162.0,           ,1.0,1.0,165.0
1827,Muut,2019-05-15 13:45:36.000000000,2019-05-15,2019-05-15,2019-05-15,3.0,-6.17,66286.89,0.0,103.0,           ,0.0,1.0,0.0
1828,Asuminen,2019-05-16 08:38:24.000000000,2019-05-16,2019-05-16,2019-05-16,3.0,-25.31,66261.58,706.0,129.0,OKOYFIHH   ,0.0,0.0,211.0
1829,Lemmikit,2019-05-16 12:48:00.000000000,2019-05-16,2019-05-16,2019-05-16,3.0,-53.64,66207.94,0.0,162.0,           ,1.0,1.0,50.0
1830,Ruoka_paivittaistavarakauppa,2019-05-16 21:07:12.000000000,2019-05-16,2019-05-16,2019-05-16,3.0,-12.18,66195.76,0.0,162.0,           ,1.0,1.0,89.0
1831,Ruoka_paivittaistavarakauppa,2019-05-17 16:57:36.000000000,2019-05-17,2019-05-17,2019-05-17,3.0,-16.46,66179.3,0.0,162.0,           ,1.0,1.0,165.0
1832,Tulot,2019-05-20 00:19:12.000000000,2019-05-20,2019-05-20,2019-05-20,3.0,510.94,66690.24,710.0,588.0,           ,0.0,1.0,233.0
1833,Asuminen,2019-05-20 04:28:48.000000000,2019-05-20,2019-05-20,2019-05-20,3.0,-35.81,66654.43,706.0,129.0,OKOYFIHH   ,0.0,0.0,212.0
1834,Shoppailu,2019-05-20 11:50:24.000000000,2019-05-20,2019-05-20,2019-05-20,3.0,-9.19,66645.24,0.0,162.0,           ,1.0,1.0,146.0
1835,Ruoka_paivittaistavarakauppa,2019-05-20 20:09:36.000000000,2019-05-20,2019-05-20,2019-05-20,3.0,-11.81,66633.43,0.0,162.0,           ,1.0,1.0,94.0
1836,Kulttuuri_viihde,2019-05-22 16:00:00.000000000,2019-05-22,2019-05-22,2019-05-22,3.0,-45.69,66587.74,0.0,162.0,           ,1.0,1.0,109.0
1837,Luottojen_maksut,2019-05-23 07:40:48.000000000,2019-05-23,2019-05-23,2019-05-23,3.0,-32.7,66555.04,0.0,162.0,           ,1.0,1.0,118.0
1838,Asuminen,2019-05-23 19:12:00.000000000,2019-05-23,2019-05-23,2019-05-23,3.0,-119.38,66435.66,0.0,162.0,           ,1.0,1.0,127.0
1839,Tulot,2019-05-24 03:31:12.000000000,2019-05-24,2019-05-24,2019-05-24,3.0,253.19,66688.85,710.0,506.0,           ,1.0,1.0,226.0
1840,Liikkuminen,2019-05-24 23:21:36.000000000,2019-05-24,2019-05-24,2019-05-23,3.0,-618.12,66070.73,706.0,106.0,OKOYFIHH   ,0.0,0.0,208.0
1841,Asuminen,2019-05-27 10:52:48.000000000,2019-05-27,2019-05-27,2019-05-27,3.0,-11.03,66059.7,706.0,129.0,OKOYFIHH   ,0.0,0.0,214.0
1842,Saastot_sijoitukset,2019-05-27 15:02:24.000000000,2019-05-27,2019-05-27,2019-05-27,3.0,-101.36,65958.34,0.0,162.0,           ,1.0,1.0,128.0
1843,Tulot,2019-05-28 06:43:12.000000000,2019-05-28,2019-05-28,2019-05-28,3.0,161.16,66119.5,710.0,588.0,           ,0.0,1.0,233.0
1844,Asuminen,2019-05-29 02:33:36.000000000,2019-05-29,2019-05-29,2019-05-29,3.0,-78.21,66041.29,706.0,129.0,OKOYFIHH   ,0.0,0.0,220.0
1845,Matkailu,2019-05-29 22:24:00.000000000,2019-05-29,2019-05-29,2019-05-29,3.0,-2127.49,63913.8,706.0,129.0,DABAFIHH   ,0.0,0.0,213.0
1846,Ravintolat_kahvilat,2019-05-30 14:04:48.000000000,2019-05-30,2019-05-30,2019-05-30,3.0,-16.1,63897.7,0.0,162.0,           ,1.0,1.0,82.0
1847,Asuminen,2019-05-30 18:14:24.000000000,2019-05-30,2019-05-30,2019-05-30,3.0,-66.87,63830.83,706.0,129.0,DABAFIHH   ,0.0,0.0,212.0
1848,Tulot,2019-06-03 01:39:18.620689655,2019-06-03,2019-06-03,2019-06-03,3.0,70.95,63901.78,710.0,588.0,           ,0.0,1.0,233.0
1849,Asuminen,2019-06-03 05:47:35.172413793,2019-06-03,2019-06-03,2019-06-03,3.0,-718.26,63183.52,706.0,129.0,NDEAFIHH   ,0.0,0.0,214.0
1850,Matkailu,2019-06-03 09:55:51.724137931,2019-06-03,2019-06-03,2019-06-03,3.0,-60.54,63122.98,706.0,129.0,OKOYFIHH   ,1.0,0.0,211.0
1851,Asuminen,2019-06-03 11:35:10.344827586,2019-06-03,2019-06-03,2019-06-03,3.0,-53.61,63069.37,706.0,129.0,NDEAFIHH   ,0.0,0.0,211.0
1852,Lemmikit,2019-06-03 13:14:28.965517241,2019-06-03,2019-06-03,2019-06-03,3.0,-24.6,63044.77,0.0,162.0,           ,1.0,1.0,113.0
1853,Tulot,2019-06-03 15:43:26.896551724,2019-06-03,2019-06-03,2019-06-03,3.0,909.04,63953.81,710.0,588.0,           ,0.0,1.0,233.0
1854,Ruoka_paivittaistavarakauppa,2019-06-03 19:51:43.448275862,2019-06-03,2019-06-03,2019-06-03,3.0,-123.07,63830.74,0.0,162.0,           ,1.0,1.0,129.0
1855,Muut,2019-06-03 21:31:02.068965517,2019-06-03,2019-06-03,2019-06-03,3.0,-296.63,63534.11,0.0,163.0,           ,1.0,1.0,173.0
1856,Ruoka_paivittaistavarakauppa,2019-06-04 07:26:53.793103448,2019-06-04,2019-06-04,2019-06-04,3.0,-24.36,63509.75,0.0,162.0,           ,1.0,1.0,92.0
1857,Ruoka_paivittaistavarakauppa,2019-06-04 17:22:45.517241379,2019-06-04,2019-06-04,2019-06-04,3.0,-4.85,63504.9,0.0,162.0,           ,1.0,1.0,165.0
1858,Saastot_sijoitukset,2019-06-04 23:10:20.689655172,2019-06-04,2019-06-04,2019-06-04,3.0,-50.54,63454.36,0.0,162.0,           ,1.0,1.0,94.0
1859,Asuminen,2019-06-05 03:18:37.241379310,2019-06-05,2019-06-05,2019-06-05,3.0,-136.56,63317.8,706.0,129.0,NDEAFIHH   ,0.0,0.0,211.0
1860,Tulot,2019-06-06 10:45:31.034482758,2019-06-06,2019-06-06,2019-06-06,3.0,846.15,64163.95,710.0,588.0,           ,0.0,1.0,234.0
1861,Tulot,2019-06-07 00:49:39.310344827,2019-06-07,2019-06-07,2019-06-07,3.0,640.03,64803.98,710.0,588.0,           ,0.0,1.0,233.0
1862,Ruoka_paivittaistavarakauppa,2019-06-07 04:57:55.862068965,2019-06-07,2019-06-07,2019-06-07,3.0,-19.33,64784.65,0.0,162.0,           ,1.0,1.0,154.0
1863,Ruoka_paivittaistavarakauppa,2019-06-07 09:06:12.413793103,2019-06-07,2019-06-07,2019-06-03,3.0,-7.61,64777.04,0.0,162.0,           ,1.0,1.0,99.0
1864,Liikkuminen,2019-06-07 14:53:47.586206896,2019-06-07,2019-06-07,2019-06-07,3.0,-85.51,64691.53,0.0,162.0,           ,1.0,1.0,124.0
1865,Ruoka_paivittaistavarakauppa,2019-06-07 19:02:04.137931034,2019-06-07,2019-06-07,2019-06-07,3.0,-6.28,64685.25,0.0,162.0,           ,1.0,1.0,140.0
1866,Muut,2019-06-08 20:41:22.758620689,2019-06-08,2019-06-08,2019-06-08,3.0,-29.13,64656.12,0.0,105.0,OKOYFIHH   ,1.0,0.0,2.0
1867,Ruoka_paivittaistavarakauppa,2019-06-10 02:28:57.931034482,2019-06-10,2019-06-10,2019-06-10,3.0,-40.66,64615.46,0.0,162.0,           ,1.0,1.0,101.0
1868,Kulttuuri_viihde,2019-06-10 06:37:14.482758620,2019-06-10,2019-06-10,2019-06-10,3.0,-148.25,64467.21,0.0,162.0,           ,1.0,1.0,88.0
1869,Ravintolat_kahvilat,2019-06-10 08:16:33.103448275,2019-06-10,2019-06-10,2019-06-10,3.0,-1554.71,62912.5,706.0,129.0,OKOYFIHH   ,0.0,0.0,211.0
1870,Ruoka_paivittaistavarakauppa,2019-06-10 12:24:49.655172413,2019-06-10,2019-06-10,2019-06-10,3.0,-10.23,62902.27,0.0,162.0,           ,1.0,1.0,101.0
1871,Saastot_sijoitukset,2019-06-10 16:33:06.206896551,2019-06-10,2019-06-10,2019-06-10,3.0,-6.3,62895.97,0.0,162.0,           ,1.0,1.0,68.0
1872,Tulot,2019-06-10 22:20:41.379310344,2019-06-10,2019-06-10,2019-06-10,3.0,7634.24,70530.21,710.0,588.0,           ,0.0,1.0,234.0
1873,Ruoka_paivittaistavarakauppa,2019-06-11 09:55:51.724137930,2019-06-11,2019-06-11,2019-06-11,3.0,-8.56,70521.65,0.0,162.0,           ,1.0,1.0,166.0
1874,Liikkuminen,2019-06-11 14:04:08.275862068,2019-06-11,2019-06-11,2019-06-11,3.0,-9.37,70512.28,0.0,162.0,           ,1.0,1.0,85.0
1875,Ruoka_paivittaistavarakauppa,2019-06-11 18:12:24.827586206,2019-06-11,2019-06-11,2019-06-10,3.0,-10.86,70501.42,0.0,162.0,           ,1.0,1.0,86.0
1876,Asuminen,2019-06-12 01:39:18.620689654,2019-06-12,2019-06-12,2019-06-12,3.0,-35.87,70465.55,0.0,162.0,           ,1.0,1.0,102.0
1877,Ravintolat_kahvilat,2019-06-12 04:08:16.551724137,2019-06-12,2019-06-12,2019-06-12,3.0,-75.91,70389.64,0.0,162.0,           ,1.0,1.0,87.0
1878,Terveys,2019-06-13 05:47:35.172413792,2019-06-13,2019-06-13,2019-06-13,3.0,-13.91,70375.73,0.0,162.0,           ,1.0,1.0,140.0
1879,Ruoka_paivittaistavarakauppa,2019-06-13 19:51:43.448275861,2019-06-13,2019-06-13,2019-06-13,3.0,-22.98,70352.75,0.0,162.0,           ,1.0,1.0,52.0
1880,Luottojen_maksut,2019-06-14 15:43:26.896551723,2019-06-14,2019-06-14,2019-06-14,3.0,-787.37,69565.38,706.0,129.0,DABAFIHH   ,0.0,0.0,212.0
1881,Muut,2019-06-14 21:31:02.068965516,2019-06-14,2019-06-14,2019-06-14,3.0,-54.33,69511.05,0.0,162.0,           ,1.0,1.0,64.0
1882,Matkailu,2019-06-15 23:59:59.999999999,2019-06-15,2019-06-15,2019-06-15,3.0,-76.38,69434.67,0.0,106.0,OKOYFIHH   ,0.0,0.0,16.0
1883,Asuminen,2019-06-17 03:18:37.241379309,2019-06-17,2019-06-17,2019-06-17,3.0,-223.73,69210.94,706.0,106.0,DABAFIHH   ,0.0,0.0,205.0
1884,Lemmikit,2019-06-17 07:26:53.793103447,2019-06-17,2019-06-17,2019-06-17,3.0,-18.3,69192.64,0.0,162.0,           ,1.0,1.0,142.0
1885,Liikkuminen,2019-06-17 11:35:10.344827585,2019-06-17,2019-06-17,2019-06-17,3.0,-64.04,69128.6,0.0,162.0,           ,1.0,1.0,86.0
1886,Ruoka_paivittaistavarakauppa,2019-06-17 13:14:28.965517240,2019-06-17,2019-06-17,2019-06-17,3.0,-24.47,69104.13,0.0,162.0,           ,1.0,1.0,102.0
1887,Ruoka_paivittaistavarakauppa,2019-06-17 17:22:45.517241378,2019-06-17,2019-06-17,2019-06-17,3.0,-16.86,69087.27,0.0,162.0,           ,1.0,1.0,115.0
1888,Luottojen_maksut,2019-06-17 19:02:04.137931033,2019-06-17,2019-06-17,2019-06-17,3.0,-110.36,68976.91,0.0,106.0,OKOYFIHH   ,0.0,0.0,20.0
1889,Muut,2019-06-17 23:10:20.689655171,2019-06-17,2019-06-17,2019-06-17,3.0,-19.37,68957.54,0.0,162.0,           ,1.0,1.0,119.0
1890,Tulot,2019-06-18 09:06:12.413793102,2019-06-18,2019-06-18,2019-06-18,3.0,44.97,69002.51,710.0,506.0,           ,1.0,1.0,231.0
1891,Saastot_sijoitukset,2019-06-19 04:57:55.862068964,2019-06-19,2019-06-19,2019-06-18,3.0,-25.36,68977.15,0.0,162.0,           ,1.0,1.0,86.0
1892,Ruoka_paivittaistavarakauppa,2019-06-19 14:53:47.586206895,2019-06-19,2019-06-21,2019-06-19,3.0,-55.54,68921.61,0.0,162.0,           ,1.0,1.0,117.0
1893,Shoppailu,2019-06-20 00:49:39.310344826,2019-06-20,2019-06-20,2019-06-20,3.0,-34.25,68887.36,0.0,162.0,           ,1.0,1.0,106.0
1894,Ruoka_paivittaistavarakauppa,2019-06-20 06:37:14.482758619,2019-06-20,2019-06-20,2019-06-20,3.0,-21.62,68865.74,0.0,162.0,           ,1.0,1.0,136.0
1895,Ruoka_paivittaistavarakauppa,2019-06-20 10:45:31.034482757,2019-06-20,2019-06-20,2019-06-20,3.0,-8.15,68857.59,0.0,162.0,           ,1.0,1.0,141.0
1896,Hyvinvointijakauneus,2019-06-20 16:33:06.206896550,2019-06-20,2019-06-20,2019-06-20,3.0,-48.52,68809.07,0.0,162.0,           ,1.0,1.0,99.0
1897,Ruoka_paivittaistavarakauppa,2019-06-20 20:41:22.758620688,2019-06-20,2019-06-20,2019-06-20,3.0,-11.03,68798.04,0.0,162.0,           ,1.0,1.0,99.0
1898,Liikkuminen,2019-06-20 22:20:41.379310343,2019-06-20,2019-06-20,2019-06-19,3.0,-71.73,68726.31,0.0,162.0,           ,1.0,1.0,104.0
1899,Hyvinvointi,2019-06-21 12:24:49.655172412,2019-06-21,2019-06-21,2019-06-21,3.0,-46.31,68680.0,0.0,162.0,           ,1.0,1.0,45.0
1900,Saastot_sijoitukset,2019-06-24 04:08:16.551724136,2019-06-24,2019-06-24,2019-06-24,3.0,-73.87,68606.13,0.0,162.0,           ,1.0,1.0,79.0
1901,Shoppailu,2019-06-24 05:47:35.172413791,2019-06-24,2019-06-24,2019-06-24,3.0,-28.54,68577.59,0.0,162.0,           ,1.0,1.0,107.0
1902,Ruoka_paivittaistavarakauppa,2019-06-24 08:16:33.103448274,2019-06-24,2019-06-24,2019-06-24,3.0,-8.78,68568.81,0.0,162.0,           ,1.0,1.0,103.0
1903,Ruoka_paivittaistavarakauppa,2019-06-24 09:55:51.724137929,2019-06-24,2019-06-24,2019-06-24,3.0,-47.73,68521.08,0.0,162.0,           ,1.0,1.0,90.0
1904,Tulot,2019-06-24 14:04:08.275862067,2019-06-24,2019-06-24,2019-06-24,3.0,882.0,69403.08,710.0,588.0,           ,0.0,1.0,235.0
1905,Muut,2019-06-24 18:12:24.827586205,2019-06-24,2019-06-24,2019-06-24,3.0,-28.6,69374.48,0.0,162.0,           ,1.0,1.0,85.0
1906,Liikkuminen,2019-06-24 23:59:59.999999998,2019-06-24,2019-06-25,2019-06-24,3.0,-29.21,69345.27,0.0,162.0,           ,1.0,1.0,158.0
1907,Ravintolat_kahvilat,2019-06-25 02:28:57.931034481,2019-06-25,2019-06-25,2019-06-25,3.0,-89.4,69255.87,0.0,162.0,           ,1.0,1.0,44.0
1908,Asuminen,2019-06-25 19:51:43.448275860,2019-06-25,2019-06-25,2019-06-25,3.0,-44.94,69210.93,0.0,162.0,           ,1.0,1.0,113.0
1909,Ruoka_paivittaistavarakauppa,2019-06-27 01:39:18.620689653,2019-06-27,2019-06-27,2019-06-27,3.0,-8.89,69202.04,0.0,162.0,           ,1.0,1.0,135.0
1910,Muut,2019-06-27 11:35:10.344827584,2019-06-27,2019-06-27,2019-06-27,3.0,-154.64,69047.4,0.0,163.0,           ,1.0,1.0,173.0
1911,Liikkuminen,2019-06-27 15:43:26.896551722,2019-06-27,2019-06-27,2019-06-27,3.0,-30.59,69016.81,0.0,162.0,           ,1.0,1.0,86.0
1912,Liikkuminen,2019-06-27 17:22:45.517241377,2019-06-27,2019-06-27,2019-06-27,3.0,-105.95,68910.86,0.0,162.0,           ,1.0,1.0,90.0
1913,Terveys,2019-06-27 21:31:02.068965515,2019-06-27,2019-06-27,2019-06-27,3.0,121.47,69032.33,0.0,505.0,           ,1.0,1.0,186.0
1914,Ruoka_paivittaistavarakauppa,2019-06-28 03:18:37.241379308,2019-06-28,2019-06-28,2019-06-28,3.0,-5.64,69026.69,0.0,162.0,           ,1.0,1.0,85.0
1915,Terveys,2019-06-28 07:26:53.793103446,2019-06-28,2019-06-28,2019-06-28,3.0,-26.82,68999.87,0.0,162.0,           ,1.0,1.0,106.0
1916,Lapset,2019-06-28 09:06:12.413793101,2019-06-28,2019-06-28,2019-06-28,3.0,-51.68,68948.19,0.0,162.0,           ,1.0,1.0,90.0
1917,Matkailu,2019-06-28 13:14:28.965517239,2019-06-28,2019-06-28,2019-06-28,3.0,-29.44,68918.75,0.0,162.0,           ,1.0,1.0,64.0
1918,Luokittelemattomat,2019-06-28 19:02:04.137931032,2019-06-28,2019-07-01,2019-06-28,3.0,-16.58,68902.17,0.0,162.0,           ,1.0,1.0,43.0
1919,Ruoka_paivittaistavarakauppa,2019-06-28 23:10:20.689655170,2019-06-28,2019-06-28,2019-06-28,3.0,-16.13,68886.04,0.0,162.0,           ,1.0,1.0,122.0
1920,Tulot,2019-07-01 17:06:12.413793103,2019-07-01,2019-07-01,2019-07-01,3.0,400.44,69286.48,701.0,520.0,           ,1.0,1.0,199.0
1921,Asuminen,2019-07-02 10:12:24.827586206,2019-07-02,2019-07-02,2019-07-02,3.0,-110.08,69176.4,706.0,129.0,OKOYFIHH   ,0.0,0.0,211.0
1922,Luokittelemattomat,2019-07-03 03:18:37.241379309,2019-07-03,2019-07-03,2019-07-03,3.0,-688.04,68488.36,0.0,106.0,OKOYFIHH   ,1.0,0.0,7.0
1923,Ravintolat_kahvilat,2019-07-03 20:24:49.655172412,2019-07-03,2019-07-03,2019-07-03,3.0,-37.76,68450.6,0.0,106.0,OKOYFIHH   ,0.0,0.0,37.0
1924,Terveys,2019-07-04 13:31:02.068965515,2019-07-04,2019-07-04,2019-07-04,3.0,-41.09,68409.51,0.0,106.0,SBANFIHH   ,0.0,0.0,12.0
1925,Asuminen,2019-07-05 06:37:14.482758618,2019-07-05,2019-07-05,2019-07-05,3.0,-34.27,68375.24,0.0,106.0,OKOYFIHH   ,0.0,0.0,27.0
1926,Liikkuminen,2019-07-05 16:49:39.310344824,2019-07-05,2019-07-05,2019-07-05,3.0,-57.28,68317.96,0.0,162.0,           ,1.0,1.0,81.0
1927,Terveys,2019-07-05 23:43:26.896551721,2019-07-05,2019-07-05,2019-07-05,3.0,-109.97,68207.99,0.0,162.0,           ,1.0,1.0,134.0
1928,Kulttuuri_viihde,2019-07-08 03:02:04.137931030,2019-07-08,2019-07-08,2019-07-08,3.0,-44.6,68163.39,0.0,162.0,           ,1.0,1.0,96.0
1929,Kulttuuri_viihde,2019-07-08 09:55:51.724137927,2019-07-08,2019-07-08,2019-07-08,3.0,-13.99,68149.4,0.0,162.0,           ,1.0,1.0,108.0
1930,Ruoka_paivittaistavarakauppa,2019-07-08 20:08:16.551724133,2019-07-08,2019-07-09,2019-07-08,3.0,-7.74,68141.66,0.0,162.0,           ,1.0,1.0,156.0
1931,Liikkuminen,2019-07-09 13:14:28.965517236,2019-07-09,2019-07-09,2019-07-09,3.0,-33.71,68107.95,0.0,162.0,           ,1.0,1.0,90.0
1932,Ruoka_paivittaistavarakauppa,2019-07-10 23:26:53.793103442,2019-07-10,2019-07-10,2019-07-10,3.0,-22.43,68085.52,0.0,162.0,           ,1.0,1.0,94.0
1933,Ruoka_paivittaistavarakauppa,2019-07-11 02:45:31.034482751,2019-07-11,2019-07-11,2019-07-11,3.0,-7.67,68077.85,0.0,162.0,           ,1.0,1.0,163.0
1934,Luokittelemattomat,2019-07-11 06:20:41.379310339,2019-07-11,2019-07-11,2019-07-11,3.0,-89.03,67988.82,0.0,162.0,           ,1.0,1.0,127.0
1935,Ruoka_paivittaistavarakauppa,2019-07-11 16:33:06.206896545,2019-07-11,2019-07-11,2019-07-11,3.0,-86.95,67901.87,0.0,162.0,           ,1.0,1.0,75.0
1936,Muut,2019-07-12 09:39:18.620689648,2019-07-12,2019-07-12,2019-07-12,3.0,-2.9,67898.97,0.0,162.0,           ,1.0,1.0,129.0
1937,Ruoka_paivittaistavarakauppa,2019-07-12 19:51:43.448275854,2019-07-12,2019-07-12,2019-07-12,3.0,-21.04,67877.93,0.0,162.0,           ,1.0,1.0,103.0
1938,Tulot,2019-07-15 06:04:08.275862060,2019-07-15,2019-07-16,2019-07-15,3.0,614.81,68492.74,710.0,588.0,           ,0.0,1.0,235.0
1939,Tulot,2019-07-15 12:57:55.862068957,2019-07-15,2019-07-15,2019-07-15,3.0,327.9,68820.64,701.0,520.0,           ,1.0,1.0,198.0
1940,Ruoka_paivittaistavarakauppa,2019-07-15 23:10:20.689655163,2019-07-15,2019-07-15,2019-07-15,3.0,-7.41,68813.23,0.0,162.0,           ,1.0,1.0,105.0
1941,Ruoka_paivittaistavarakauppa,2019-07-16 16:16:33.103448266,2019-07-16,2019-07-16,2019-07-16,3.0,-8.43,68804.8,0.0,162.0,           ,1.0,1.0,122.0
1942,Tulot,2019-07-17 02:28:57.931034472,2019-07-17,2019-07-17,2019-07-17,3.0,314.99,69119.79,710.0,588.0,           ,0.0,1.0,237.0
1943,Lemmikit,2019-07-17 09:22:45.517241369,2019-07-17,2019-07-17,2019-07-17,3.0,-94.31,69025.48,0.0,162.0,           ,1.0,1.0,87.0
1944,Ruoka_paivittaistavarakauppa,2019-07-19 05:47:35.172413781,2019-07-19,2019-07-19,2019-07-19,3.0,-20.49,69004.99,0.0,162.0,           ,1.0,1.0,64.0
1945,Tulot,2019-07-19 12:41:22.758620678,2019-07-19,2019-07-19,2019-07-19,3.0,296.39,69301.38,710.0,588.0,           ,0.0,1.0,233.0
1946,Asuminen,2019-07-19 19:35:10.344827575,2019-07-19,2019-07-19,2019-07-19,3.0,-52.14,69249.24,0.0,106.0,OKOYFIHH   ,0.0,0.0,22.0
1947,Shoppailu,2019-07-19 22:53:47.586206884,2019-07-19,2019-07-19,2019-07-19,3.0,-42.71,69206.53,0.0,162.0,           ,1.0,1.0,85.0
1948,Muut,2019-07-21 09:06:12.413793090,2019-07-21,2019-07-21,2019-07-21,3.0,-16.44,69190.09,0.0,106.0,OKOYFIHH   ,0.0,0.0,17.0
1949,Muut,2019-07-23 02:12:24.827586193,2019-07-23,2019-07-23,2019-07-23,3.0,-116.09,69074.0,0.0,163.0,           ,1.0,1.0,173.0
1950,Lapset,2019-07-23 15:59:59.999999987,2019-07-23,2019-07-23,2019-07-23,3.0,-24.78,69049.22,0.0,162.0,           ,1.0,1.0,135.0
1951,Tulot,2019-07-23 19:18:37.241379296,2019-07-23,2019-07-23,2019-07-23,3.0,959.38,70008.6,710.0,588.0,           ,0.0,1.0,236.0
1952,Ruoka_paivittaistavarakauppa,2019-07-24 12:24:49.655172399,2019-07-24,2019-07-24,2019-07-24,3.0,-55.89,69952.71,0.0,162.0,           ,1.0,1.0,99.0
1953,Ruoka_paivittaistavarakauppa,2019-07-25 15:43:26.896551708,2019-07-25,2019-07-25,2019-07-25,3.0,-22.51,69930.2,0.0,162.0,           ,1.0,1.0,172.0
1954,Liikkuminen,2019-07-26 05:31:02.068965502,2019-07-26,2019-07-26,2019-07-23,3.0,-148.48,69781.72,0.0,162.0,           ,1.0,1.0,110.0
1955,Tulot,2019-07-26 22:37:14.482758605,2019-07-26,2019-07-26,2019-07-26,3.0,3271.96,73053.68,710.0,588.0,           ,0.0,1.0,236.0
1956,Liikkuminen,2019-07-29 01:55:51.724137914,2019-07-29,2019-07-29,2019-07-29,3.0,-68.86,72984.82,0.0,162.0,           ,1.0,1.0,156.0
1957,Ruoka_paivittaistavarakauppa,2019-07-29 08:49:39.310344811,2019-07-29,2019-07-29,2019-07-29,3.0,-57.43,72927.39,0.0,162.0,           ,1.0,1.0,98.0
1958,Ruoka_paivittaistavarakauppa,2019-07-29 12:08:16.551724120,2019-07-29,2019-07-29,2019-07-29,3.0,-17.45,72909.94,0.0,162.0,           ,1.0,1.0,106.0
1959,Saastot_sijoitukset,2019-07-29 19:02:04.137931017,2019-07-29,2019-07-31,2019-07-29,3.0,-21.56,72888.38,0.0,162.0,           ,1.0,1.0,55.0
1960,Asuminen,2019-07-29 22:20:41.379310326,2019-07-29,2019-07-31,2019-07-29,3.0,-194.65,72693.73,0.0,162.0,           ,1.0,1.0,59.0
1961,Ruoka_paivittaistavarakauppa,2019-07-31 05:14:28.965517223,2019-07-31,2019-08-01,2019-07-31,3.0,-4.76,72688.97,0.0,162.0,           ,1.0,1.0,92.0
1962,Muut,2019-07-31 15:26:53.793103429,2019-07-31,2019-07-31,2019-07-31,3.0,-35.59,72653.38,706.0,129.0,OKOYFIHH   ,1.0,0.0,212.0
1963,Kulttuuri_viihde,2019-08-02 05:10:35.294117647,2019-08-02,2019-08-02,2019-08-02,3.0,-27.35,72626.03,0.0,106.0,OKOYFIHH   ,0.0,0.0,39.0
1964,Kulttuuri_viihde,2019-08-05 10:21:10.588235294,2019-08-05,2019-08-06,2019-08-05,3.0,-13.23,72612.8,0.0,162.0,           ,1.0,1.0,88.0
1965,Ruoka_paivittaistavarakauppa,2019-08-05 20:42:21.176470588,2019-08-05,2019-08-06,2019-08-05,3.0,-67.41,72545.39,0.0,162.0,           ,1.0,1.0,88.0
1966,Shoppailu,2019-08-06 01:52:56.470588235,2019-08-06,2019-08-06,2019-08-06,3.0,-16.48,72528.91,0.0,162.0,           ,1.0,1.0,117.0
1967,Muut,2019-08-06 15:31:45.882352941,2019-08-06,2019-08-06,2019-08-06,3.0,-10.84,72518.07,0.0,162.0,           ,1.0,1.0,43.0
1968,Tulot,2019-08-07 22:35:17.647058823,2019-08-07,2019-08-07,2019-08-07,3.0,357.18,72875.25,701.0,520.0,           ,1.0,1.0,196.0
1969,Shoppailu,2019-08-09 07:03:31.764705882,2019-08-09,2019-08-09,2019-08-09,3.0,-55.61,72819.64,0.0,162.0,           ,1.0,1.0,135.0
1970,Ruoka_paivittaistavarakauppa,2019-08-09 12:14:07.058823529,2019-08-09,2019-08-09,2019-08-09,3.0,-17.79,72801.85,0.0,162.0,           ,1.0,1.0,169.0
1971,Luokittelemattomat,2019-08-12 17:24:42.352941176,2019-08-12,2019-08-12,2019-08-12,3.0,-111.31,72690.54,0.0,162.0,           ,1.0,1.0,94.0
1972,Tulot,2019-08-13 03:45:52.941176470,2019-08-13,2019-08-13,2019-08-13,3.0,58.75,72749.29,710.0,588.0,           ,0.0,1.0,233.0
1973,Ravintolat_kahvilat,2019-08-15 08:56:28.235294117,2019-08-15,2019-08-15,2019-08-15,3.0,-80.44,72668.85,0.0,162.0,           ,1.0,1.0,124.0
1974,Ruoka_paivittaistavarakauppa,2019-08-15 14:07:03.529411764,2019-08-15,2019-08-15,2019-08-15,3.0,-6.73,72662.12,0.0,162.0,           ,1.0,1.0,109.0
1975,Luokittelemattomat,2019-08-16 19:17:38.823529411,2019-08-16,2019-08-16,2019-08-16,3.0,-32.47,72629.65,0.0,162.0,           ,1.0,1.0,111.0
1976,Ruoka_paivittaistavarakauppa,2019-08-19 00:28:14.117647058,2019-08-19,2019-08-19,2019-08-19,3.0,-6.69,72622.96,0.0,162.0,           ,1.0,1.0,129.0
1977,Liikkuminen,2019-08-19 05:38:49.411764705,2019-08-19,2019-08-19,2019-08-19,3.0,-242.28,72380.68,0.0,162.0,           ,1.0,1.0,101.0
1978,Ruoka_paivittaistavarakauppa,2019-08-20 10:49:24.705882352,2019-08-20,2019-08-20,2019-08-20,3.0,-7.72,72372.96,0.0,162.0,           ,1.0,1.0,147.0
1979,Liikkuminen,2019-08-20 21:10:35.294117646,2019-08-20,2019-08-20,2019-08-20,3.0,-12.27,72360.69,0.0,162.0,           ,1.0,1.0,60.0
1980,Muut,2019-08-22 15:59:59.999999999,2019-08-22,2019-08-22,2019-08-22,3.0,-1218.27,71142.42,0.0,163.0,           ,1.0,1.0,173.0
1981,Liikkuminen,2019-08-23 02:21:10.588235293,2019-08-23,2019-08-23,2019-08-23,3.0,-21.05,71121.37,0.0,162.0,           ,1.0,1.0,103.0
1982,Ruoka_paivittaistavarakauppa,2019-08-26 07:31:45.882352940,2019-08-26,2019-08-26,2019-08-26,3.0,-9.47,71111.9,0.0,162.0,           ,1.0,1.0,44.0
1983,Terveys,2019-08-26 12:42:21.176470587,2019-08-26,2019-08-26,2019-08-26,3.0,-4.91,71106.99,0.0,162.0,           ,1.0,1.0,104.0
1984,Liikkuminen,2019-08-27 17:52:56.470588234,2019-08-27,2019-08-29,2019-08-27,3.0,-26.02,71080.97,0.0,162.0,           ,1.0,1.0,86.0
1985,Asuminen,2019-08-28 23:03:31.764705881,2019-08-28,2019-08-28,2019-08-28,3.0,-64.27,71016.7,0.0,162.0,           ,1.0,1.0,109.0
1986,Tulot,2019-08-30 04:14:07.058823528,2019-08-30,2019-08-30,2019-08-30,3.0,44.07,71060.77,710.0,506.0,           ,1.0,1.0,229.0
1987,Asuminen,2019-08-30 09:24:42.352941175,2019-08-30,2019-08-30,2019-08-30,3.0,-16.37,71044.4,706.0,129.0,OKOYFIHH   ,0.0,0.0,213.0
1988,Muut,2019-09-02 23:12:47.213114754,2019-09-02,2019-09-02,2019-09-02,3.0,-1617.13,69427.27,0.0,105.0,OKOYFIHH   ,1.0,0.0,4.0
1989,Tulot,2019-09-02 23:36:23.606557377,2019-09-02,2019-09-02,2019-09-02,3.0,2125.66,71552.93,701.0,520.0,           ,1.0,1.0,196.0
1990,Ruoka_paivittaistavarakauppa,2019-09-03 22:49:10.819672131,2019-09-03,2019-09-04,2019-09-02,3.0,-26.99,71525.94,0.0,163.0,           ,1.0,1.0,175.0
1991,Hyvinvointijakauneus,2019-09-04 22:25:34.426229508,2019-09-04,2019-09-04,2019-09-04,3.0,-218.41,71307.53,0.0,106.0,HANDFIHH   ,0.0,0.0,25.0
1992,Luottojen_maksut,2019-09-05 21:14:45.245901639,2019-09-05,2019-09-05,2019-09-05,3.0,-265.65,71041.88,0.0,106.0,OKOYFIHH   ,0.0,0.0,24.0
1993,Muut,2019-09-05 22:01:58.032786885,2019-09-05,2019-09-05,2019-09-05,3.0,-89.66,70952.22,0.0,106.0,OKOYFIHH   ,0.0,0.0,16.0
1994,Ravintolat_kahvilat,2019-09-06 21:38:21.639344262,2019-09-06,2019-09-06,2019-09-06,3.0,-38.91,70913.31,0.0,106.0,OKOYFIHH   ,0.0,0.0,23.0
1995,Liikkuminen,2019-09-09 20:27:32.459016393,2019-09-09,2019-09-09,2019-09-09,3.0,-59.85,70853.46,0.0,162.0,           ,1.0,1.0,87.0
1996,Matkailu,2019-09-09 20:51:08.852459016,2019-09-09,2019-09-10,2019-09-09,3.0,-205.71,70647.75,0.0,106.0,HANDFIHH   ,0.0,0.0,8.0
1997,Ruoka_paivittaistavarakauppa,2019-09-10 20:03:56.065573770,2019-09-10,2019-09-10,2019-09-10,3.0,-5.95,70641.8,0.0,162.0,           ,1.0,1.0,120.0
1998,Ruoka_paivittaistavarakauppa,2019-09-11 19:40:19.672131147,2019-09-11,2019-09-11,2019-09-11,3.0,-15.45,70626.35,0.0,162.0,           ,1.0,1.0,68.0
1999,Tulot,2019-09-12 19:16:43.278688524,2019-09-12,2019-09-12,2019-09-12,3.0,336.54,70962.89,710.0,588.0,           ,0.0,1.0,233.0
2000,Asuminen,2019-09-13 18:29:30.491803278,2019-09-13,2019-09-13,2019-09-13,3.0,-29.5,70933.39,706.0,147.0,DABAFIHH   ,0.0,0.0,223.0
2001,Asuminen,2019-09-13 18:53:06.885245901,2019-09-13,2019-09-13,2019-09-13,3.0,-13.67,70919.72,706.0,129.0,OKOYFIHH   ,0.0,0.0,212.0
2002,Matkailu,2019-09-14 18:05:54.098360655,2019-09-14,2019-09-14,2019-09-14,3.0,-46.36,70873.36,0.0,106.0,OKOYFIHH   ,0.0,0.0,15.0
2003,Ruoka_paivittaistavarakauppa,2019-09-16 17:18:41.311475409,2019-09-16,2019-09-16,2019-09-16,3.0,-15.58,70857.78,0.0,162.0,           ,1.0,1.0,103.0
2004,Shoppailu,2019-09-16 17:42:17.704918032,2019-09-16,2019-09-16,2019-09-16,3.0,195.7,71053.48,710.0,588.0,           ,0.0,1.0,233.0
2005,Asuminen,2019-09-17 16:55:04.918032786,2019-09-17,2019-09-17,2019-09-17,3.0,-18.92,71034.56,706.0,129.0,OKOYFIHH   ,0.0,0.0,212.0
2006,Ruoka_paivittaistavarakauppa,2019-09-19 15:44:15.737704917,2019-09-19,2019-09-19,2019-09-19,3.0,-56.67,70977.89,0.0,162.0,           ,1.0,1.0,109.0
2007,Tulot,2019-09-20 15:20:39.344262294,2019-09-20,2019-09-20,2019-09-20,3.0,345.75,71323.64,710.0,588.0,           ,0.0,1.0,233.0
2008,Ruoka_paivittaistavarakauppa,2019-09-20 16:07:52.131147540,2019-09-20,2019-09-20,2019-09-20,3.0,-31.97,71291.67,0.0,162.0,           ,1.0,1.0,81.0
2009,Muut,2019-09-20 16:31:28.524590163,2019-09-20,2019-09-20,2019-09-20,3.0,-276.27,71015.4,0.0,163.0,           ,1.0,1.0,173.0
2010,Tulot,2019-09-23 14:33:26.557377048,2019-09-23,2019-09-23,2019-09-23,3.0,521.78,71537.18,710.0,588.0,           ,0.0,1.0,233.0
2011,Ruoka_paivittaistavarakauppa,2019-09-23 14:57:02.950819671,2019-09-23,2019-09-23,2019-09-23,3.0,-8.34,71528.84,0.0,162.0,           ,1.0,1.0,135.0
2012,Liikkuminen,2019-09-25 13:46:13.770491802,2019-09-25,2019-09-25,2019-09-25,3.0,-7.21,71521.63,0.0,162.0,           ,1.0,1.0,53.0
2013,Shoppailu,2019-09-25 14:09:50.163934425,2019-09-25,2019-09-25,2019-09-25,3.0,419.38,71941.01,0.0,505.0,           ,1.0,1.0,187.0
2014,Ruoka_paivittaistavarakauppa,2019-09-27 12:59:00.983606556,2019-09-27,2019-09-27,2019-09-27,3.0,-9.86,71931.15,0.0,162.0,           ,1.0,1.0,106.0
2015,Lemmikit,2019-09-27 13:22:37.377049179,2019-09-27,2019-09-27,2019-09-27,3.0,-25.24,71905.91,0.0,162.0,           ,1.0,1.0,80.0
2016,Tulot,2019-09-30 12:11:48.196721310,2019-09-30,2019-09-30,2019-09-30,3.0,491.45,72397.36,710.0,588.0,           ,0.0,1.0,233.0
2017,Tulot,2019-09-30 12:35:24.590163933,2019-09-30,2019-09-30,2019-09-30,3.0,2.85,72400.21,710.0,588.0,           ,0.0,1.0,233.0
2018,Tulot,2019-10-01 19:50:24.000000000,2019-10-01,2019-10-01,2019-10-01,3.0,62.69,72462.9,701.0,520.0,           ,1.0,1.0,196.0
2019,Asuminen,2019-10-02 15:40:48.000000000,2019-10-02,2019-10-02,2019-10-02,3.0,-17.16,72445.74,706.0,129.0,NDEAFIHH   ,0.0,0.0,212.0
2020,Tulot,2019-10-03 03:12:00.000000000,2019-10-03,2019-10-03,2019-10-03,3.0,1117.9,73563.64,710.0,588.0,           ,0.0,1.0,234.0
2021,Tulot,2019-10-03 11:31:12.000000000,2019-10-03,2019-10-03,2019-10-03,3.0,191.57,73755.21,710.0,588.0,           ,0.0,1.0,233.0
2022,Ruoka_paivittaistavarakauppa,2019-10-04 07:21:36.000000000,2019-10-04,2019-10-04,2019-10-04,3.0,-50.7,73704.51,0.0,162.0,           ,1.0,1.0,90.0
2023,Ruoka_paivittaistavarakauppa,2019-10-07 14:43:12.000000000,2019-10-07,2019-10-07,2019-10-07,3.0,-11.1,73693.41,0.0,162.0,           ,1.0,1.0,129.0
2024,Shoppailu,2019-10-07 18:52:48.000000000,2019-10-07,2019-10-07,2019-10-07,3.0,-49.91,73643.5,0.0,162.0,           ,1.0,1.0,48.0
2025,Ruoka_paivittaistavarakauppa,2019-10-07 23:02:24.000000000,2019-10-07,2019-10-07,2019-10-07,3.0,-22.39,73621.11,0.0,162.0,           ,1.0,1.0,109.0
2026,Ruoka_paivittaistavarakauppa,2019-10-08 10:33:36.000000000,2019-10-08,2019-10-08,2019-10-08,3.0,-12.58,73608.53,0.0,162.0,           ,1.0,1.0,105.0
2027,Ruoka_paivittaistavarakauppa,2019-10-09 06:24:00.000000000,2019-10-09,2019-10-09,2019-10-09,3.0,-11.6,73596.93,0.0,162.0,           ,1.0,1.0,139.0
2028,Terveys,2019-10-10 02:14:24.000000000,2019-10-10,2019-10-10,2019-10-10,3.0,-311.76,73285.17,706.0,129.0,OKOYFIHH   ,0.0,0.0,211.0
2029,Asuminen,2019-10-10 17:55:12.000000000,2019-10-10,2019-10-10,2019-10-10,3.0,-162.19,73122.98,706.0,129.0,OKOYFIHH   ,0.0,0.0,211.0
2030,Asuminen,2019-10-11 22:04:48.000000000,2019-10-11,2019-10-11,2019-10-11,3.0,-7.85,73115.13,706.0,129.0,OKOYFIHH   ,0.0,0.0,219.0
2031,Asuminen,2019-10-12 09:36:00.000000000,2019-10-12,2019-10-12,2019-10-12,3.0,-23.91,73091.22,0.0,106.0,OKOYFIHH   ,0.0,0.0,7.0
2032,Luokittelemattomat,2019-10-14 05:26:24.000000000,2019-10-14,2019-10-14,2019-10-14,3.0,-126.92,72964.3,0.0,106.0,OKOYFIHH   ,0.0,0.0,21.0
2033,Tulot,2019-10-14 13:45:36.000000000,2019-10-14,2019-10-14,2019-10-14,3.0,254.01,73218.31,710.0,588.0,           ,0.0,1.0,238.0
2034,Luokittelemattomat,2019-10-14 16:57:36.000000000,2019-10-14,2019-10-14,2019-10-14,3.0,-178.8,73039.51,0.0,162.0,           ,1.0,1.0,90.0
2035,Hyvinvointi,2019-10-14 21:07:12.000000000,2019-10-14,2019-10-14,2019-10-14,3.0,-20.8,73018.71,0.0,162.0,           ,1.0,1.0,157.0
2036,Tulot,2019-10-15 01:16:48.000000000,2019-10-15,2019-10-15,2019-10-15,3.0,59.86,73078.57,710.0,588.0,           ,0.0,1.0,233.0
2037,Muut,2019-10-18 08:38:24.000000000,2019-10-18,2019-10-18,2019-10-18,3.0,-173.25,72905.32,0.0,162.0,           ,1.0,1.0,71.0
2038,Saastot_sijoitukset,2019-10-18 12:48:00.000000000,2019-10-18,2019-10-18,2019-10-18,3.0,-28.0,72877.32,0.0,162.0,           ,1.0,1.0,117.0
2039,Liikkuminen,2019-10-18 20:09:36.000000000,2019-10-18,2019-10-18,2019-10-18,3.0,-27.07,72850.25,0.0,162.0,           ,1.0,1.0,158.0
2040,Luokittelemattomat,2019-10-19 00:19:12.000000000,2019-10-19,2019-10-19,2019-10-19,3.0,-618.45,72231.8,0.0,106.0,OKOYFIHH   ,0.0,0.0,8.0
2041,Tulot,2019-10-21 04:28:48.000000000,2019-10-21,2019-10-21,2019-10-21,3.0,678.82,72910.62,710.0,588.0,           ,0.0,1.0,233.0
2042,Asuminen,2019-10-21 07:40:48.000000000,2019-10-21,2019-10-22,2019-10-21,3.0,-63.69,72846.93,0.0,162.0,           ,1.0,1.0,68.0
2043,Ruoka_paivittaistavarakauppa,2019-10-21 16:00:00.000000000,2019-10-21,2019-10-21,2019-10-21,3.0,-18.81,72828.12,0.0,162.0,           ,1.0,1.0,68.0
2044,Shoppailu,2019-10-23 11:50:24.000000000,2019-10-23,2019-10-23,2019-10-23,3.0,-22.3,72805.82,0.0,162.0,           ,1.0,1.0,113.0
2045,Tulot,2019-10-23 15:02:24.000000000,2019-10-23,2019-10-23,2019-10-23,3.0,592.43,73398.25,710.0,588.0,           ,0.0,1.0,233.0
2046,Tulot,2019-10-24 03:31:12.000000000,2019-10-24,2019-10-24,2019-10-24,3.0,333.73,73731.98,710.0,588.0,           ,0.0,1.0,234.0
2047,Tulot,2019-10-24 23:21:36.000000000,2019-10-24,2019-10-24,2019-10-24,3.0,57.42,73789.4,710.0,588.0,           ,0.0,1.0,235.0
2048,Tulot,2019-10-25 19:12:00.000000000,2019-10-25,2019-10-25,2019-10-25,3.0,447.07,74236.47,710.0,588.0,           ,0.0,1.0,236.0
2049,Muut,2019-10-27 22:24:00.000000000,2019-10-27,2019-10-27,2019-10-27,3.0,-1648.05,72588.42,0.0,163.0,           ,1.0,1.0,173.0
2050,Tulot,2019-10-28 06:43:12.000000000,2019-10-28,2019-10-30,2019-10-28,3.0,242.57,72830.99,710.0,588.0,           ,0.0,1.0,235.0
2051,Tulot,2019-10-28 10:52:48.000000000,2019-10-28,2019-10-28,2019-10-28,3.0,3854.84,76685.83,710.0,588.0,           ,0.0,1.0,233.0
2052,Asuminen,2019-10-29 02:33:36.000000000,2019-10-29,2019-10-29,2019-10-29,3.0,-219.14,76466.69,706.0,129.0,OKOYFIHH   ,0.0,0.0,215.0
2053,Ruoka_paivittaistavarakauppa,2019-10-30 18:14:24.000000000,2019-10-30,2019-11-01,2019-10-30,3.0,-80.48,76386.21,0.0,162.0,           ,1.0,1.0,44.0
2054,Asuminen,2019-10-31 14:04:48.000000000,2019-10-31,2019-10-31,2019-10-31,3.0,-23.07,76363.14,706.0,129.0,OKOYFIHH   ,0.0,0.0,219.0
2055,Tulot,2019-11-01 06:58:03.870967740,2019-11-01,2019-11-01,2019-11-01,3.0,77.46,76440.6,701.0,520.0,           ,1.0,1.0,198.0
2056,Saastot_sijoitukset,2019-11-01 15:29:01.935483870,2019-11-01,2019-11-01,2019-11-01,3.0,-23.29,76417.31,0.0,192.0,           ,0.0,1.0,184.0
2057,Matkailu,2019-11-04 05:25:09.677419350,2019-11-04,2019-11-04,2019-11-04,3.0,-23.23,76394.08,706.0,129.0,OKOYFIHH   ,0.0,0.0,211.0
2058,Saastot_sijoitukset,2019-11-04 13:56:07.741935480,2019-11-04,2019-11-04,2019-11-04,3.0,-24.4,76369.68,0.0,162.0,           ,1.0,1.0,163.0
2059,Ruoka_paivittaistavarakauppa,2019-11-04 20:54:11.612903220,2019-11-04,2019-11-04,2019-11-04,3.0,-6.99,76362.69,0.0,162.0,           ,1.0,1.0,123.0
2060,Asuminen,2019-11-04 22:27:05.806451610,2019-11-04,2019-11-04,2019-11-04,3.0,-43.38,76319.31,0.0,162.0,           ,1.0,1.0,87.0
2061,Hyvinvointijakauneus,2019-11-05 12:23:13.548387090,2019-11-05,2019-11-05,2019-11-05,3.0,-187.17,76132.14,0.0,162.0,           ,1.0,1.0,86.0
2062,Ruoka_paivittaistavarakauppa,2019-11-06 19:21:17.419354830,2019-11-06,2019-11-06,2019-11-06,3.0,-9.09,76123.05,0.0,162.0,           ,1.0,1.0,121.0
2063,Asuminen,2019-11-07 02:19:21.290322570,2019-11-07,2019-11-07,2019-11-07,3.0,-19.57,76103.48,706.0,129.0,OKOYFIHH   ,0.0,0.0,212.0
2064,Ruoka_paivittaistavarakauppa,2019-11-07 03:52:15.483870960,2019-11-07,2019-11-07,2019-11-07,3.0,-2.01,76101.47,0.0,162.0,           ,1.0,1.0,64.0
2065,Liikkuminen,2019-11-07 10:50:19.354838700,2019-11-07,2019-11-07,2019-11-07,3.0,-31.95,76069.52,0.0,162.0,           ,1.0,1.0,64.0
2066,Ruoka_paivittaistavarakauppa,2019-11-08 17:48:23.225806440,2019-11-08,2019-11-08,2019-11-08,3.0,-23.96,76045.56,0.0,162.0,           ,1.0,1.0,103.0
2067,Muut,2019-11-10 09:17:25.161290310,2019-11-10,2019-11-10,2019-11-10,3.0,-218.53,75827.03,0.0,163.0,           ,1.0,1.0,173.0
2068,Liikkuminen,2019-11-11 00:46:27.096774180,2019-11-11,2019-11-11,2019-11-11,3.0,-14.73,75812.3,0.0,162.0,           ,1.0,1.0,138.0
2069,Asuminen,2019-11-11 07:44:30.967741920,2019-11-11,2019-11-11,2019-11-11,3.0,-23271.42,52540.88,0.0,162.0,           ,1.0,1.0,46.0
2070,Saastot_sijoitukset,2019-11-11 16:15:29.032258050,2019-11-11,2019-11-11,2019-11-11,3.0,-53.65,52487.23,0.0,162.0,           ,1.0,1.0,156.0
2071,Ruoka_paivittaistavarakauppa,2019-11-11 23:13:32.903225790,2019-11-11,2019-11-11,2019-11-11,3.0,-28.65,52458.58,0.0,162.0,           ,1.0,1.0,138.0
2072,Ruoka_paivittaistavarakauppa,2019-11-12 06:11:36.774193530,2019-11-12,2019-11-12,2019-11-12,3.0,-2.12,52456.46,0.0,162.0,           ,1.0,1.0,146.0
2073,Hyvinvointijakauneus,2019-11-12 14:42:34.838709660,2019-11-12,2019-11-12,2019-11-12,3.0,-6.46,52450.0,0.0,162.0,           ,1.0,1.0,163.0
2074,Asuminen,2019-11-13 21:40:38.709677400,2019-11-13,2019-11-13,2019-11-13,3.0,-28.49,52421.51,706.0,129.0,OKOYFIHH   ,0.0,0.0,213.0
2075,Matkailu,2019-11-14 11:36:46.451612880,2019-11-14,2019-11-14,2019-11-14,3.0,-14.75,52406.76,0.0,162.0,           ,1.0,1.0,99.0
2076,Asuminen,2019-11-15 04:38:42.580645140,2019-11-15,2019-11-15,2019-11-15,3.0,-35.03,52371.73,706.0,129.0,NDEAFIHH   ,0.0,0.0,217.0
2077,Luokittelemattomat,2019-11-15 13:09:40.645161270,2019-11-15,2019-11-15,2019-11-15,3.0,-21.54,52350.19,0.0,162.0,           ,1.0,1.0,86.0
2078,Ruoka_paivittaistavarakauppa,2019-11-18 10:03:52.258064490,2019-11-18,2019-11-18,2019-11-18,3.0,-25082.27,27267.92,0.0,192.0,           ,0.0,1.0,183.0
2079,Luokittelemattomat,2019-11-18 18:34:50.322580620,2019-11-18,2019-11-18,2019-11-18,3.0,-831.99,26435.93,0.0,106.0,SBANFIHH   ,1.0,0.0,9.0
2080,Shoppailu,2019-11-18 20:07:44.516129010,2019-11-18,2019-11-18,2019-11-18,3.0,-18.87,26417.06,0.0,162.0,           ,1.0,1.0,155.0
2081,Luokittelemattomat,2019-11-19 01:32:54.193548360,2019-11-19,2019-11-19,2019-11-19,3.0,-273.84,26143.22,0.0,162.0,           ,1.0,1.0,112.0
2082,Matkailu,2019-11-19 03:05:48.387096750,2019-11-19,2019-11-20,2019-11-19,3.0,-571.43,25571.79,0.0,106.0,OKOYFIHH   ,1.0,0.0,24.0
2083,Luokittelemattomat,2019-11-19 17:01:56.129032230,2019-11-19,2019-11-19,2019-11-19,3.0,-11.67,25560.12,0.0,162.0,           ,1.0,1.0,76.0
2084,Liikkuminen,2019-11-19 23:59:59.999999970,2019-11-19,2019-11-19,2019-11-19,3.0,-26.29,25533.83,0.0,162.0,           ,1.0,1.0,100.0
2085,Liikkuminen,2019-11-20 15:29:01.935483840,2019-11-20,2019-11-20,2019-11-20,3.0,-117.68,25416.15,0.0,162.0,           ,1.0,1.0,57.0
2086,Ruoka_paivittaistavarakauppa,2019-11-21 06:58:03.870967710,2019-11-21,2019-11-21,2019-11-18,3.0,-52.95,25363.2,0.0,162.0,           ,1.0,1.0,90.0
2087,Muut,2019-11-21 08:30:58.064516100,2019-11-21,2019-11-21,2019-11-21,3.0,-22.32,25340.88,0.0,163.0,           ,1.0,1.0,174.0
2088,Luottojen_maksut,2019-11-22 13:56:07.741935450,2019-11-22,2019-11-22,2019-11-22,3.0,-58.53,25282.35,0.0,106.0,OKOYFIHH   ,0.0,0.0,17.0
2089,Asuminen,2019-11-22 22:27:05.806451580,2019-11-22,2019-11-22,2019-11-22,3.0,-64.58,25217.77,0.0,162.0,           ,1.0,1.0,64.0
2090,Luottojen_maksut,2019-11-25 05:25:09.677419320,2019-11-25,2019-11-25,2019-11-25,3.0,-304.43,24913.34,706.0,129.0,SBANFIHH   ,0.0,0.0,216.0
2091,Kulttuuri_viihde,2019-11-25 12:23:13.548387060,2019-11-25,2019-11-25,2019-11-25,3.0,-25.55,24887.79,0.0,162.0,           ,1.0,1.0,136.0
2092,Liikkuminen,2019-11-25 20:54:11.612903190,2019-11-25,2019-11-25,2019-11-25,3.0,-288.42,24599.37,706.0,129.0,OKOYFIHH   ,0.0,0.0,212.0
2093,Liikkuminen,2019-11-26 19:21:17.419354800,2019-11-26,2019-11-26,2019-11-26,3.0,-21.25,24578.12,0.0,162.0,           ,1.0,1.0,70.0
2094,Lemmikit,2019-11-27 03:52:15.483870930,2019-11-27,2019-11-27,2019-11-27,3.0,-25.98,24552.14,0.0,106.0,OKOYFIHH   ,0.0,0.0,34.0
2095,Luokittelemattomat,2019-11-27 10:50:19.354838670,2019-11-27,2019-11-27,2019-11-27,3.0,-57.9,24494.24,0.0,162.0,           ,1.0,1.0,162.0
2096,Asuminen,2019-11-27 17:48:23.225806410,2019-11-27,2019-11-27,2019-11-27,3.0,-35.64,24458.6,0.0,162.0,           ,1.0,1.0,44.0
2097,Saastot_sijoitukset,2019-11-28 02:19:21.290322540,2019-11-28,2019-11-28,2019-11-28,3.0,-34.44,24424.16,0.0,162.0,           ,1.0,1.0,59.0
2098,Tulot,2019-11-28 09:17:25.161290280,2019-11-28,2019-11-28,2019-11-28,3.0,2292.69,26716.85,710.0,588.0,           ,0.0,1.0,233.0
2099,Hyvinvointijakauneus,2019-11-29 00:46:27.096774150,2019-11-29,2019-11-29,2019-11-29,3.0,-26.08,26690.77,0.0,162.0,           ,1.0,1.0,63.0
2100,Shoppailu,2019-11-29 16:15:29.032258020,2019-11-29,2019-11-29,2019-11-29,3.0,-30.77,26660.0,0.0,162.0,           ,1.0,1.0,137.0
2101,Ravintolat_kahvilat,2019-12-02 19:07:49.565217390,2019-12-02,2019-12-05,2019-12-02,3.0,-1.69,26658.31,0.0,162.0,           ,1.0,1.0,112.0
2102,Ruoka_paivittaistavarakauppa,2019-12-03 16:41:44.347826085,2019-12-03,2019-12-04,2019-12-03,3.0,-7.94,26650.37,0.0,162.0,           ,1.0,1.0,59.0
2103,Tulot,2019-12-03 21:33:54.782608695,2019-12-03,2019-12-03,2019-12-05,3.0,959.71,27610.08,701.0,520.0,           ,1.0,1.0,198.0
2104,Ruoka_paivittaistavarakauppa,2019-12-04 09:23:28.695652170,2019-12-04,2019-12-04,2019-12-04,3.0,-56.11,27553.97,0.0,162.0,           ,1.0,1.0,140.0
2105,Hyvinvointi,2019-12-04 14:15:39.130434780,2019-12-04,2019-12-04,2019-12-04,3.0,-128.01,27425.96,706.0,106.0,OKOYFIHH   ,0.0,0.0,208.0
2106,Luokittelemattomat,2019-12-05 06:57:23.478260865,2019-12-05,2019-12-05,2019-12-05,3.0,-133.32,27292.64,0.0,106.0,DABAFIHH   ,1.0,0.0,28.0
2107,Luokittelemattomat,2019-12-05 11:49:33.913043475,2019-12-05,2019-12-05,2019-12-05,3.0,-145.09,27147.55,706.0,129.0,OKOYFIHH   ,0.0,0.0,212.0
2108,Liikkuminen,2019-12-09 02:05:13.043478255,2019-12-09,2019-12-09,2019-12-09,3.0,-298.68,26848.87,0.0,162.0,           ,1.0,1.0,53.0
2109,Asuminen,2019-12-09 04:31:18.260869560,2019-12-09,2019-12-11,2019-12-09,3.0,-21.88,26826.99,706.0,129.0,OKOYFIHH   ,0.0,0.0,211.0
2110,Tulot,2019-12-09 18:46:57.391304340,2019-12-09,2019-12-09,2019-12-09,3.0,141.68,26968.67,701.0,521.0,           ,1.0,1.0,201.0
2111,Ruoka_paivittaistavarakauppa,2019-12-09 23:39:07.826086950,2019-12-09,2019-12-09,2019-12-09,3.0,-15.24,26953.43,0.0,162.0,           ,1.0,1.0,132.0
2112,Luokittelemattomat,2019-12-10 21:13:02.608695645,2019-12-10,2019-12-10,2019-12-10,3.0,-324.21,26629.22,706.0,106.0,DABAFIHH   ,1.0,0.0,205.0
2113,Tulot,2019-12-12 16:20:52.173913035,2019-12-12,2019-12-12,2019-12-12,3.0,3361.88,29991.1,710.0,506.0,           ,1.0,1.0,232.0
2114,Muut,2019-12-13 09:02:36.521739120,2019-12-13,2019-12-13,2019-12-13,3.0,-276.43,29714.67,0.0,163.0,           ,1.0,1.0,173.0
2115,Ravintolat_kahvilat,2019-12-13 13:54:46.956521730,2019-12-13,2019-12-13,2019-12-13,3.0,-43.07,29671.6,0.0,162.0,           ,1.0,1.0,116.0
2116,Asuminen,2019-12-16 06:36:31.304347815,2019-12-16,2019-12-16,2019-12-16,3.0,-7.99,29663.61,706.0,106.0,OKOYFIHH   ,0.0,0.0,204.0
2117,Saastot_sijoitukset,2019-12-16 11:28:41.739130425,2019-12-16,2019-12-16,2019-12-16,3.0,-43.53,29620.08,0.0,162.0,           ,1.0,1.0,156.0
2118,Ruoka_paivittaistavarakauppa,2019-12-17 04:10:26.086956510,2019-12-17,2019-12-17,2019-12-17,3.0,-36.65,29583.43,0.0,162.0,           ,1.0,1.0,119.0
2119,Asuminen,2019-12-17 23:18:15.652173900,2019-12-17,2019-12-17,2019-12-17,3.0,-17.09,29566.34,706.0,129.0,OKOYFIHH   ,0.0,0.0,212.0
2120,Muut,2019-12-18 01:44:20.869565205,2019-12-18,2019-12-18,2019-12-18,3.0,-32.64,29533.7,0.0,163.0,           ,1.0,1.0,173.0
2121,Vakuutukset,2019-12-19 20:52:10.434782595,2019-12-19,2019-12-19,2019-12-19,3.0,-35.24,29498.46,706.0,106.0,OKOYFIHH   ,0.0,0.0,205.0
2122,Matkailu,2019-12-20 18:26:05.217391290,2019-12-20,2019-12-20,2019-12-19,3.0,-271.41,29227.05,0.0,163.0,           ,1.0,1.0,174.0
2123,Muut,2019-12-21 15:59:59.999999985,2019-12-21,2019-12-21,2019-12-21,3.0,-42.57,29184.48,0.0,163.0,           ,1.0,1.0,174.0
2124,Matkailu,2019-12-23 11:07:49.565217375,2019-12-23,2019-12-23,2019-12-23,3.0,-38.07,29146.41,0.0,162.0,           ,1.0,1.0,135.0
2125,Kulttuuri_viihde,2019-12-23 13:33:54.782608680,2019-12-23,2019-12-23,2019-12-23,3.0,-9.44,29136.97,0.0,162.0,           ,1.0,1.0,135.0
2126,Luottojen_maksut,2019-12-24 08:41:44.347826070,2019-12-24,2019-12-24,2019-12-24,3.0,-11.69,29125.28,706.0,129.0,DABAFIHH   ,0.0,0.0,213.0
2127,Ruoka_paivittaistavarakauppa,2019-12-25 06:15:39.130434765,2019-12-25,2019-12-25,2019-12-25,3.0,-7.65,29117.63,0.0,162.0,           ,1.0,1.0,59.0
2128,Muut,2019-12-27 01:23:28.695652155,2019-12-27,2019-12-27,2019-12-27,3.0,-130.04,28987.59,0.0,163.0,           ,1.0,1.0,175.0
2129,Liikkuminen,2019-12-27 03:49:33.913043460,2019-12-27,2019-12-27,2019-12-27,3.0,-15.91,28971.68,0.0,162.0,           ,1.0,1.0,96.0
2130,Ravintolat_kahvilat,2019-12-27 20:31:18.260869545,2019-12-27,2019-12-27,2019-12-27,3.0,-10.03,28961.65,0.0,162.0,           ,1.0,1.0,68.0
2131,Luokittelemattomat,2019-12-27 22:57:23.478260850,2019-12-27,2019-12-27,2019-12-27,3.0,-1345.73,27615.92,706.0,106.0,OKOYFIHH   ,1.0,0.0,204.0
2132,Muut,2019-12-30 13:13:02.608695630,2019-12-30,2020-01-01,2019-12-30,3.0,-151.58,27464.34,0.0,163.0,           ,1.0,1.0,173.0
2133,Asuminen,2019-12-30 15:39:07.826086935,2019-12-30,2019-12-30,2019-12-30,3.0,-60.92,27403.42,706.0,129.0,OKOYFIHH   ,0.0,0.0,212.0
2134,Ruoka_paivittaistavarakauppa,2019-12-30 18:05:13.043478240,2019-12-30,2019-12-30,2019-12-30,3.0,-30.35,27373.07,0.0,162.0,           ,1.0,1.0,136.0
2135,Tulot,2020-01-02 05:10:35.294117647,2020-01-02,2020-01-02,2020-01-02,3.0,199.65,27572.72,701.0,520.0,           ,1.0,1.0,196.0
2136,Tulot,2020-01-03 10:21:10.588235294,2020-01-03,2020-01-03,2020-01-03,3.0,210.36,27783.08,701.0,520.0,           ,1.0,1.0,197.0
2137,Ruoka_paivittaistavarakauppa,2020-01-03 15:31:45.882352941,2020-01-03,2020-01-03,2020-01-03,3.0,-17.09,27765.99,0.0,162.0,           ,1.0,1.0,99.0
2138,Ravintolat_kahvilat,2020-01-03 20:42:21.176470588,2020-01-03,2020-01-03,2020-01-03,3.0,-3.08,27762.91,0.0,162.0,           ,1.0,1.0,129.0
2139,Muut,2020-01-07 01:52:56.470588235,2020-01-07,2020-01-07,2020-01-07,3.0,-154.59,27608.32,0.0,163.0,           ,1.0,1.0,174.0
2140,Tulot,2020-01-08 07:03:31.764705882,2020-01-08,2020-01-08,2020-01-08,3.0,2027.6,29635.92,710.0,506.0,           ,1.0,1.0,225.0
2141,Liikkuminen,2020-01-10 12:14:07.058823529,2020-01-10,2020-01-10,2020-01-10,3.0,-647.67,28988.25,706.0,106.0,OKOYFIHH   ,0.0,0.0,204.0
2142,Luokittelemattomat,2020-01-10 17:24:42.352941176,2020-01-10,2020-01-10,2020-01-10,3.0,-144.05,28844.2,706.0,106.0,ITELFIHH   ,0.0,0.0,207.0
2143,Liikkuminen,2020-01-10 22:35:17.647058823,2020-01-10,2020-01-10,2020-01-10,3.0,-49.39,28794.81,0.0,162.0,           ,1.0,1.0,164.0
2144,Ruoka_paivittaistavarakauppa,2020-01-13 03:45:52.941176470,2020-01-13,2020-01-13,2020-01-13,3.0,-60.95,28733.86,0.0,162.0,           ,1.0,1.0,121.0
2145,Lemmikit,2020-01-13 08:56:28.235294117,2020-01-13,2020-01-13,2020-01-13,3.0,-37.74,28696.12,0.0,162.0,           ,1.0,1.0,95.0
2146,Liikkuminen,2020-01-15 14:07:03.529411764,2020-01-15,2020-01-15,2020-01-15,3.0,-64.64,28631.48,0.0,162.0,           ,1.0,1.0,96.0
2147,Ruoka_paivittaistavarakauppa,2020-01-15 19:17:38.823529411,2020-01-15,2020-01-15,2020-01-15,3.0,-91.77,28539.71,0.0,162.0,           ,1.0,1.0,125.0
2148,Ravintolat_kahvilat,2020-01-20 00:28:14.117647058,2020-01-20,2020-01-20,2020-01-20,3.0,-9.75,28529.96,0.0,162.0,           ,1.0,1.0,44.0
2149,Ravintolat_kahvilat,2020-01-20 05:38:49.411764705,2020-01-20,2020-01-20,2020-01-20,3.0,-304.55,28225.41,706.0,106.0,OKOYFIHH   ,0.0,0.0,206.0
2150,Luottojen_maksut,2020-01-20 10:49:24.705882352,2020-01-20,2020-01-20,2020-01-20,3.0,-34.77,28190.64,0.0,106.0,OKOYFIHH   ,0.0,0.0,18.0
2151,Asuminen,2020-01-21 15:59:59.999999999,2020-01-21,2020-01-21,2020-01-21,3.0,-160.85,28029.79,0.0,106.0,OKOYFIHH   ,0.0,0.0,10.0
2152,Asuminen,2020-01-24 02:21:10.588235293,2020-01-24,2020-01-24,2020-01-24,3.0,-30.46,27999.33,706.0,129.0,OKOYFIHH   ,0.0,0.0,214.0
2153,Luokittelemattomat,2020-01-24 07:31:45.882352940,2020-01-24,2020-01-24,2020-01-24,3.0,-6.66,27992.67,0.0,162.0,           ,1.0,1.0,45.0
2154,Luokittelemattomat,2020-01-24 21:10:35.294117646,2020-01-24,2020-01-24,2020-01-24,3.0,-30.8,27961.87,0.0,162.0,           ,1.0,1.0,171.0
2155,Vakuutukset,2020-01-27 12:42:21.176470587,2020-01-27,2020-01-27,2020-01-27,3.0,-43.34,27918.53,706.0,129.0,DABAFIHH   ,0.0,0.0,215.0
2156,Ruoka_paivittaistavarakauppa,2020-01-27 17:52:56.470588234,2020-01-27,2020-01-27,2020-01-27,3.0,-6.73,27911.8,0.0,162.0,           ,1.0,1.0,44.0
2157,Liikkuminen,2020-01-27 23:03:31.764705881,2020-01-27,2020-01-27,2020-01-27,3.0,-43.18,27868.62,0.0,162.0,           ,1.0,1.0,136.0
2158,Ruoka_paivittaistavarakauppa,2020-01-29 04:14:07.058823528,2020-01-29,2020-01-29,2020-01-29,3.0,-17.61,27851.01,0.0,162.0,           ,1.0,1.0,113.0
2159,Muut,2020-01-31 09:24:42.352941175,2020-01-31,2020-01-31,2020-01-31,3.0,-81.84,27769.17,0.0,163.0,           ,1.0,1.0,173.0
2160,Tulot,2020-02-03 15:46:17.142857142,2020-02-03,2020-02-05,2020-02-03,3.0,36.74,27805.91,701.0,520.0,           ,1.0,1.0,197.0
2161,Muut,2020-02-05 07:32:34.285714284,2020-02-05,2020-02-05,2020-02-05,3.0,-302.62,27503.29,0.0,163.0,           ,1.0,1.0,173.0
2162,Tulot,2020-02-05 23:18:51.428571426,2020-02-05,2020-02-05,2020-02-05,3.0,424.99,27928.28,701.0,520.0,           ,1.0,1.0,198.0
2163,Tulot,2020-02-07 15:05:08.571428568,2020-02-07,2020-02-07,2020-02-07,3.0,341.46,28269.74,701.0,521.0,           ,1.0,1.0,201.0
2164,Harrastukset,2020-02-10 06:51:25.714285710,2020-02-10,2020-02-10,2020-02-10,3.0,-17.44,28252.3,706.0,129.0,DABAFIHH   ,0.0,0.0,212.0
2165,Harrastukset,2020-02-10 22:37:42.857142852,2020-02-10,2020-02-10,2020-02-10,3.0,-344.9,27907.4,706.0,106.0,OKOYFIHH   ,0.0,0.0,205.0
2166,Luokittelemattomat,2020-02-12 14:23:59.999999994,2020-02-12,2020-02-12,2020-02-12,3.0,-167.02,27740.38,0.0,106.0,OKOYFIHH   ,1.0,0.0,38.0
2167,Asuminen,2020-02-14 06:10:17.142857136,2020-02-14,2020-02-14,2020-02-14,3.0,-236.25,27504.13,0.0,106.0,OKOYFIHH   ,0.0,0.0,16.0
2168,Liikkuminen,2020-02-17 13:42:51.428571420,2020-02-17,2020-02-17,2020-02-17,3.0,-114.11,27390.02,0.0,162.0,           ,1.0,1.0,163.0
2169,Liikkuminen,2020-02-17 21:56:34.285714278,2020-02-17,2020-02-17,2020-02-17,3.0,-4.06,27385.96,0.0,162.0,           ,1.0,1.0,165.0
2170,Ruoka_paivittaistavarakauppa,2020-02-19 05:29:08.571428562,2020-02-19,2020-02-21,2020-02-19,3.0,-11.83,27374.13,0.0,162.0,           ,1.0,1.0,156.0
2171,Ravintolat_kahvilat,2020-02-20 21:15:25.714285704,2020-02-20,2020-02-20,2020-02-20,3.0,-3.0,27371.13,0.0,162.0,           ,1.0,1.0,84.0
2172,Saastot_sijoitukset,2020-02-21 13:01:42.857142846,2020-02-21,2020-02-21,2020-02-21,3.0,-41.22,27329.91,0.0,162.0,           ,1.0,1.0,153.0
2173,Asuminen,2020-02-24 04:47:59.999999988,2020-02-24,2020-02-24,2020-02-24,3.0,-30.42,27299.49,706.0,129.0,DABAFIHH   ,0.0,0.0,212.0
2174,Ruoka_paivittaistavarakauppa,2020-02-26 20:34:17.142857130,2020-02-26,2020-02-26,2020-02-26,3.0,-11.48,27288.01,0.0,162.0,           ,1.0,1.0,106.0
2175,Tulot,2020-02-27 12:20:34.285714272,2020-02-27,2020-02-27,2020-02-27,3.0,-15.94,27272.07,0.0,162.0,           ,1.0,1.0,94.0
2176,Saastot_sijoitukset,2020-02-28 04:06:51.428571414,2020-02-28,2020-02-28,2020-02-28,3.0,-167.97,27104.1,706.0,129.0,SBANFIHH   ,0.0,0.0,218.0
2177,Tulot,2020-03-02 09:04:00.000000000,2020-03-02,2020-03-02,2020-03-02,3.0,2684.89,29788.99,701.0,520.0,           ,1.0,1.0,198.0
2178,Ruoka_paivittaistavarakauppa,2020-03-03 18:08:00.000000000,2020-03-03,2020-03-03,2020-03-03,3.0,-22.42,29766.57,0.0,162.0,           ,1.0,1.0,147.0
2179,Tulot,2020-03-05 03:12:00.000000000,2020-03-05,2020-03-05,2020-03-04,3.0,777.52,30544.09,701.0,520.0,           ,1.0,1.0,197.0
2180,Liikkuminen,2020-03-05 12:16:00.000000000,2020-03-05,2020-03-05,2020-03-05,3.0,-40.02,30504.07,0.0,162.0,           ,1.0,1.0,82.0
2181,Liikkuminen,2020-03-09 06:24:00.000000000,2020-03-09,2020-03-09,2020-03-09,3.0,-23.47,30480.6,0.0,162.0,           ,1.0,1.0,66.0
2182,Tulot,2020-03-09 15:28:00.000000000,2020-03-09,2020-03-11,2020-03-09,3.0,247.57,30728.17,701.0,520.0,           ,1.0,1.0,198.0
2183,Saastot_sijoitukset,2020-03-09 21:20:00.000000000,2020-03-09,2020-03-10,2020-03-09,3.0,-23.88,30704.29,0.0,162.0,           ,1.0,1.0,53.0
2184,Tulot,2020-03-12 00:32:00.000000000,2020-03-12,2020-03-12,2020-03-12,3.0,21.09,30725.38,710.0,506.0,           ,1.0,1.0,227.0
2185,Matkailu,2020-03-13 09:36:00.000000000,2020-03-13,2020-03-13,2020-03-13,3.0,-419.1,30306.28,0.0,163.0,           ,1.0,1.0,174.0
2186,Ruoka_paivittaistavarakauppa,2020-03-16 03:44:00.000000000,2020-03-16,2020-03-16,2020-03-16,3.0,-7.28,30299.0,0.0,162.0,           ,1.0,1.0,68.0
2187,Asuminen,2020-03-16 12:48:00.000000000,2020-03-16,2020-03-16,2020-03-16,3.0,-61.11,30237.89,706.0,129.0,OKOYFIHH   ,0.0,0.0,211.0
2188,Ravintolat_kahvilat,2020-03-17 18:40:00.000000000,2020-03-17,2020-03-17,2020-03-17,3.0,-4.31,30233.58,0.0,162.0,           ,1.0,1.0,108.0
2189,Saastot_sijoitukset,2020-03-18 21:52:00.000000000,2020-03-18,2020-03-18,2020-03-18,3.0,-28.2,30205.38,0.0,162.0,           ,1.0,1.0,124.0
2190,Ruoka_paivittaistavarakauppa,2020-03-20 06:56:00.000000000,2020-03-20,2020-03-20,2020-03-20,3.0,-5.16,30200.22,0.0,162.0,           ,1.0,1.0,147.0
2191,Ruoka_paivittaistavarakauppa,2020-03-23 01:04:00.000000000,2020-03-23,2020-03-23,2020-03-23,3.0,-423.89,29776.33,0.0,162.0,           ,1.0,1.0,43.0
2192,Liikkuminen,2020-03-23 10:08:00.000000000,2020-03-23,2020-03-23,2020-03-23,3.0,-31.26,29745.07,0.0,162.0,           ,1.0,1.0,166.0
2193,Ruoka_paivittaistavarakauppa,2020-03-23 16:00:00.000000000,2020-03-23,2020-03-23,2020-03-23,3.0,-26.35,29718.72,0.0,162.0,           ,1.0,1.0,96.0
2194,Ruoka_paivittaistavarakauppa,2020-03-27 04:16:00.000000000,2020-03-27,2020-03-27,2020-03-27,3.0,-12.97,29705.75,0.0,162.0,           ,1.0,1.0,156.0
2195,Ruoka_paivittaistavarakauppa,2020-03-27 19:12:00.000000000,2020-03-27,2020-03-27,2020-03-27,3.0,-7.82,29697.93,0.0,162.0,           ,1.0,1.0,51.0
2196,Ruoka_paivittaistavarakauppa,2020-03-30 13:20:00.000000000,2020-03-30,2020-03-30,2020-03-30,3.0,-39.93,29658.0,0.0,162.0,           ,1.0,1.0,165.0
2197,Ravintolat_kahvilat,2020-03-30 22:24:00.000000000,2020-03-30,2020-03-30,2020-03-30,3.0,-39.59,29618.41,0.0,162.0,           ,1.0,1.0,127.0
2198,Vakuutukset,2020-03-31 07:28:00.000000000,2020-03-31,2020-03-31,2020-03-31,3.0,-22.15,29596.26,706.0,106.0,OKOYFIHH   ,0.0,0.0,205.0
2199,Tulot,2020-04-02 09:29:18.139534883,2020-04-02,2020-04-02,2020-04-02,3.0,205.91,29802.17,701.0,520.0,           ,1.0,1.0,198.0
2200,Lemmikit,2020-04-03 18:58:36.279069766,2020-04-03,2020-04-03,2020-04-03,3.0,-46.65,29755.52,0.0,162.0,           ,1.0,1.0,81.0
2201,Ruoka_paivittaistavarakauppa,2020-04-06 04:27:54.418604649,2020-04-06,2020-04-06,2020-04-06,3.0,-7.63,29747.89,0.0,162.0,           ,1.0,1.0,53.0
2202,Luokittelemattomat,2020-04-06 13:57:12.558139532,2020-04-06,2020-04-06,2020-04-06,3.0,-9.45,29738.44,0.0,162.0,           ,1.0,1.0,124.0
2203,Tulot,2020-04-07 18:25:06.976744181,2020-04-07,2020-04-07,2020-04-07,3.0,144.45,29882.89,701.0,520.0,           ,1.0,1.0,196.0
2204,Liikkuminen,2020-04-07 23:26:30.697674415,2020-04-07,2020-04-07,2020-04-07,3.0,-55.79,29827.1,0.0,162.0,           ,1.0,1.0,149.0
2205,Ruoka_paivittaistavarakauppa,2020-04-09 08:55:48.837209298,2020-04-09,2020-04-09,2020-04-09,3.0,-10.82,29816.28,0.0,162.0,           ,1.0,1.0,150.0
2206,Terveys,2020-04-13 13:23:43.255813947,2020-04-13,2020-04-13,2020-04-13,3.0,-27.63,29788.65,0.0,162.0,           ,1.0,1.0,135.0
2207,Ravintolat_kahvilat,2020-04-14 03:54:25.116279064,2020-04-14,2020-04-14,2020-04-14,3.0,-4.38,29784.27,0.0,162.0,           ,1.0,1.0,102.0
2208,Ruoka_paivittaistavarakauppa,2020-04-15 08:22:19.534883713,2020-04-15,2020-04-15,2020-04-15,3.0,-17.52,29766.75,0.0,162.0,           ,1.0,1.0,104.0
2209,Ruoka_paivittaistavarakauppa,2020-04-16 22:53:01.395348830,2020-04-16,2020-04-16,2020-04-16,3.0,-29.55,29737.2,0.0,162.0,           ,1.0,1.0,103.0
2210,Tulot,2020-04-17 17:51:37.674418596,2020-04-17,2020-04-17,2020-04-17,3.0,2955.32,32692.52,701.0,521.0,           ,1.0,1.0,201.0
2211,Hyvinvointi,2020-04-20 03:20:55.813953479,2020-04-20,2020-04-20,2020-04-20,3.0,-150.74,32541.78,0.0,162.0,           ,1.0,1.0,77.0
2212,Ruoka_paivittaistavarakauppa,2020-04-20 12:50:13.953488362,2020-04-20,2020-04-20,2020-04-20,3.0,-23.09,32518.69,0.0,162.0,           ,1.0,1.0,44.0
2213,Ruoka_paivittaistavarakauppa,2020-04-21 22:19:32.093023245,2020-04-21,2020-04-21,2020-04-21,3.0,-5.84,32512.85,0.0,162.0,           ,1.0,1.0,82.0
2214,Ruoka_paivittaistavarakauppa,2020-04-22 17:18:08.372093011,2020-04-22,2020-04-22,2020-04-22,3.0,-51.07,32461.78,0.0,162.0,           ,1.0,1.0,53.0
2215,Luokittelemattomat,2020-04-23 07:48:50.232558128,2020-04-23,2020-04-23,2020-04-23,3.0,-17.85,32443.93,0.0,162.0,           ,1.0,1.0,126.0
2216,Ruoka_paivittaistavarakauppa,2020-04-24 02:47:26.511627894,2020-04-24,2020-04-24,2020-04-24,3.0,-15.44,32428.49,0.0,162.0,           ,1.0,1.0,81.0
2217,Kulttuuri_viihde,2020-04-27 12:16:44.651162777,2020-04-27,2020-04-27,2020-04-27,3.0,-32.23,32396.26,0.0,162.0,           ,1.0,1.0,143.0
2218,Ruoka_paivittaistavarakauppa,2020-04-27 21:46:02.790697660,2020-04-27,2020-04-27,2020-04-27,3.0,-16.03,32380.23,0.0,162.0,           ,1.0,1.0,145.0
2219,Matkailu,2020-04-29 07:15:20.930232543,2020-04-29,2020-04-29,2020-04-29,3.0,-50.77,32329.46,0.0,162.0,           ,1.0,1.0,44.0
2220,Tulot,2020-05-01 06:22:02.448979591,2020-05-01,2020-05-01,2020-05-01,3.0,238.78,32568.24,701.0,520.0,           ,1.0,1.0,200.0
2221,Ravintolat_kahvilat,2020-05-04 12:44:04.897959182,2020-05-04,2020-05-06,2020-05-04,3.0,-45.68,32522.56,0.0,162.0,           ,1.0,1.0,45.0
2222,Hyvinvointi,2020-05-04 19:06:07.346938773,2020-05-04,2020-05-04,2020-05-04,3.0,-6.25,32516.31,0.0,162.0,           ,1.0,1.0,152.0
2223,Ruoka_paivittaistavarakauppa,2020-05-06 01:28:09.795918364,2020-05-06,2020-05-06,2020-05-06,3.0,-53.53,32462.78,0.0,162.0,           ,1.0,1.0,130.0
2224,Liikkuminen,2020-05-07 07:50:12.244897955,2020-05-07,2020-05-07,2020-05-07,3.0,-158.7,32304.08,0.0,162.0,           ,1.0,1.0,170.0
2225,Shoppailu,2020-05-08 14:12:14.693877546,2020-05-08,2020-05-08,2020-05-08,3.0,-4528.64,27775.44,706.0,129.0,OKOYFIHH   ,0.0,0.0,211.0
2226,Luottojen_maksut,2020-05-08 20:34:17.142857137,2020-05-08,2020-05-08,2020-05-08,3.0,-25.48,27749.96,0.0,162.0,           ,1.0,1.0,113.0
2227,Matkailu,2020-05-11 02:56:19.591836728,2020-05-11,2020-05-11,2020-05-11,3.0,-16.99,27732.97,0.0,162.0,           ,1.0,1.0,146.0
2228,Tulot,2020-05-11 09:18:22.040816319,2020-05-11,2020-05-11,2020-05-11,3.0,-433.2,27299.77,706.0,106.0,OKOYFIHH   ,0.0,0.0,210.0
2229,Liikkuminen,2020-05-13 22:02:26.938775501,2020-05-13,2020-05-13,2020-05-13,3.0,-4.82,27294.95,0.0,162.0,           ,1.0,1.0,47.0
2230,Kulttuuri_viihde,2020-05-14 15:40:24.489795910,2020-05-14,2020-05-14,2020-05-14,3.0,-30.47,27264.48,0.0,162.0,           ,1.0,1.0,128.0
2231,Muut,2020-05-15 04:24:29.387755092,2020-05-15,2020-05-15,2020-05-15,3.0,-151.38,27113.1,0.0,163.0,           ,1.0,1.0,173.0
2232,Kulttuuri_viihde,2020-05-18 10:46:31.836734683,2020-05-18,2020-05-18,2020-05-18,3.0,-27.61,27085.49,706.0,106.0,OKOYFIHH   ,0.0,0.0,209.0
2233,Liikkuminen,2020-05-18 17:08:34.285714274,2020-05-18,2020-05-18,2020-05-18,3.0,-18.47,27067.02,0.0,162.0,           ,1.0,1.0,148.0
2234,Ruoka_paivittaistavarakauppa,2020-05-19 23:30:36.734693865,2020-05-19,2020-05-19,2020-05-19,3.0,-8.66,27058.36,0.0,162.0,           ,1.0,1.0,48.0
2235,Ruoka_paivittaistavarakauppa,2020-05-21 05:52:39.183673456,2020-05-21,2020-05-21,2020-05-21,3.0,-50.48,27007.88,0.0,162.0,           ,1.0,1.0,146.0
2236,Ruoka_paivittaistavarakauppa,2020-05-21 12:14:41.632653047,2020-05-21,2020-05-21,2020-05-21,3.0,-12.6,26995.28,0.0,162.0,           ,1.0,1.0,43.0
2237,Saastot_sijoitukset,2020-05-21 18:36:44.081632638,2020-05-21,2020-05-21,2020-05-21,3.0,-11.7,26983.58,0.0,162.0,           ,1.0,1.0,110.0
2238,Hyvinvointijakauneus,2020-05-25 00:58:46.530612229,2020-05-25,2020-05-25,2020-05-25,3.0,-46.65,26936.93,706.0,106.0,OKOYFIHH   ,0.0,0.0,204.0
2239,Saastot_sijoitukset,2020-05-26 07:20:48.979591820,2020-05-26,2020-05-26,2020-05-26,3.0,-46.94,26889.99,0.0,162.0,           ,1.0,1.0,68.0
2240,Luokittelemattomat,2020-05-27 13:42:51.428571411,2020-05-27,2020-05-27,2020-05-27,3.0,-26.33,26863.66,0.0,162.0,           ,1.0,1.0,146.0
2241,Ruoka_paivittaistavarakauppa,2020-05-28 20:04:53.877551002,2020-05-28,2020-05-28,2020-05-28,3.0,-8.82,26854.84,0.0,162.0,           ,1.0,1.0,85.0
2242,Asuminen,2020-05-29 02:26:56.326530593,2020-05-29,2020-05-29,2020-05-29,3.0,-134.61,26720.23,0.0,162.0,           ,1.0,1.0,133.0
2243,Muut,2020-05-29 08:48:58.775510184,2020-05-29,2020-05-29,2020-05-29,3.0,-113.31,26606.92,0.0,163.0,           ,1.0,1.0,173.0
2244,Tulot,2020-06-01 07:32:21.361256544,2020-06-01,2020-06-01,2020-06-01,3.0,6.53,26613.45,701.0,520.0,           ,1.0,1.0,197.0
2245,Ruoka_paivittaistavarakauppa,2020-06-01 15:04:42.722513088,2020-06-01,2020-06-01,2020-06-01,3.0,-15.64,26597.81,0.0,162.0,           ,1.0,1.0,166.0
2246,Muut,2020-06-01 22:37:04.083769632,2020-06-01,2020-06-01,2020-06-01,3.0,-156.39,26441.42,0.0,163.0,           ,1.0,1.0,175.0
2247,Luokittelemattomat,2020-06-02 06:09:25.445026176,2020-06-02,2020-06-02,2020-06-02,3.0,-308.85,26132.57,706.0,106.0,OKOYFIHH   ,0.0,0.0,205.0
2248,Asuminen,2020-06-02 13:41:46.806282720,2020-06-02,2020-06-02,2020-06-02,3.0,-23.75,26108.82,0.0,106.0,OKOYFIHH   ,0.0,0.0,26.0
2249,Lapset,2020-06-02 21:14:08.167539264,2020-06-02,2020-06-02,2020-06-01,3.0,-45.03,26063.79,0.0,162.0,           ,1.0,1.0,86.0
2250,Lemmikit,2020-06-03 04:46:29.528795808,2020-06-03,2020-06-03,2020-06-03,3.0,-8.64,26055.15,0.0,162.0,           ,1.0,1.0,105.0
2251,Ruoka_paivittaistavarakauppa,2020-06-03 12:18:50.890052352,2020-06-03,2020-06-03,2020-06-02,3.0,-25.12,26030.03,0.0,162.0,           ,1.0,1.0,85.0
2252,Ruoka_paivittaistavarakauppa,2020-06-03 19:51:12.251308896,2020-06-03,2020-06-03,2020-06-03,3.0,-20.05,26009.98,0.0,162.0,           ,1.0,1.0,113.0
2253,Lemmikit,2020-06-04 03:23:33.612565440,2020-06-04,2020-06-04,2020-06-04,3.0,-6.95,26003.03,0.0,162.0,           ,1.0,1.0,49.0
2254,Muut,2020-06-04 10:55:54.973821984,2020-06-04,2020-06-04,2020-06-04,3.0,-209.59,25793.44,0.0,163.0,           ,1.0,1.0,175.0
2255,Muut,2020-06-04 18:28:16.335078528,2020-06-04,2020-06-05,2020-06-04,3.0,-3.68,25789.76,0.0,162.0,           ,1.0,1.0,101.0
2256,Ravintolat_kahvilat,2020-06-05 00:37:41.780104704,2020-06-05,2020-06-05,2020-06-05,3.0,-1.41,25788.35,0.0,162.0,           ,1.0,1.0,139.0
2257,Ruoka_paivittaistavarakauppa,2020-06-05 02:00:37.696335072,2020-06-05,2020-06-05,2020-06-05,3.0,-2.77,25785.58,0.0,162.0,           ,1.0,1.0,92.0
2258,Ravintolat_kahvilat,2020-06-05 09:32:59.057591616,2020-06-05,2020-06-05,2020-06-05,3.0,-4.41,25781.17,0.0,162.0,           ,1.0,1.0,98.0
2259,Hyvinvointijakauneus,2020-06-05 17:05:20.418848160,2020-06-05,2020-06-05,2020-06-05,3.0,-84.81,25696.36,706.0,106.0,OKOYFIHH   ,0.0,0.0,208.0
2260,Ruoka_paivittaistavarakauppa,2020-06-05 23:14:45.863874336,2020-06-05,2020-06-05,2020-06-05,3.0,-30.96,25665.4,0.0,162.0,           ,1.0,1.0,74.0
2261,Ruoka_paivittaistavarakauppa,2020-06-08 05:24:11.308900512,2020-06-08,2020-06-08,2020-06-08,3.0,-9.02,25656.38,0.0,162.0,           ,1.0,1.0,68.0
2262,Muut,2020-06-08 06:47:07.225130880,2020-06-08,2020-06-08,2020-06-08,3.0,-9.15,25647.23,0.0,162.0,           ,1.0,1.0,114.0
2263,Liikkuminen,2020-06-08 08:10:03.141361248,2020-06-08,2020-06-08,2020-06-08,3.0,-48.92,25598.31,0.0,162.0,           ,1.0,1.0,135.0
2264,Ruoka_paivittaistavarakauppa,2020-06-08 12:56:32.670157056,2020-06-08,2020-06-08,2020-06-08,3.0,-2.78,25595.53,0.0,162.0,           ,1.0,1.0,103.0
2265,Ruoka_paivittaistavarakauppa,2020-06-08 14:19:28.586387424,2020-06-08,2020-06-08,2020-06-08,3.0,-6.48,25589.05,0.0,162.0,           ,1.0,1.0,104.0
2266,Ruoka_paivittaistavarakauppa,2020-06-08 15:42:24.502617792,2020-06-08,2020-06-08,2020-06-08,3.0,-10.25,25578.8,0.0,162.0,           ,1.0,1.0,59.0
2267,Muut,2020-06-08 20:28:54.031413600,2020-06-08,2020-06-08,2020-06-08,3.0,-382.68,25196.12,0.0,163.0,           ,1.0,1.0,173.0
2268,Lapset,2020-06-08 21:51:49.947643968,2020-06-08,2020-06-08,2020-06-08,3.0,-11.91,25184.21,0.0,162.0,           ,1.0,1.0,116.0
2269,Liikkuminen,2020-06-09 02:38:19.476439776,2020-06-09,2020-06-09,2020-06-09,3.0,-38.13,25146.08,0.0,162.0,           ,1.0,1.0,88.0
2270,Liikkuminen,2020-06-09 04:01:15.392670144,2020-06-09,2020-06-10,2020-06-09,3.0,-60.29,25085.79,0.0,162.0,           ,1.0,1.0,139.0
2271,Liikkuminen,2020-06-09 10:10:40.837696320,2020-06-09,2020-06-10,2020-06-09,3.0,-28.08,25057.71,0.0,162.0,           ,1.0,1.0,55.0
2272,Asuminen,2020-06-09 11:33:36.753926688,2020-06-09,2020-06-09,2020-06-09,3.0,-23.55,25034.16,0.0,162.0,           ,1.0,1.0,85.0
2273,Shoppailu,2020-06-09 19:05:58.115183232,2020-06-09,2020-06-09,2020-06-09,3.0,-21.28,25012.88,0.0,162.0,           ,1.0,1.0,117.0
2274,Ruoka_paivittaistavarakauppa,2020-06-10 17:43:02.198952864,2020-06-10,2020-06-10,2020-06-10,3.0,-95.62,24917.26,0.0,162.0,           ,1.0,1.0,112.0
2275,Ravintolat_kahvilat,2020-06-11 01:15:23.560209408,2020-06-11,2020-06-11,2020-06-11,3.0,-69.4,24847.86,0.0,106.0,SBANFIHH   ,0.0,0.0,19.0
2276,Liikkuminen,2020-06-11 08:47:44.921465952,2020-06-11,2020-06-11,2020-06-11,3.0,-40.21,24807.65,0.0,162.0,           ,1.0,1.0,87.0
2277,Ruoka_paivittaistavarakauppa,2020-06-11 13:34:14.450261760,2020-06-11,2020-06-11,2020-06-11,3.0,-6.42,24801.23,0.0,162.0,           ,1.0,1.0,90.0
2278,Ruoka_paivittaistavarakauppa,2020-06-11 16:20:06.282722496,2020-06-11,2020-06-11,2020-06-11,3.0,-14.12,24787.11,0.0,162.0,           ,1.0,1.0,85.0
2279,Liikkuminen,2020-06-11 23:52:27.643979040,2020-06-11,2020-06-11,2020-06-11,3.0,-135.24,24651.87,0.0,162.0,           ,1.0,1.0,111.0
2280,Matkailu,2020-06-12 07:24:49.005235584,2020-06-12,2020-06-12,2020-06-12,3.0,-29.59,24622.28,0.0,162.0,           ,1.0,1.0,141.0
2281,Shoppailu,2020-06-12 14:57:10.366492128,2020-06-12,2020-06-12,2020-06-12,3.0,-21.65,24600.63,0.0,162.0,           ,1.0,1.0,64.0
2282,Liikkuminen,2020-06-12 22:29:31.727748672,2020-06-12,2020-06-12,2020-06-12,3.0,-75.95,24524.68,0.0,162.0,           ,1.0,1.0,165.0
2283,Muut,2020-06-13 03:16:01.256544480,2020-06-13,2020-06-13,2020-06-13,3.0,-124.27,24400.41,0.0,163.0,           ,1.0,1.0,175.0
2284,Muut,2020-06-15 01:53:05.340314112,2020-06-15,2020-06-15,2020-06-15,3.0,-214.91,24185.5,0.0,163.0,           ,1.0,1.0,175.0
2285,Harrastukset,2020-06-15 06:01:53.089005216,2020-06-15,2020-06-15,2020-06-15,3.0,-31.24,24154.26,0.0,162.0,           ,1.0,1.0,86.0
2286,Luokittelemattomat,2020-06-15 10:48:22.617801024,2020-06-15,2020-06-15,2020-06-15,3.0,-9.99,24144.27,0.0,162.0,           ,1.0,1.0,124.0
2287,Liikkuminen,2020-06-15 12:11:18.534031392,2020-06-15,2020-06-15,2020-06-15,3.0,-16.22,24128.05,0.0,162.0,           ,1.0,1.0,47.0
2288,Ruoka_paivittaistavarakauppa,2020-06-15 18:20:43.979057568,2020-06-15,2020-06-17,2020-06-15,3.0,-23.31,24104.74,0.0,162.0,           ,1.0,1.0,118.0
2289,Ruoka_paivittaistavarakauppa,2020-06-15 19:43:39.895287936,2020-06-15,2020-06-15,2020-06-15,3.0,-0.73,24104.01,0.0,162.0,           ,1.0,1.0,124.0
2290,Ravintolat_kahvilat,2020-06-15 21:06:35.811518304,2020-06-15,2020-06-15,2020-06-15,3.0,-1.31,24102.7,0.0,162.0,           ,1.0,1.0,94.0
2291,Terveys,2020-06-16 04:38:57.172774848,2020-06-16,2020-06-16,2020-06-16,3.0,-107.45,23995.25,0.0,162.0,           ,1.0,1.0,87.0
2292,Liikkuminen,2020-06-16 08:02:30.785340288,2020-06-16,2020-06-16,2020-06-16,3.0,-45.31,23949.94,0.0,162.0,           ,1.0,1.0,113.0
2293,Ruoka_paivittaistavarakauppa,2020-06-16 09:25:26.701570656,2020-06-16,2020-06-16,2020-06-16,3.0,-47.97,23901.97,0.0,162.0,           ,1.0,1.0,98.0
2294,Ruoka_paivittaistavarakauppa,2020-06-16 16:57:48.062827200,2020-06-16,2020-06-16,2020-06-16,3.0,-40.34,23861.63,0.0,162.0,           ,1.0,1.0,113.0
2295,Muut,2020-06-16 23:07:13.507853376,2020-06-16,2020-06-16,2020-06-16,3.0,-85.61,23776.02,0.0,163.0,           ,1.0,1.0,173.0
2296,Ruoka_paivittaistavarakauppa,2020-06-17 00:30:09.424083744,2020-06-17,2020-06-17,2020-06-17,3.0,-5.45,23770.57,0.0,162.0,           ,1.0,1.0,53.0
2297,Ravintolat_kahvilat,2020-06-17 15:34:52.146596832,2020-06-17,2020-06-17,2020-06-17,3.0,-10.07,23760.5,0.0,162.0,           ,1.0,1.0,148.0
2298,Asuminen,2020-06-18 06:39:34.869109920,2020-06-18,2020-06-18,2020-06-18,3.0,-88.46,23672.04,0.0,162.0,           ,1.0,1.0,120.0
2299,Ravintolat_kahvilat,2020-06-18 14:11:56.230366464,2020-06-18,2020-06-18,2020-06-18,3.0,-1.81,23670.23,0.0,162.0,           ,1.0,1.0,131.0
2300,Harrastukset,2020-06-18 21:44:17.591623008,2020-06-18,2020-06-18,2020-06-18,3.0,-103.9,23566.33,0.0,162.0,           ,1.0,1.0,158.0
2301,Ruoka_paivittaistavarakauppa,2020-06-19 02:30:47.120418816,2020-06-19,2020-06-19,2020-06-19,3.0,-24.73,23541.6,0.0,162.0,           ,1.0,1.0,71.0
2302,Muut,2020-06-19 03:53:43.036649184,2020-06-19,2020-06-19,2020-06-19,3.0,-40.85,23500.75,0.0,162.0,           ,1.0,1.0,106.0
2303,Asuminen,2020-06-19 05:16:38.952879552,2020-06-19,2020-06-19,2020-06-19,3.0,-24.06,23476.69,0.0,162.0,           ,1.0,1.0,161.0
2304,Luokittelemattomat,2020-06-19 12:49:00.314136096,2020-06-19,2020-06-19,2020-06-19,3.0,-12.08,23464.61,0.0,162.0,           ,1.0,1.0,104.0
2305,Ruoka_paivittaistavarakauppa,2020-06-19 18:58:25.759162272,2020-06-19,2020-06-19,2020-06-19,3.0,-8.48,23456.13,0.0,162.0,           ,1.0,1.0,96.0
2306,Ruoka_paivittaistavarakauppa,2020-06-19 20:21:21.675392640,2020-06-19,2020-06-19,2020-06-19,3.0,-11.08,23445.05,0.0,162.0,           ,1.0,1.0,93.0
2307,Muut,2020-06-20 11:26:04.397905728,2020-06-20,2020-06-20,2020-06-20,3.0,-104.55,23340.5,0.0,163.0,           ,1.0,1.0,174.0
2308,Liikkuminen,2020-06-21 10:03:08.481675360,2020-06-21,2020-06-21,2020-06-21,3.0,-757.79,22582.71,0.0,106.0,DABAFIHH   ,0.0,0.0,36.0
2309,Ruoka_paivittaistavarakauppa,2020-06-22 01:07:51.204188448,2020-06-22,2020-06-22,2020-06-22,3.0,-9.11,22573.6,0.0,162.0,           ,1.0,1.0,53.0
2310,Ruoka_paivittaistavarakauppa,2020-06-22 08:40:12.565444992,2020-06-22,2020-06-22,2020-06-22,3.0,-4.23,22569.37,0.0,162.0,           ,1.0,1.0,106.0
2311,Liikkuminen,2020-06-22 16:12:33.926701536,2020-06-22,2020-06-22,2020-06-22,3.0,-4.69,22564.68,0.0,162.0,           ,1.0,1.0,146.0
2312,Ruoka_paivittaistavarakauppa,2020-06-22 17:35:29.842931904,2020-06-22,2020-06-22,2020-06-22,3.0,-28.62,22536.06,0.0,162.0,           ,1.0,1.0,154.0
2313,Liikkuminen,2020-06-22 23:44:55.287958080,2020-06-22,2020-06-22,2020-06-22,3.0,-7.83,22528.23,0.0,162.0,           ,1.0,1.0,147.0
2314,Liikkuminen,2020-06-23 05:54:20.732984256,2020-06-23,2020-06-23,2020-06-23,3.0,-11.17,22517.06,0.0,162.0,           ,1.0,1.0,156.0
2315,Tulot,2020-06-23 07:17:16.649214624,2020-06-23,2020-06-23,2020-06-23,3.0,-27.23,22489.83,0.0,162.0,           ,1.0,1.0,44.0
2316,Asuminen,2020-06-23 14:49:38.010471168,2020-06-23,2020-06-23,2020-06-23,3.0,-45.18,22444.65,0.0,162.0,           ,1.0,1.0,68.0
2317,Luottojen_maksut,2020-06-23 22:21:59.371727712,2020-06-23,2020-06-23,2020-06-23,3.0,-59.25,22385.4,0.0,162.0,           ,1.0,1.0,81.0
2318,Liikkuminen,2020-06-24 13:26:42.094240800,2020-06-24,2020-06-24,2020-06-24,3.0,-48.28,22337.12,0.0,162.0,           ,1.0,1.0,113.0
2319,Ravintolat_kahvilat,2020-06-24 19:36:07.539266976,2020-06-24,2020-06-24,2020-06-24,3.0,-2.33,22334.79,0.0,162.0,           ,1.0,1.0,112.0
2320,Liikkuminen,2020-06-24 20:59:03.455497344,2020-06-24,2020-06-24,2020-06-24,3.0,-139.88,22194.91,0.0,162.0,           ,1.0,1.0,108.0
2321,Hyvinvointi,2020-06-25 12:03:46.178010432,2020-06-25,2020-06-25,2020-06-25,3.0,-21.72,22173.19,0.0,162.0,           ,1.0,1.0,45.0
2322,Lemmikit,2020-06-25 18:13:11.623036608,2020-06-25,2020-06-25,2020-06-25,3.0,-14.96,22158.23,0.0,162.0,           ,1.0,1.0,92.0
2323,Saastot_sijoitukset,2020-06-26 00:22:37.068062784,2020-06-26,2020-06-26,2020-06-26,3.0,-2.54,22155.69,0.0,162.0,           ,1.0,1.0,44.0
2324,Ruoka_paivittaistavarakauppa,2020-06-26 01:45:32.984293152,2020-06-26,2020-06-26,2020-06-26,3.0,-9.01,22146.68,0.0,162.0,           ,1.0,1.0,106.0
2325,Ruoka_paivittaistavarakauppa,2020-06-26 03:08:28.900523520,2020-06-26,2020-06-26,2020-06-26,3.0,-35.62,22111.06,0.0,162.0,           ,1.0,1.0,111.0
2326,Liikkuminen,2020-06-26 04:31:24.816753888,2020-06-26,2020-06-26,2020-06-26,3.0,-203.51,21907.55,0.0,162.0,           ,1.0,1.0,117.0
2327,Asuminen,2020-06-26 09:17:54.345549696,2020-06-26,2020-06-26,2020-06-26,3.0,-185.11,21722.44,0.0,162.0,           ,1.0,1.0,124.0
2328,Ravintolat_kahvilat,2020-06-26 10:40:50.261780064,2020-06-26,2020-06-26,2020-06-26,3.0,-30.76,21691.68,0.0,162.0,           ,1.0,1.0,102.0
2329,Luottojen_maksut,2020-06-28 22:59:41.151832416,2020-06-28,2020-06-28,2020-06-28,3.0,-42.04,21649.64,0.0,106.0,OKOYFIHH   ,0.0,0.0,37.0
2330,Ruoka_paivittaistavarakauppa,2020-06-29 05:09:06.596858592,2020-06-29,2020-06-29,2020-06-29,3.0,-4.58,21645.06,0.0,162.0,           ,1.0,1.0,172.0
2331,Luokittelemattomat,2020-06-29 06:32:02.513088960,2020-06-29,2020-06-29,2020-06-29,3.0,-116.98,21528.08,0.0,162.0,           ,1.0,1.0,87.0
2332,Liikkuminen,2020-06-29 07:54:58.429319328,2020-06-29,2020-06-29,2020-06-29,3.0,-10.73,21517.35,0.0,162.0,           ,1.0,1.0,124.0
2333,Lapset,2020-06-29 12:41:27.958115136,2020-06-29,2020-06-29,2020-06-29,3.0,-174.76,21342.59,0.0,162.0,           ,1.0,1.0,124.0
2334,Liikkuminen,2020-06-29 14:04:23.874345504,2020-06-29,2020-06-29,2020-06-29,3.0,-6.91,21335.68,0.0,162.0,           ,1.0,1.0,140.0
2335,Ravintolat_kahvilat,2020-06-29 15:27:19.790575872,2020-06-29,2020-06-29,2020-06-29,3.0,-1.86,21333.82,0.0,162.0,           ,1.0,1.0,102.0
2336,Muut,2020-06-29 16:50:15.706806240,2020-06-29,2020-06-29,2020-06-29,3.0,-20.5,21313.32,0.0,162.0,           ,1.0,1.0,144.0
2337,Ruoka_paivittaistavarakauppa,2020-06-29 21:36:45.235602048,2020-06-29,2020-06-29,2020-06-29,3.0,-35.53,21277.79,0.0,162.0,           ,1.0,1.0,71.0
2338,Ruoka_paivittaistavarakauppa,2020-06-30 20:13:49.319371680,2020-06-30,2020-06-30,2020-06-30,3.0,-8.9,21268.89,0.0,162.0,           ,1.0,1.0,64.0
2339,Muut,2020-07-01 15:54:51.978609624,2020-07-01,2020-07-01,2020-07-01,3.0,-29.91,21238.98,0.0,106.0,DABAFIHH   ,0.0,0.0,14.0
2340,Asuminen,2020-07-01 23:52:17.967914436,2020-07-01,2020-07-01,2020-07-01,3.0,-7.96,21231.02,0.0,162.0,           ,1.0,1.0,82.0
2341,Liikkuminen,2020-07-02 07:49:43.957219248,2020-07-02,2020-07-03,2020-07-02,3.0,-87.63,21143.39,0.0,162.0,           ,1.0,1.0,59.0
2342,Liikkuminen,2020-07-02 07:57:25.989304812,2020-07-02,2020-07-02,2020-07-02,3.0,-6.65,21136.74,0.0,162.0,           ,1.0,1.0,158.0
2343,Luokittelemattomat,2020-07-02 15:47:09.946524060,2020-07-02,2020-07-02,2020-07-02,3.0,-2.44,21134.3,0.0,162.0,           ,1.0,1.0,43.0
2344,Shoppailu,2020-07-02 23:44:35.935828872,2020-07-02,2020-07-02,2020-07-02,3.0,-60.7,21073.6,0.0,162.0,           ,1.0,1.0,76.0
2345,Ruoka_paivittaistavarakauppa,2020-07-03 07:26:37.860962556,2020-07-03,2020-07-03,2020-07-03,3.0,-2.48,21071.12,0.0,162.0,           ,1.0,1.0,116.0
2346,Ravintolat_kahvilat,2020-07-03 07:42:01.925133684,2020-07-03,2020-07-03,2020-07-03,3.0,-6.29,21064.83,0.0,162.0,           ,1.0,1.0,148.0
2347,Luokittelemattomat,2020-07-03 15:31:45.882352932,2020-07-03,2020-07-03,2020-07-03,3.0,-8.16,21056.67,0.0,162.0,           ,1.0,1.0,43.0
2348,Ravintolat_kahvilat,2020-07-03 15:39:27.914438496,2020-07-03,2020-07-03,2020-07-03,3.0,-149.91,20906.76,0.0,162.0,           ,1.0,1.0,81.0
2349,Ruoka_paivittaistavarakauppa,2020-07-03 23:36:53.903743308,2020-07-03,2020-07-03,2020-07-03,3.0,-2.07,20904.69,0.0,162.0,           ,1.0,1.0,45.0
2350,Matkailu,2020-07-06 07:18:55.828876992,2020-07-06,2020-07-06,2020-07-06,3.0,-42.91,20861.78,0.0,162.0,           ,1.0,1.0,106.0
2351,Ruoka_paivittaistavarakauppa,2020-07-06 07:34:19.893048120,2020-07-06,2020-07-06,2020-07-06,3.0,-42.25,20819.53,0.0,162.0,           ,1.0,1.0,165.0
2352,Ruoka_paivittaistavarakauppa,2020-07-06 15:16:21.818181804,2020-07-06,2020-07-06,2020-07-06,3.0,-30.84,20788.69,0.0,162.0,           ,1.0,1.0,144.0
2353,Liikkuminen,2020-07-06 15:24:03.850267368,2020-07-06,2020-07-06,2020-07-06,3.0,-18.31,20770.38,0.0,162.0,           ,1.0,1.0,81.0
2354,Liikkuminen,2020-07-06 23:13:47.807486616,2020-07-06,2020-07-08,2020-07-06,3.0,-14.29,20756.09,0.0,162.0,           ,1.0,1.0,143.0
2355,Ruoka_paivittaistavarakauppa,2020-07-06 23:21:29.839572180,2020-07-06,2020-07-06,2020-07-06,3.0,-63.12,20692.97,0.0,162.0,           ,1.0,1.0,44.0
2356,Ruoka_paivittaistavarakauppa,2020-07-06 23:29:11.871657744,2020-07-06,2020-07-06,2020-07-06,3.0,-12.4,20680.57,0.0,162.0,           ,1.0,1.0,64.0
2357,Liikkuminen,2020-07-07 07:11:13.796791428,2020-07-07,2020-07-07,2020-07-07,3.0,-182.47,20498.1,0.0,162.0,           ,1.0,1.0,142.0
2358,Ruoka_paivittaistavarakauppa,2020-07-07 15:00:57.754010676,2020-07-07,2020-07-07,2020-07-07,3.0,-5.15,20492.95,0.0,162.0,           ,1.0,1.0,168.0
2359,Liikkuminen,2020-07-07 15:08:39.786096240,2020-07-07,2020-07-07,2020-07-07,3.0,-47.57,20445.38,0.0,162.0,           ,1.0,1.0,156.0
2360,Ravintolat_kahvilat,2020-07-07 23:06:05.775401052,2020-07-07,2020-07-07,2020-07-07,3.0,-1.82,20443.56,0.0,162.0,           ,1.0,1.0,82.0
2361,Ruoka_paivittaistavarakauppa,2020-07-09 06:48:07.700534736,2020-07-09,2020-07-09,2020-07-09,3.0,-67.56,20376.0,0.0,162.0,           ,1.0,1.0,133.0
2362,Saastot_sijoitukset,2020-07-09 06:55:49.732620300,2020-07-09,2020-07-09,2020-07-09,3.0,-134.3,20241.7,0.0,162.0,           ,1.0,1.0,112.0
2363,Hyvinvointijakauneus,2020-07-09 07:03:31.764705864,2020-07-09,2020-07-09,2020-07-09,3.0,-40.55,20201.15,0.0,162.0,           ,1.0,1.0,119.0
2364,Ruoka_paivittaistavarakauppa,2020-07-09 14:53:15.721925112,2020-07-09,2020-07-09,2020-07-09,3.0,-9.02,20192.13,0.0,162.0,           ,1.0,1.0,125.0
2365,Ruoka_paivittaistavarakauppa,2020-07-09 22:42:59.679144360,2020-07-09,2020-07-09,2020-07-09,3.0,-13.01,20179.12,0.0,162.0,           ,1.0,1.0,113.0
2366,Ruoka_paivittaistavarakauppa,2020-07-09 22:50:41.711229924,2020-07-09,2020-07-09,2020-07-09,3.0,-17.64,20161.48,0.0,162.0,           ,1.0,1.0,76.0
2367,Liikkuminen,2020-07-09 22:58:23.743315488,2020-07-09,2020-07-09,2020-07-09,3.0,-2.54,20158.94,0.0,162.0,           ,1.0,1.0,134.0
2368,Luokittelemattomat,2020-07-10 06:40:25.668449172,2020-07-10,2020-07-10,2020-07-10,3.0,-27.05,20131.89,0.0,162.0,           ,1.0,1.0,107.0
2369,Shoppailu,2020-07-10 14:37:51.657753984,2020-07-10,2020-07-10,2020-07-10,3.0,-22.59,20109.3,0.0,162.0,           ,1.0,1.0,113.0
2370,Tulot,2020-07-10 14:45:33.689839548,2020-07-10,2020-07-10,2020-07-10,3.0,2176.89,22286.19,0.0,559.0,           ,1.0,1.0,193.0
2371,Liikkuminen,2020-07-10 22:35:17.647058796,2020-07-10,2020-07-10,2020-07-10,3.0,-32.41,22253.78,0.0,162.0,           ,1.0,1.0,87.0
2372,Matkailu,2020-07-13 06:17:19.572192480,2020-07-13,2020-07-13,2020-07-13,3.0,-19.04,22234.74,0.0,162.0,           ,1.0,1.0,43.0
2373,Liikkuminen,2020-07-13 06:25:01.604278044,2020-07-13,2020-07-13,2020-07-13,3.0,-57.43,22177.31,0.0,162.0,           ,1.0,1.0,65.0
2374,Ruoka_paivittaistavarakauppa,2020-07-13 06:32:43.636363608,2020-07-13,2020-07-13,2020-07-13,3.0,-18.06,22159.25,0.0,162.0,           ,1.0,1.0,156.0
2375,Muut,2020-07-13 14:14:45.561497292,2020-07-13,2020-07-13,2020-07-13,3.0,-425.61,21733.64,0.0,164.0,           ,1.0,1.0,178.0
2376,Liikkuminen,2020-07-13 14:22:27.593582856,2020-07-13,2020-07-13,2020-07-13,3.0,-43.95,21689.69,0.0,162.0,           ,1.0,1.0,87.0
2377,Muut,2020-07-13 14:30:09.625668420,2020-07-13,2020-07-13,2020-07-13,3.0,-2.7,21686.99,0.0,162.0,           ,1.0,1.0,124.0
2378,Matkailu,2020-07-13 22:04:29.518716540,2020-07-13,2020-07-13,2020-07-13,3.0,-95.9,21591.09,0.0,164.0,           ,1.0,1.0,177.0
2379,Ruoka_paivittaistavarakauppa,2020-07-13 22:19:53.582887668,2020-07-13,2020-07-13,2020-07-13,3.0,-36.01,21555.08,0.0,162.0,           ,1.0,1.0,82.0
2380,Ruoka_paivittaistavarakauppa,2020-07-13 22:27:35.614973232,2020-07-13,2020-07-13,2020-07-13,3.0,-23.57,21531.51,0.0,162.0,           ,1.0,1.0,161.0
2381,Matkailu,2020-07-14 22:12:11.550802104,2020-07-14,2020-07-14,2020-07-14,3.0,-330.38,21201.13,0.0,164.0,           ,1.0,1.0,178.0
2382,Tulot,2020-07-15 06:09:37.540106916,2020-07-15,2020-07-15,2020-07-15,3.0,720.82,21921.95,710.0,506.0,           ,1.0,1.0,228.0
2383,Liikkuminen,2020-07-15 21:56:47.486630976,2020-07-15,2020-07-15,2020-07-15,3.0,-17.72,21904.23,0.0,162.0,           ,1.0,1.0,103.0
2384,Hyvinvointi,2020-07-16 05:54:13.475935788,2020-07-16,2020-07-16,2020-07-16,3.0,-14.31,21889.92,0.0,162.0,           ,1.0,1.0,86.0
2385,Liikkuminen,2020-07-16 13:43:57.433155036,2020-07-16,2020-07-16,2020-07-16,3.0,-5.63,21884.29,0.0,162.0,           ,1.0,1.0,115.0
2386,Ruoka_paivittaistavarakauppa,2020-07-16 13:51:39.465240600,2020-07-16,2020-07-16,2020-07-16,3.0,-5.14,21879.15,0.0,162.0,           ,1.0,1.0,146.0
2387,Ruoka_paivittaistavarakauppa,2020-07-16 14:07:03.529411728,2020-07-16,2020-07-16,2020-07-16,3.0,-14.7,21864.45,0.0,162.0,           ,1.0,1.0,131.0
2388,Ruoka_paivittaistavarakauppa,2020-07-17 06:01:55.508021352,2020-07-17,2020-07-17,2020-07-17,3.0,-53.58,21810.87,0.0,162.0,           ,1.0,1.0,104.0
2389,Saastot_sijoitukset,2020-07-17 13:36:15.401069472,2020-07-17,2020-07-17,2020-07-17,3.0,-1277.47,20533.4,0.0,164.0,           ,1.0,1.0,179.0
2390,Asuminen,2020-07-17 13:59:21.497326164,2020-07-13,2020-07-17,2020-07-17,3.0,-35.93,20497.47,0.0,162.0,           ,1.0,1.0,142.0
2391,Muut,2020-07-17 21:41:23.422459848,2020-07-17,2020-07-17,2020-07-17,3.0,-100.68,20396.79,0.0,164.0,           ,1.0,1.0,177.0
2392,Matkailu,2020-07-17 21:49:05.454545412,2020-07-17,2020-07-17,2020-07-17,3.0,-219.67,20177.12,0.0,164.0,           ,1.0,1.0,178.0
2393,Matkailu,2020-07-20 05:31:07.379679096,2020-07-20,2020-07-20,2020-07-20,3.0,-101.94,20075.18,0.0,162.0,           ,1.0,1.0,139.0
2394,Ruoka_paivittaistavarakauppa,2020-07-20 05:38:49.411764660,2020-07-20,2020-07-20,2020-07-20,3.0,-21.52,20053.66,0.0,162.0,           ,1.0,1.0,102.0
2395,Liikkuminen,2020-07-20 05:46:31.443850224,2020-07-20,2020-07-20,2020-07-20,3.0,-21.87,20031.79,0.0,162.0,           ,1.0,1.0,129.0
2396,Ruoka_paivittaistavarakauppa,2020-07-20 13:20:51.336898344,2020-07-20,2020-07-20,2020-07-20,3.0,-22.74,20009.05,0.0,162.0,           ,1.0,1.0,60.0
2397,Liikkuminen,2020-07-20 13:28:33.368983908,2020-07-20,2020-07-20,2020-07-20,3.0,-27.34,19981.71,0.0,162.0,           ,1.0,1.0,135.0
2398,Ruoka_paivittaistavarakauppa,2020-07-20 21:18:17.326203156,2020-07-20,2020-07-20,2020-07-20,3.0,-3.1,19978.61,0.0,162.0,           ,1.0,1.0,103.0
2399,Kulttuuri_viihde,2020-07-20 21:25:59.358288720,2020-07-20,2020-07-20,2020-07-20,3.0,-22.34,19956.27,0.0,162.0,           ,1.0,1.0,86.0
2400,Ruoka_paivittaistavarakauppa,2020-07-20 21:33:41.390374284,2020-07-20,2020-07-20,2020-07-20,3.0,-9.68,19946.59,0.0,162.0,           ,1.0,1.0,105.0
2401,Liikkuminen,2020-07-22 05:15:43.315507968,2020-07-22,2020-07-22,2020-07-22,3.0,-32.41,19914.18,0.0,162.0,           ,1.0,1.0,134.0
2402,Liikkuminen,2020-07-22 05:23:25.347593532,2020-07-22,2020-07-22,2020-07-22,3.0,-11.93,19902.25,0.0,162.0,           ,1.0,1.0,73.0
2403,Lemmikit,2020-07-23 05:00:19.251336840,2020-07-23,2020-07-23,2020-07-23,3.0,-10.83,19891.42,0.0,162.0,           ,1.0,1.0,110.0
2404,Shoppailu,2020-07-23 05:08:01.283422404,2020-07-23,2020-07-23,2020-07-23,3.0,-30.1,19861.32,0.0,162.0,           ,1.0,1.0,166.0
2405,Shoppailu,2020-07-23 12:50:03.208556088,2020-07-23,2020-07-23,2020-07-23,3.0,-25.58,19835.74,0.0,162.0,           ,1.0,1.0,148.0
2406,Hyvinvointijakauneus,2020-07-23 13:05:27.272727216,2020-07-23,2020-07-23,2020-07-23,3.0,-38.91,19796.83,0.0,162.0,           ,1.0,1.0,68.0
2407,Ravintolat_kahvilat,2020-07-23 13:13:09.304812780,2020-07-23,2020-07-23,2020-07-23,3.0,-1.73,19795.1,0.0,162.0,           ,1.0,1.0,150.0
2408,Tulot,2020-07-23 21:10:35.294117592,2020-07-23,2020-07-23,2020-07-23,3.0,6132.25,25927.35,0.0,505.0,           ,1.0,1.0,187.0
2409,Ruoka_paivittaistavarakauppa,2020-07-24 04:52:37.219251276,2020-07-24,2020-07-24,2020-07-24,3.0,-12.97,25914.38,0.0,162.0,           ,1.0,1.0,108.0
2410,Ruoka_paivittaistavarakauppa,2020-07-24 12:57:45.240641652,2020-07-24,2020-07-24,2020-07-24,3.0,-35.98,25878.4,0.0,162.0,           ,1.0,1.0,106.0
2411,Ruoka_paivittaistavarakauppa,2020-07-24 20:47:29.197860900,2020-07-24,2020-07-24,2020-07-24,3.0,-19.03,25859.37,0.0,162.0,           ,1.0,1.0,103.0
2412,Ravintolat_kahvilat,2020-07-24 20:55:11.229946464,2020-07-24,2020-07-24,2020-07-24,3.0,-1.2,25858.17,0.0,162.0,           ,1.0,1.0,45.0
2413,Ruoka_paivittaistavarakauppa,2020-07-24 21:02:53.262032028,2020-07-24,2020-07-24,2020-07-24,3.0,-16.48,25841.69,0.0,162.0,           ,1.0,1.0,86.0
2414,Ruoka_paivittaistavarakauppa,2020-07-27 04:37:13.155080148,2020-07-27,2020-07-27,2020-07-27,3.0,-20.92,25820.77,0.0,162.0,           ,1.0,1.0,139.0
2415,Ravintolat_kahvilat,2020-07-27 12:34:39.144384960,2020-07-27,2020-07-27,2020-07-27,3.0,-1.48,25819.29,0.0,162.0,           ,1.0,1.0,154.0
2416,Lapset,2020-07-27 12:42:21.176470524,2020-07-27,2020-07-27,2020-07-27,3.0,-14.03,25805.26,0.0,162.0,           ,1.0,1.0,92.0
2417,Muut,2020-07-27 20:32:05.133689772,2020-07-27,2020-07-27,2020-07-27,3.0,-29.0,25776.26,0.0,164.0,           ,1.0,1.0,177.0
2418,Lapset,2020-07-27 20:39:47.165775336,2020-07-27,2020-07-27,2020-07-27,3.0,-4.26,25772.0,0.0,162.0,           ,1.0,1.0,119.0
2419,Ruoka_paivittaistavarakauppa,2020-07-28 04:44:55.187165712,2020-07-28,2020-07-28,2020-07-28,3.0,-26.14,25745.86,0.0,162.0,           ,1.0,1.0,121.0
2420,Muut,2020-07-28 12:26:57.112299396,2020-07-28,2020-07-28,2020-07-28,3.0,-304.6,25441.26,0.0,164.0,           ,1.0,1.0,177.0
2421,Luokittelemattomat,2020-07-28 20:24:23.101604208,2020-07-28,2020-07-28,2020-07-28,3.0,-196.26,25245.0,0.0,106.0,HELSFIHH   ,1.0,0.0,7.0
2422,Muut,2020-07-29 04:06:25.026737892,2020-07-29,2020-07-29,2020-07-29,3.0,-59.58,25185.42,0.0,164.0,           ,1.0,1.0,180.0
2423,Muut,2020-07-29 04:29:31.122994584,2020-07-29,2020-07-29,2020-07-29,3.0,-138.36,25047.06,0.0,164.0,           ,1.0,1.0,177.0
2424,Muut,2020-07-29 12:11:33.048128268,2020-07-29,2020-07-29,2020-07-29,3.0,-180.24,24866.82,0.0,163.0,           ,1.0,1.0,173.0
2425,Ruoka_paivittaistavarakauppa,2020-07-30 04:21:49.090909020,2020-07-30,2020-07-30,2020-07-30,3.0,-22.42,24844.4,0.0,162.0,           ,1.0,1.0,137.0
2426,Ruoka_paivittaistavarakauppa,2020-07-30 12:19:15.080213832,2020-07-30,2020-07-30,2020-07-30,3.0,-25.0,24819.4,0.0,162.0,           ,1.0,1.0,69.0
2427,Ruoka_paivittaistavarakauppa,2020-07-30 20:08:59.037433080,2020-07-30,2020-07-30,2020-07-30,3.0,-0.73,24818.67,0.0,162.0,           ,1.0,1.0,119.0
2428,Liikkuminen,2020-07-30 20:16:41.069518644,2020-07-30,2020-07-30,2020-07-30,3.0,-19.72,24798.95,0.0,162.0,           ,1.0,1.0,134.0
2429,Liikkuminen,2020-07-31 04:14:07.058823456,2020-07-31,2020-07-31,2020-07-31,3.0,-78.49,24720.46,0.0,162.0,           ,1.0,1.0,94.0
2430,Luottojen_maksut,2020-07-31 12:03:51.016042704,2020-07-31,2020-07-31,2020-07-31,3.0,-511.96,24208.5,0.0,172.0,           ,1.0,1.0,182.0
2431,Luottojen_maksut,2020-07-31 20:01:17.005347516,2020-07-31,2020-07-31,2020-07-31,3.0,-583.6,23624.9,0.0,172.0,           ,1.0,1.0,181.0
2432,Ravintolat_kahvilat,2020-08-03 09:40:27.906976740,2020-08-03,2020-08-03,2020-08-03,3.0,-25.91,23598.99,0.0,162.0,           ,1.0,1.0,94.0
2433,Lemmikit,2020-08-03 10:36:16.744186044,2020-08-03,2020-08-03,2020-08-03,3.0,-57.38,23541.61,0.0,162.0,           ,1.0,1.0,110.0
2434,Ruoka_paivittaistavarakauppa,2020-08-03 11:32:05.581395348,2020-08-03,2020-08-03,2020-08-03,3.0,-5.72,23535.89,0.0,162.0,           ,1.0,1.0,45.0
2435,Ruoka_paivittaistavarakauppa,2020-08-03 21:12:33.488372088,2020-08-03,2020-08-03,2020-08-03,3.0,-8.6,23527.29,0.0,162.0,           ,1.0,1.0,110.0
2436,Ravintolat_kahvilat,2020-08-03 22:08:22.325581392,2020-08-03,2020-08-03,2020-08-03,3.0,-11.01,23516.28,0.0,162.0,           ,1.0,1.0,62.0
2437,Shoppailu,2020-08-03 23:04:11.162790696,2020-08-03,2020-08-03,2020-08-03,3.0,-14.95,23501.33,0.0,162.0,           ,1.0,1.0,128.0
2438,Ruoka_paivittaistavarakauppa,2020-08-04 08:44:39.069767436,2020-08-04,2020-08-05,2020-08-04,3.0,-0.56,23500.77,0.0,162.0,           ,1.0,1.0,85.0
2439,Ruoka_paivittaistavarakauppa,2020-08-05 07:48:50.232558132,2020-08-05,2020-08-05,2020-08-05,3.0,-107.0,23393.77,0.0,162.0,           ,1.0,1.0,149.0
2440,Tulot,2020-08-05 20:16:44.651162784,2020-08-05,2020-08-05,2020-08-05,3.0,1384.19,24777.96,0.0,505.0,           ,1.0,1.0,187.0
2441,Ruoka_paivittaistavarakauppa,2020-08-06 18:25:06.976744176,2020-08-06,2020-08-06,2020-08-06,3.0,-1.23,24776.73,0.0,162.0,           ,1.0,1.0,113.0
2442,Ruoka_paivittaistavarakauppa,2020-08-06 19:20:55.813953480,2020-08-06,2020-08-06,2020-08-06,3.0,-4.69,24772.04,0.0,162.0,           ,1.0,1.0,100.0
2443,Muut,2020-08-07 05:57:12.558139524,2020-08-07,2020-08-07,2020-08-07,3.0,-10.12,24761.92,0.0,162.0,           ,1.0,1.0,85.0
2444,Ruoka_paivittaistavarakauppa,2020-08-07 06:53:01.395348828,2020-08-07,2020-08-07,2020-08-07,3.0,-12.05,24749.87,0.0,162.0,           ,1.0,1.0,113.0
2445,Ruoka_paivittaistavarakauppa,2020-08-07 16:33:29.302325568,2020-08-07,2020-08-07,2020-08-07,3.0,-1.62,24748.25,0.0,162.0,           ,1.0,1.0,111.0
2446,Muut,2020-08-07 17:29:18.139534872,2020-08-07,2020-08-07,2020-08-07,3.0,-153.83,24594.42,0.0,162.0,           ,1.0,1.0,86.0
2447,Saastot_sijoitukset,2020-08-10 03:09:46.046511612,2020-08-10,2020-08-10,2020-08-10,3.0,-26.22,24568.2,0.0,162.0,           ,1.0,1.0,53.0
2448,Ruoka_paivittaistavarakauppa,2020-08-10 04:05:34.883720916,2020-08-10,2020-08-10,2020-08-10,3.0,-33.98,24534.22,0.0,162.0,           ,1.0,1.0,64.0
2449,Ravintolat_kahvilat,2020-08-10 05:01:23.720930220,2020-08-10,2020-08-10,2020-08-10,3.0,-0.95,24533.27,0.0,162.0,           ,1.0,1.0,81.0
2450,Ruoka_paivittaistavarakauppa,2020-08-10 14:41:51.627906960,2020-08-10,2020-08-10,2020-08-10,3.0,-3.8,24529.47,0.0,162.0,           ,1.0,1.0,125.0
2451,Ruoka_paivittaistavarakauppa,2020-08-10 15:37:40.465116264,2020-08-10,2020-08-10,2020-08-10,3.0,-12.55,24516.92,0.0,162.0,           ,1.0,1.0,169.0
2452,Shoppailu,2020-08-11 01:18:08.372093004,2020-08-11,2020-08-11,2020-08-11,3.0,-9.19,24507.73,0.0,162.0,           ,1.0,1.0,145.0
2453,Liikkuminen,2020-08-12 12:50:13.953488352,2020-08-12,2020-08-12,2020-08-12,3.0,-22.63,24485.1,0.0,162.0,           ,1.0,1.0,143.0
2454,Harrastukset,2020-08-12 13:46:02.790697656,2020-08-12,2020-08-12,2020-08-12,3.0,-151.31,24333.79,0.0,106.0,OKOYFIHH   ,0.0,0.0,31.0
2455,Tulot,2020-08-13 02:13:57.209302308,2020-08-13,2020-08-14,2020-08-13,3.0,163.08,24496.87,0.0,505.0,           ,1.0,1.0,188.0
2456,Muut,2020-08-13 23:26:30.697674396,2020-08-13,2020-08-13,2020-08-13,3.0,-15.17,24481.7,0.0,103.0,           ,0.0,1.0,1.0
2457,Ruoka_paivittaistavarakauppa,2020-08-14 00:22:19.534883700,2020-08-14,2020-08-14,2020-08-14,3.0,-233.42,24248.28,0.0,162.0,           ,1.0,1.0,134.0
2458,Ravintolat_kahvilat,2020-08-14 10:58:36.279069744,2020-08-14,2020-08-14,2020-08-14,3.0,-4.66,24243.62,0.0,162.0,           ,1.0,1.0,90.0
2459,Ravintolat_kahvilat,2020-08-14 11:54:25.116279048,2020-08-14,2020-08-14,2020-08-14,3.0,-6.59,24237.03,0.0,162.0,           ,1.0,1.0,140.0
2460,Tulot,2020-08-14 22:30:41.860465092,2020-08-14,2020-08-14,2020-08-14,3.0,5601.95,29838.98,0.0,505.0,           ,1.0,1.0,186.0
2461,Muut,2020-08-15 10:02:47.441860440,2020-08-15,2020-08-15,2020-08-15,3.0,-69.87,29769.11,0.0,163.0,           ,1.0,1.0,174.0
2462,Matkailu,2020-08-17 08:11:09.767441832,2020-08-17,2020-08-17,2020-08-17,3.0,-486.38,29282.73,0.0,106.0,OKOYFIHH   ,1.0,0.0,16.0
2463,Luottojen_maksut,2020-08-17 09:06:58.604651136,2020-08-17,2020-08-17,2020-08-17,3.0,-70.93,29211.8,0.0,172.0,           ,1.0,1.0,181.0
2464,Terveys,2020-08-17 19:43:15.348837180,2020-08-17,2020-08-17,2020-08-17,3.0,3380.84,32592.64,0.0,583.0,OKOYFIHH   ,1.0,0.0,194.0
2465,Luottojen_maksut,2020-08-17 21:34:53.023255788,2020-08-17,2020-08-17,2020-08-17,3.0,-113.19,32479.45,0.0,172.0,           ,1.0,1.0,181.0
2466,Ruoka_paivittaistavarakauppa,2020-08-18 07:15:20.930232528,2020-08-18,2020-08-18,2020-08-18,3.0,-54.39,32425.06,0.0,162.0,           ,1.0,1.0,146.0
2467,Tulot,2020-08-18 18:47:26.511627876,2020-08-18,2020-08-18,2020-08-18,3.0,3995.67,36420.73,0.0,506.0,           ,1.0,1.0,192.0
2468,Ruoka_paivittaistavarakauppa,2020-08-18 20:39:04.186046484,2020-08-21,2020-08-18,2020-08-18,3.0,-13.69,36407.04,0.0,162.0,           ,1.0,1.0,71.0
2469,Ruoka_paivittaistavarakauppa,2020-08-20 04:27:54.418604616,2020-08-20,2020-08-20,2020-08-20,3.0,-73.46,36333.58,0.0,162.0,           ,1.0,1.0,46.0
2470,Muut,2020-08-20 05:23:43.255813920,2020-08-20,2020-08-20,2020-08-20,3.0,-323.07,36010.51,0.0,105.0,OKOYFIHH   ,1.0,0.0,3.0
2471,Muut,2020-08-20 06:19:32.093023224,2020-08-20,2020-08-20,2020-08-20,3.0,-650.09,35360.42,0.0,105.0,OKOYFIHH   ,1.0,0.0,2.0
2472,Luokittelemattomat,2020-08-20 16:55:48.837209268,2020-08-20,2020-08-20,2020-08-20,3.0,-35.89,35324.53,706.0,129.0,OKOYFIHH   ,0.0,0.0,218.0
2473,Tulot,2020-08-20 17:51:37.674418572,2020-08-20,2020-08-20,2020-08-20,3.0,721.77,36046.3,701.0,506.0,           ,1.0,1.0,195.0
2474,Luokittelemattomat,2020-08-22 14:08:22.325581356,2020-08-22,2020-08-22,2020-08-22,3.0,-109.66,35936.64,0.0,129.0,OKOYFIHH   ,0.0,0.0,42.0
2475,Shoppailu,2020-08-23 02:36:16.744186008,2020-08-23,2020-08-23,2020-08-23,3.0,-39.03,35897.61,0.0,129.0,DABAFIHH   ,0.0,0.0,40.0
2476,Asuminen,2020-08-23 15:04:11.162790660,2020-08-23,2020-08-23,2020-08-23,3.0,-63.11,35834.5,0.0,129.0,OKOYFIHH   ,0.0,0.0,40.0
2477,Matkailu,2020-08-23 15:59:59.999999964,2020-08-23,2020-08-23,2020-08-23,3.0,-116.27,35718.23,0.0,106.0,OKOYFIHH   ,0.0,0.0,36.0
2478,Tulot,2020-08-24 03:32:05.581395312,2020-08-24,2020-08-24,2020-08-24,3.0,332.19,36050.42,0.0,505.0,           ,1.0,1.0,188.0
2479,Tulot,2020-08-24 13:12:33.488372052,2020-08-24,2020-08-24,2020-08-24,3.0,-19.03,36031.39,0.0,162.0,           ,1.0,1.0,118.0
2480,Ruoka_paivittaistavarakauppa,2020-08-24 23:48:50.232558096,2020-08-24,2020-08-24,2020-08-24,3.0,-18.68,36012.71,0.0,162.0,           ,1.0,1.0,92.0
2481,Tulot,2020-08-25 00:44:39.069767400,2020-08-25,2020-08-25,2020-08-25,3.0,-11.97,36000.74,0.0,162.0,           ,1.0,1.0,161.0
2482,Hyvinvointijakauneus,2020-08-25 01:40:27.906976704,2020-08-25,2020-08-25,2020-08-25,3.0,-106.43,35894.31,0.0,129.0,HANDFIHH   ,0.0,0.0,41.0
2483,Luokittelemattomat,2020-08-25 12:16:44.651162748,2020-08-25,2020-08-25,2020-08-25,3.0,-41.76,35852.55,0.0,106.0,OKOYFIHH   ,1.0,0.0,32.0
2484,Tulot,2020-08-25 22:53:01.395348792,2020-08-25,2020-08-26,2020-08-25,3.0,4933.96,40786.51,0.0,505.0,           ,1.0,1.0,186.0
2485,Hyvinvointijakauneus,2020-08-26 11:20:55.813953444,2020-08-26,2020-08-26,2020-08-26,3.0,-9.29,40777.22,0.0,162.0,           ,1.0,1.0,44.0
2486,Matkailu,2020-08-27 09:29:18.139534836,2020-08-27,2020-08-27,2020-08-27,3.0,-13.21,40764.01,0.0,162.0,           ,1.0,1.0,59.0
2487,Ruoka_paivittaistavarakauppa,2020-08-27 10:25:06.976744140,2020-08-27,2020-08-27,2020-08-27,3.0,-4.0,40760.01,0.0,162.0,           ,1.0,1.0,92.0
2488,Ruoka_paivittaistavarakauppa,2020-08-27 21:01:23.720930184,2020-08-27,2020-08-27,2020-08-27,3.0,-89.91,40670.1,0.0,162.0,           ,1.0,1.0,107.0
2489,Ruoka_paivittaistavarakauppa,2020-08-27 21:57:12.558139488,2020-08-27,2020-08-27,2020-08-27,3.0,-59.95,40610.15,0.0,162.0,           ,1.0,1.0,82.0
2490,Ruoka_paivittaistavarakauppa,2020-08-28 08:33:29.302325532,2020-08-28,2020-08-28,2020-08-28,3.0,-8.61,40601.54,0.0,162.0,           ,1.0,1.0,100.0
2491,Tulot,2020-08-28 20:05:34.883720880,2020-08-28,2020-08-28,2020-08-28,3.0,1235.84,41837.38,0.0,505.0,           ,1.0,1.0,186.0
2492,Matkailu,2020-08-30 07:37:40.465116228,2020-08-30,2020-08-31,2020-08-30,3.0,-549.04,41288.34,0.0,106.0,OKOYFIHH   ,0.0,0.0,30.0
2493,Luokittelemattomat,2020-08-30 19:09:46.046511576,2020-08-30,2020-08-30,2020-08-30,3.0,-73.49,41214.85,0.0,106.0,OKOYFIHH   ,0.0,0.0,11.0
2494,Ruoka_paivittaistavarakauppa,2020-08-31 06:41:51.627906924,2020-08-27,2020-09-02,2020-08-31,3.0,-73.51,41141.34,0.0,162.0,           ,1.0,1.0,71.0
2495,Ruoka_paivittaistavarakauppa,2020-08-31 18:13:57.209302272,2020-08-31,2020-08-31,2020-08-31,3.0,-44.77,41096.57,0.0,162.0,           ,1.0,1.0,118.0
2496,Tulot,2020-09-01 10:30:39.416058394,2020-09-01,2020-09-01,2020-09-01,3.0,510.58,41607.15,701.0,520.0,           ,1.0,1.0,197.0
2497,Luottojen_maksut,2020-09-01 21:01:18.832116788,2020-09-01,2020-09-01,2020-09-01,3.0,-534.56,41072.59,0.0,172.0,           ,1.0,1.0,181.0
2498,Luottojen_maksut,2020-09-02 07:31:58.248175182,2020-09-02,2020-09-04,2020-09-02,3.0,-142.26,40930.33,0.0,172.0,           ,1.0,1.0,181.0
2499,Tulot,2020-09-02 18:02:37.664233576,2020-09-02,2020-09-02,2020-09-01,3.0,593.71,41524.04,710.0,506.0,           ,1.0,1.0,225.0
2500,Ruoka_paivittaistavarakauppa,2020-09-03 04:33:17.080291970,2020-09-03,2020-09-03,2020-09-03,3.0,-35.5,41488.54,0.0,162.0,           ,1.0,1.0,144.0
2501,Saastot_sijoitukset,2020-09-03 15:03:56.496350364,2020-09-03,2020-09-03,2020-09-03,3.0,-8.36,41480.18,0.0,162.0,           ,1.0,1.0,124.0
2502,Ruoka_paivittaistavarakauppa,2020-09-04 01:34:35.912408758,2020-09-04,2020-09-04,2020-09-04,3.0,-8.45,41471.73,0.0,162.0,           ,1.0,1.0,92.0
2503,Ruoka_paivittaistavarakauppa,2020-09-04 12:05:15.328467152,2020-09-04,2020-09-04,2020-09-04,3.0,-49.47,41422.26,0.0,162.0,           ,1.0,1.0,92.0
2504,Lemmikit,2020-09-04 22:35:54.744525546,2020-09-04,2020-09-04,2020-09-04,3.0,-33.29,41388.97,0.0,162.0,           ,1.0,1.0,71.0
2505,Kulttuuri_viihde,2020-09-05 09:06:34.160583940,2020-09-05,2020-09-05,2020-09-05,3.0,-42.99,41345.98,0.0,106.0,OKOYFIHH   ,0.0,0.0,13.0
2506,Matkailu,2020-09-06 06:07:52.992700728,2020-09-06,2020-09-08,2020-09-06,3.0,-225.53,41120.45,0.0,106.0,OKOYFIHH   ,0.0,0.0,8.0
2507,Muut,2020-09-06 16:38:32.408759122,2020-09-06,2020-09-06,2020-09-06,3.0,-11.69,41108.76,0.0,163.0,           ,1.0,1.0,173.0
2508,Tulot,2020-09-07 03:09:11.824817516,2020-09-07,2020-09-07,2020-09-07,3.0,3713.67,44822.43,0.0,505.0,           ,1.0,1.0,187.0
2509,Lapset,2020-09-07 13:39:51.240875910,2020-09-07,2020-09-07,2020-09-07,3.0,-303.57,44518.86,0.0,162.0,           ,1.0,1.0,92.0
2510,Shoppailu,2020-09-07 19:37:13.576642334,2020-09-07,2020-09-07,2020-09-07,3.0,270.53,44789.39,0.0,505.0,           ,1.0,1.0,186.0
2511,Ruoka_paivittaistavarakauppa,2020-09-08 00:10:30.656934304,2020-09-08,2020-09-08,2020-09-08,3.0,-8.45,44780.94,0.0,162.0,           ,1.0,1.0,136.0
2512,Matkailu,2020-09-08 10:41:10.072992698,2020-09-08,2020-09-08,2020-09-08,3.0,-49.45,44731.49,0.0,162.0,           ,1.0,1.0,117.0
2513,Asuminen,2020-09-08 18:13:08.321167880,2020-09-08,2020-09-08,2020-09-08,3.0,-240.58,44490.91,706.0,129.0,OKOYFIHH   ,0.0,0.0,216.0
2514,Ruoka_paivittaistavarakauppa,2020-09-08 21:11:49.489051092,2020-09-08,2020-09-08,2020-09-08,3.0,-42.16,44448.75,0.0,106.0,NDEAFIHH   ,0.0,0.0,36.0
2515,Tulot,2020-09-09 07:42:28.905109486,2020-09-09,2020-09-09,2020-09-09,3.0,1460.2,45908.95,0.0,505.0,           ,1.0,1.0,186.0
2516,Lemmikit,2020-09-09 15:14:27.153284668,2020-09-09,2020-09-09,2020-09-09,3.0,-60.38,45848.57,0.0,162.0,           ,1.0,1.0,98.0
2517,Asuminen,2020-09-10 22:46:25.401459850,2020-09-10,2020-09-10,2020-09-10,3.0,-19.61,45828.96,706.0,129.0,DABAFIHH   ,0.0,0.0,214.0
2518,Ruoka_paivittaistavarakauppa,2020-09-11 01:45:06.569343062,2020-09-11,2020-09-11,2020-09-11,3.0,-33.44,45795.52,0.0,162.0,           ,1.0,1.0,141.0
2519,Ravintolat_kahvilat,2020-09-11 04:43:47.737226274,2020-09-11,2020-09-11,2020-09-11,3.0,-4.44,45791.08,0.0,162.0,           ,1.0,1.0,99.0
2520,Ruoka_paivittaistavarakauppa,2020-09-11 12:15:45.985401456,2020-09-11,2020-09-11,2020-09-11,3.0,-11.76,45779.32,0.0,162.0,           ,1.0,1.0,44.0
2521,Matkailu,2020-09-11 19:47:44.233576638,2020-09-11,2020-09-11,2020-09-11,3.0,-34.87,45744.45,0.0,106.0,OKOYFIHH   ,0.0,0.0,11.0
2522,Matkailu,2020-09-12 09:17:04.817518244,2020-09-12,2020-09-12,2020-09-12,3.0,-528.63,45215.82,0.0,106.0,DABAFIHH   ,0.0,0.0,39.0
2523,Luokittelemattomat,2020-09-14 03:19:42.481751820,2020-09-14,2020-09-14,2020-09-14,3.0,-138.7,45077.12,0.0,162.0,           ,1.0,1.0,86.0
2524,Muut,2020-09-14 06:18:23.649635032,2020-09-14,2020-09-14,2020-09-14,3.0,-23.44,45053.68,0.0,162.0,           ,1.0,1.0,156.0
2525,Saastot_sijoitukset,2020-09-14 13:50:21.897810214,2020-09-14,2020-09-14,2020-09-14,3.0,-17.8,45035.88,0.0,162.0,           ,1.0,1.0,155.0
2526,Ruoka_paivittaistavarakauppa,2020-09-14 16:49:03.065693426,2020-09-14,2020-09-14,2020-09-14,3.0,-16.05,45019.83,0.0,162.0,           ,1.0,1.0,81.0
2527,Matkailu,2020-09-15 10:51:40.729927002,2020-09-15,2020-09-15,2020-09-15,3.0,-433.03,44586.8,0.0,105.0,OKOYFIHH   ,1.0,0.0,4.0
2528,Matkailu,2020-09-15 21:22:20.145985396,2020-09-15,2020-09-15,2020-09-15,3.0,-335.4,44251.4,0.0,105.0,OKOYFIHH   ,1.0,0.0,2.0
2529,Luokittelemattomat,2020-09-16 00:21:01.313868608,2020-09-16,2020-09-17,2020-09-16,3.0,-84.52,44166.88,0.0,162.0,           ,1.0,1.0,45.0
2530,Muut,2020-09-16 07:52:59.562043790,2020-09-16,2020-09-16,2020-09-16,3.0,-31.03,44135.85,0.0,105.0,OKOYFIHH   ,1.0,0.0,3.0
2531,Saastot_sijoitukset,2020-09-16 18:23:38.978102184,2020-09-16,2020-09-16,2020-09-16,3.0,-37.62,44098.23,0.0,162.0,           ,1.0,1.0,88.0
2532,Ruoka_paivittaistavarakauppa,2020-09-18 01:55:37.226277366,2020-09-18,2020-09-18,2020-09-18,3.0,-10.92,44087.31,0.0,162.0,           ,1.0,1.0,102.0
2533,Muut,2020-09-18 04:54:18.394160578,2020-09-18,2020-09-18,2020-09-18,3.0,-28.47,44058.84,0.0,162.0,           ,1.0,1.0,146.0
2534,Ravintolat_kahvilat,2020-09-18 09:27:35.474452548,2020-09-18,2020-09-18,2020-09-18,3.0,-2.63,44056.21,0.0,162.0,           ,1.0,1.0,138.0
2535,Asuminen,2020-09-18 12:26:16.642335760,2020-09-18,2020-09-18,2020-09-18,3.0,-62.81,43993.4,0.0,162.0,           ,1.0,1.0,165.0
2536,Saastot_sijoitukset,2020-09-18 15:24:57.810218972,2020-09-18,2020-09-18,2020-09-18,3.0,-71.03,43922.37,0.0,162.0,           ,1.0,1.0,106.0
2537,Ruoka_paivittaistavarakauppa,2020-09-18 16:59:33.722627730,2020-09-18,2020-09-18,2020-09-18,3.0,-32.63,43889.74,0.0,162.0,           ,1.0,1.0,99.0
2538,Liikkuminen,2020-09-18 22:56:56.058394154,2020-09-18,2020-09-18,2020-09-18,3.0,-28.36,43861.38,0.0,162.0,           ,1.0,1.0,99.0
2539,Ruoka_paivittaistavarakauppa,2020-09-21 03:30:13.138686124,2020-09-21,2020-09-21,2020-09-21,3.0,-10.79,43850.59,0.0,162.0,           ,1.0,1.0,106.0
2540,Ruoka_paivittaistavarakauppa,2020-09-21 06:28:54.306569336,2020-09-21,2020-09-21,2020-09-21,3.0,-13.8,43836.79,0.0,162.0,           ,1.0,1.0,146.0
2541,Luokittelemattomat,2020-09-21 11:02:11.386861306,2020-09-21,2020-09-21,2020-09-21,3.0,-102.21,43734.58,0.0,106.0,NDEAFIHH   ,1.0,0.0,29.0
2542,Ruoka_paivittaistavarakauppa,2020-09-21 14:00:52.554744518,2020-09-21,2020-09-21,2020-09-21,3.0,-14.31,43720.27,0.0,162.0,           ,1.0,1.0,104.0
2543,Ruoka_paivittaistavarakauppa,2020-09-21 19:58:14.890510942,2020-09-21,2020-09-21,2020-09-21,3.0,-6.05,43714.22,0.0,162.0,           ,1.0,1.0,45.0
2544,Ruoka_paivittaistavarakauppa,2020-09-22 00:31:31.970802912,2020-09-22,2020-09-22,2020-09-22,3.0,-15.27,43698.95,0.0,162.0,           ,1.0,1.0,53.0
2545,Ravintolat_kahvilat,2020-09-22 08:03:30.218978094,2020-09-22,2020-09-22,2020-09-22,3.0,-66.78,43632.17,0.0,162.0,           ,1.0,1.0,85.0
2546,Shoppailu,2020-09-23 21:32:50.802919700,2020-09-23,2020-09-23,2020-09-23,3.0,-22.53,43609.64,0.0,162.0,           ,1.0,1.0,92.0
2547,Ruoka_paivittaistavarakauppa,2020-09-23 23:07:26.715328458,2020-09-23,2020-09-23,2020-09-23,3.0,-15.29,43594.35,0.0,162.0,           ,1.0,1.0,98.0
2548,Lemmikit,2020-09-24 02:06:07.883211670,2020-09-24,2020-09-24,2020-09-24,3.0,-9.63,43584.72,0.0,162.0,           ,1.0,1.0,102.0
2549,Ravintolat_kahvilat,2020-09-24 15:35:28.467153276,2020-09-24,2020-09-24,2020-09-24,3.0,-25.08,43559.64,0.0,162.0,           ,1.0,1.0,45.0
2550,Ruoka_paivittaistavarakauppa,2020-09-25 05:04:49.051094882,2020-09-25,2020-09-25,2020-09-25,3.0,-48.96,43510.68,0.0,162.0,           ,1.0,1.0,92.0
2551,Liikkuminen,2020-09-25 09:38:06.131386852,2020-09-25,2020-09-25,2020-09-25,3.0,-7.36,43503.32,0.0,162.0,           ,1.0,1.0,71.0
2552,Ruoka_paivittaistavarakauppa,2020-09-25 12:36:47.299270064,2020-09-25,2020-09-25,2020-09-25,3.0,-64.16,43439.16,0.0,162.0,           ,1.0,1.0,61.0
2553,Shoppailu,2020-09-25 18:34:09.635036488,2020-09-25,2020-09-25,2020-09-25,3.0,-26.2,43412.96,0.0,162.0,           ,1.0,1.0,118.0
2554,Ruoka_paivittaistavarakauppa,2020-09-28 00:42:02.627737216,2020-09-28,2020-09-28,2020-09-28,3.0,-34.39,43378.57,0.0,162.0,           ,1.0,1.0,104.0
2555,Ravintolat_kahvilat,2020-09-28 03:40:43.795620428,2020-09-28,2020-09-28,2020-09-28,3.0,-3.12,43375.45,0.0,162.0,           ,1.0,1.0,146.0
2556,Shoppailu,2020-09-28 11:12:42.043795610,2020-09-28,2020-09-28,2020-09-28,3.0,-62.16,43313.29,0.0,162.0,           ,1.0,1.0,58.0
2557,Ruoka_paivittaistavarakauppa,2020-09-28 14:11:23.211678822,2020-09-28,2020-09-28,2020-09-28,3.0,-33.2,43280.09,0.0,162.0,           ,1.0,1.0,114.0
2558,Ruoka_paivittaistavarakauppa,2020-09-28 20:08:45.547445246,2020-09-28,2020-09-28,2020-09-28,3.0,-90.16,43189.93,0.0,162.0,           ,1.0,1.0,146.0
2559,Ruoka_paivittaistavarakauppa,2020-09-29 06:39:24.963503640,2020-09-29,2020-09-29,2020-09-28,3.0,-18.97,43170.96,0.0,162.0,           ,1.0,1.0,68.0
2560,Harrastukset,2020-09-29 08:14:00.875912398,2020-09-29,2020-09-29,2020-09-29,3.0,-9.63,43161.33,0.0,162.0,           ,1.0,1.0,127.0
2561,Ruoka_paivittaistavarakauppa,2020-09-29 17:10:04.379562034,2020-09-29,2020-09-29,2020-09-29,3.0,-9.98,43151.35,0.0,162.0,           ,1.0,1.0,45.0
2562,Shoppailu,2020-09-30 18:44:40.291970792,2020-09-30,2020-09-30,2020-09-30,3.0,-47.67,43103.68,706.0,147.0,NDEAFIHH   ,0.0,0.0,221.0
2563,Tulot,2020-09-30 21:43:21.459854004,2020-09-30,2020-09-30,2020-09-30,3.0,401.84,43505.52,701.0,521.0,           ,1.0,1.0,202.0
2564,Ruoka_paivittaistavarakauppa,2020-10-01 09:43:31.764705882,2020-10-01,2020-10-01,2020-09-28,3.0,-11.65,43493.87,0.0,162.0,           ,1.0,1.0,43.0
2565,Muut,2020-10-01 10:21:10.588235292,2020-10-01,2020-10-01,2020-10-01,3.0,-38.35,43455.52,0.0,105.0,OKOYFIHH   ,1.0,0.0,6.0
2566,Tulot,2020-10-01 19:27:03.529411764,2020-10-01,2020-10-01,2020-10-01,3.0,291.68,43747.2,0.0,505.0,           ,1.0,1.0,188.0
2567,Saastot_sijoitukset,2020-10-02 05:10:35.294117646,2020-10-02,2020-10-02,2020-10-02,3.0,-46.22,43700.98,0.0,162.0,           ,1.0,1.0,98.0
2568,Muut,2020-10-02 14:54:07.058823528,2020-10-02,2020-10-02,2020-10-02,3.0,-33528.07,10172.91,0.0,105.0,OKOYFIHH   ,1.0,0.0,5.0
2569,Muut,2020-10-02 20:04:42.352941174,2020-10-02,2020-10-02,2020-10-02,3.0,-43.84,10129.07,0.0,105.0,OKOYFIHH   ,1.0,0.0,3.0
2570,Tulot,2020-10-05 00:37:38.823529410,2020-10-05,2020-10-05,2020-10-05,3.0,2925.44,13054.51,710.0,506.0,           ,1.0,1.0,228.0
2571,Lemmikit,2020-10-05 01:15:17.647058820,2020-10-05,2020-10-05,2020-10-05,3.0,-30.71,13023.8,0.0,106.0,OKOYFIHH   ,1.0,0.0,25.0
2572,Luokittelemattomat,2020-10-05 01:52:56.470588230,2020-10-05,2020-10-05,2020-10-05,3.0,-2.93,13020.87,0.0,162.0,           ,1.0,1.0,113.0
2573,Ravintolat_kahvilat,2020-10-05 05:48:14.117647056,2020-10-05,2020-10-05,2020-10-05,3.0,-13.0,13007.87,0.0,162.0,           ,1.0,1.0,165.0
2574,Ravintolat_kahvilat,2020-10-05 10:58:49.411764702,2020-10-05,2020-10-05,2020-10-05,3.0,-66.16,12941.71,0.0,162.0,           ,1.0,1.0,105.0
2575,Asuminen,2020-10-05 15:31:45.882352938,2020-10-05,2020-10-05,2020-10-05,3.0,-25.02,12916.69,0.0,162.0,           ,1.0,1.0,44.0
2576,Ruoka_paivittaistavarakauppa,2020-10-05 16:09:24.705882348,2020-10-05,2020-10-05,2020-10-05,3.0,-11.57,12905.12,0.0,162.0,           ,1.0,1.0,100.0
2577,Ruoka_paivittaistavarakauppa,2020-10-05 20:42:21.176470584,2020-10-05,2020-10-05,2020-10-05,3.0,-11.23,12893.89,0.0,162.0,           ,1.0,1.0,100.0
2578,Ravintolat_kahvilat,2020-10-06 06:25:52.941176466,2020-10-06,2020-10-06,2020-10-06,3.0,-11.7,12882.19,0.0,162.0,           ,1.0,1.0,117.0
2579,Ravintolat_kahvilat,2020-10-06 16:47:03.529411758,2020-10-06,2020-10-06,2020-10-06,3.0,-1.28,12880.91,0.0,162.0,           ,1.0,1.0,139.0
2580,Muut,2020-10-07 07:03:31.764705876,2020-10-07,2020-10-07,2020-10-07,3.0,-19.43,12861.48,0.0,162.0,           ,1.0,1.0,124.0
2581,Ruoka_paivittaistavarakauppa,2020-10-07 11:36:28.235294112,2020-10-07,2020-10-07,2020-10-07,3.0,-122.34,12739.14,0.0,162.0,           ,1.0,1.0,59.0
2582,Asuminen,2020-10-08 07:41:10.588235286,2020-10-08,2020-10-08,2020-10-08,3.0,-49.22,12689.92,706.0,129.0,OKOYFIHH   ,0.0,0.0,213.0
2583,Asuminen,2020-10-09 02:30:35.294117640,2020-10-09,2020-10-09,2020-10-09,3.0,-135.17,12554.75,0.0,162.0,           ,1.0,1.0,145.0
2584,Ravintolat_kahvilat,2020-10-09 12:14:07.058823522,2020-10-09,2020-10-09,2020-10-09,3.0,-40.36,12514.39,0.0,162.0,           ,1.0,1.0,117.0
2585,Matkailu,2020-10-09 17:24:42.352941168,2020-10-09,2020-10-09,2020-10-09,3.0,-20.7,12493.69,706.0,129.0,OKOYFIHH   ,0.0,0.0,212.0
2586,Liikkuminen,2020-10-09 21:19:59.999999994,2020-10-09,2020-10-09,2020-10-09,3.0,-27.82,12465.87,0.0,162.0,           ,1.0,1.0,86.0
2587,Tulot,2020-10-09 21:57:38.823529404,2020-10-09,2020-10-09,2020-10-09,3.0,5207.54,17673.41,710.0,506.0,           ,1.0,1.0,232.0
2588,Lapset,2020-10-12 03:08:14.117647050,2020-10-12,2020-10-12,2020-10-12,3.0,-56.36,17617.05,706.0,129.0,OKOYFIHH   ,0.0,0.0,213.0
2589,Ruoka_paivittaistavarakauppa,2020-10-12 03:45:52.941176460,2020-10-12,2020-10-12,2020-10-12,3.0,-11.47,17605.58,0.0,162.0,           ,1.0,1.0,101.0
2590,Liikkuminen,2020-10-12 08:18:49.411764696,2020-10-12,2020-10-12,2020-10-12,3.0,-46.92,17558.66,0.0,162.0,           ,1.0,1.0,117.0
2591,Ruoka_paivittaistavarakauppa,2020-10-12 12:51:45.882352932,2020-10-12,2020-10-12,2020-10-12,3.0,-2.74,17555.92,0.0,162.0,           ,1.0,1.0,96.0
2592,Ruoka_paivittaistavarakauppa,2020-10-12 13:29:24.705882342,2020-10-12,2020-10-12,2020-10-12,3.0,-2.41,17553.51,0.0,162.0,           ,1.0,1.0,86.0
2593,Ruoka_paivittaistavarakauppa,2020-10-12 18:02:21.176470578,2020-10-12,2020-10-12,2020-10-12,3.0,-62.12,17491.39,0.0,162.0,           ,1.0,1.0,105.0
2594,Ruoka_paivittaistavarakauppa,2020-10-12 22:35:17.647058814,2020-10-12,2020-10-12,2020-10-12,3.0,-20.06,17471.33,0.0,162.0,           ,1.0,1.0,113.0
2595,Ravintolat_kahvilat,2020-10-12 23:12:56.470588224,2020-10-12,2020-10-12,2020-10-12,3.0,-7.62,17463.71,0.0,162.0,           ,1.0,1.0,105.0
2596,Liikkuminen,2020-10-13 18:39:59.999999988,2020-10-13,2020-10-13,2020-10-13,3.0,-63.65,17400.06,0.0,162.0,           ,1.0,1.0,88.0
2597,Liikkuminen,2020-10-15 04:23:31.764705870,2020-10-15,2020-10-15,2020-10-15,3.0,-48.01,17352.05,0.0,162.0,           ,1.0,1.0,146.0
2598,Saastot_sijoitukset,2020-10-15 08:56:28.235294106,2020-10-15,2020-10-15,2020-10-15,3.0,-42.87,17309.18,0.0,162.0,           ,1.0,1.0,94.0
2599,Muut,2020-10-15 14:07:03.529411752,2020-10-15,2020-10-15,2020-10-15,3.0,-1.89,17307.29,0.0,103.0,           ,0.0,1.0,0.0
2600,Ravintolat_kahvilat,2020-10-15 23:50:35.294117634,2020-10-15,2020-10-15,2020-10-15,3.0,-11.12,17296.17,0.0,162.0,           ,1.0,1.0,124.0
2601,Ruoka_paivittaistavarakauppa,2020-10-16 05:01:10.588235280,2020-10-16,2020-10-16,2020-10-16,3.0,-4.28,17291.89,0.0,162.0,           ,1.0,1.0,166.0
2602,Tulot,2020-10-16 09:34:07.058823516,2020-10-16,2020-10-16,2020-10-16,3.0,961.82,18253.71,710.0,506.0,           ,1.0,1.0,230.0
2603,Ruoka_paivittaistavarakauppa,2020-10-16 19:17:38.823529398,2020-10-16,2020-10-16,2020-10-16,3.0,-6.39,18247.32,0.0,162.0,           ,1.0,1.0,131.0
2604,Tulot,2020-10-19 00:28:14.117647044,2020-10-19,2020-10-19,2020-10-19,3.0,414.45,18661.77,710.0,506.0,           ,1.0,1.0,224.0
2605,Muut,2020-10-19 05:38:49.411764690,2020-10-19,2020-10-19,2020-10-19,3.0,-8.96,18652.81,0.0,162.0,           ,1.0,1.0,107.0
2606,Luokittelemattomat,2020-10-19 10:11:45.882352926,2020-10-19,2020-10-19,2020-10-19,3.0,-8.5,18644.31,0.0,162.0,           ,1.0,1.0,68.0
2607,Ravintolat_kahvilat,2020-10-19 14:44:42.352941162,2020-10-19,2020-10-19,2020-10-19,3.0,-82.41,18561.9,0.0,162.0,           ,1.0,1.0,71.0
2608,Muut,2020-10-19 15:22:21.176470572,2020-10-19,2020-10-19,2020-10-19,3.0,-70.83,18491.07,0.0,163.0,           ,1.0,1.0,173.0
2609,Shoppailu,2020-10-19 19:55:17.647058808,2020-10-19,2020-10-19,2020-10-19,3.0,-32.59,18458.48,0.0,162.0,           ,1.0,1.0,88.0
2610,Luottojen_maksut,2020-10-19 20:32:56.470588218,2020-10-19,2020-10-19,2020-10-19,3.0,-74.21,18384.27,706.0,129.0,OKOYFIHH   ,0.0,0.0,214.0
2611,Liikkuminen,2020-10-20 01:05:52.941176454,2020-10-20,2020-10-20,2020-10-20,3.0,-12.64,18371.63,0.0,162.0,           ,1.0,1.0,53.0
2612,Saastot_sijoitukset,2020-10-20 10:49:24.705882336,2020-10-20,2020-10-23,2020-10-20,3.0,-26.57,18345.06,0.0,162.0,           ,1.0,1.0,53.0
2613,Luokittelemattomat,2020-10-21 06:16:28.235294100,2020-10-21,2020-10-22,2020-10-21,3.0,-539.54,17805.52,0.0,106.0,NDEAFIHH   ,1.0,0.0,36.0
2614,Liikkuminen,2020-10-21 16:37:38.823529392,2020-10-21,2020-10-21,2020-10-21,3.0,-10.51,17795.01,0.0,162.0,           ,1.0,1.0,167.0
2615,Ruoka_paivittaistavarakauppa,2020-10-21 21:10:35.294117628,2020-10-21,2020-10-21,2020-10-21,3.0,-15.84,17779.17,0.0,162.0,           ,1.0,1.0,71.0
2616,Muut,2020-10-22 11:27:03.529411746,2020-10-22,2020-10-22,2020-10-21,3.0,-742.97,17036.2,0.0,163.0,           ,1.0,1.0,174.0
2617,Shoppailu,2020-10-23 01:43:31.764705864,2020-10-23,2020-10-23,2020-10-23,3.0,132.0,17168.2,0.0,505.0,           ,1.0,1.0,186.0
2618,Harrastukset,2020-10-23 02:21:10.588235274,2020-10-23,2020-10-23,2020-10-23,3.0,-11.01,17157.19,0.0,162.0,           ,1.0,1.0,105.0
2619,Asuminen,2020-10-23 06:54:07.058823510,2020-10-23,2020-10-23,2020-10-23,3.0,-21.72,17135.47,0.0,162.0,           ,1.0,1.0,111.0
2620,Ruoka_paivittaistavarakauppa,2020-10-23 12:04:42.352941156,2020-10-23,2020-10-23,2020-10-23,3.0,-18.16,17117.31,0.0,162.0,           ,1.0,1.0,72.0
2621,Matkailu,2020-10-23 15:59:59.999999982,2020-10-23,2020-10-23,2020-10-23,3.0,-69.0,17048.31,0.0,106.0,OKOYFIHH   ,0.0,0.0,8.0
2622,Muut,2020-10-24 07:31:45.882352920,2020-10-24,2020-10-24,2020-10-24,3.0,-638.95,16409.36,0.0,163.0,           ,1.0,1.0,175.0
2623,Liikkuminen,2020-10-26 02:58:49.411764684,2020-10-26,2020-10-26,2020-10-26,3.0,-33.78,16375.58,0.0,162.0,           ,1.0,1.0,65.0
2624,Ruoka_paivittaistavarakauppa,2020-10-26 13:19:59.999999976,2020-10-26,2020-10-26,2020-10-26,3.0,-39.13,16336.45,0.0,162.0,           ,1.0,1.0,130.0
2625,Shoppailu,2020-10-26 17:15:17.647058802,2020-10-26,2020-10-26,2020-10-26,3.0,-16.85,16319.6,0.0,162.0,           ,1.0,1.0,87.0
2626,Luottojen_maksut,2020-10-26 22:25:52.941176448,2020-10-26,2020-10-26,2020-10-26,3.0,-29.99,16289.61,0.0,106.0,OKOYFIHH   ,1.0,0.0,8.0
2627,Muut,2020-10-27 08:09:24.705882330,2020-10-27,2020-10-27,2020-10-27,3.0,-149.64,16139.97,0.0,163.0,           ,1.0,1.0,173.0
2628,Ravintolat_kahvilat,2020-10-27 21:48:14.117647038,2020-10-27,2020-10-27,2020-10-27,3.0,-19.0,16120.97,0.0,162.0,           ,1.0,1.0,82.0
2629,Asuminen,2020-10-28 03:36:28.235294094,2020-10-28,2020-10-28,2020-10-28,3.0,-17.35,16103.62,706.0,129.0,OKOYFIHH   ,0.0,0.0,212.0
2630,Luokittelemattomat,2020-10-28 04:14:07.058823504,2020-10-28,2020-10-28,2020-10-28,3.0,-110.75,15992.87,0.0,162.0,           ,1.0,1.0,94.0
2631,Muut,2020-10-28 12:42:21.176470566,2020-10-28,2020-10-28,2020-10-28,3.0,-25.4,15967.47,0.0,163.0,           ,1.0,1.0,176.0
2632,Muut,2020-10-28 17:52:56.470588212,2020-10-28,2020-10-28,2020-10-28,3.0,-89.95,15877.52,0.0,163.0,           ,1.0,1.0,173.0
2633,Ruoka_paivittaistavarakauppa,2020-10-28 23:03:31.764705858,2020-10-28,2020-10-28,2020-10-28,3.0,-4.1,15873.42,0.0,162.0,           ,1.0,1.0,146.0
2634,Luokittelemattomat,2020-10-29 08:47:03.529411740,2020-10-29,2020-10-29,2020-10-29,3.0,-61.31,15812.11,702.0,106.0,           ,1.0,1.0,203.0
2635,Liikkuminen,2020-10-29 13:57:38.823529386,2020-10-29,2020-10-29,2020-10-29,3.0,-4.48,15807.63,0.0,162.0,           ,1.0,1.0,156.0
2636,Liikkuminen,2020-10-30 09:24:42.352941150,2020-10-30,2020-10-30,2020-10-30,3.0,-106.4,15701.23,0.0,162.0,           ,1.0,1.0,151.0
2637,Matkailu,2020-10-30 18:30:35.294117622,2020-10-30,2020-10-30,2020-10-30,3.0,-164.84,15536.39,0.0,106.0,OKOYFIHH   ,0.0,0.0,12.0
2638,Ruoka_paivittaistavarakauppa,2020-10-30 19:08:14.117647032,2020-10-30,2020-10-30,2020-10-30,3.0,-13.17,15523.22,0.0,162.0,           ,1.0,1.0,53.0
2639,Liikkuminen,2020-10-30 23:41:10.588235268,2020-10-30,2020-10-30,2020-10-30,3.0,-25.67,15497.55,0.0,162.0,           ,1.0,1.0,105.0
2640,Muut,2020-11-01 07:52:07.868852459,2020-11-01,2020-11-01,2020-11-01,3.0,-58.06,15439.49,0.0,163.0,           ,1.0,1.0,175.0
2641,Ruoka_paivittaistavarakauppa,2020-11-02 07:28:31.475409836,2020-11-02,2020-11-02,2020-11-02,3.0,-16.62,15422.87,0.0,162.0,           ,1.0,1.0,169.0
2642,Tulot,2020-11-02 15:20:39.344262295,2020-11-02,2020-11-02,2020-11-02,3.0,6516.5,21939.37,0.0,505.0,           ,1.0,1.0,190.0
2643,Ruoka_paivittaistavarakauppa,2020-11-02 15:44:15.737704918,2020-11-02,2020-11-02,2020-11-02,3.0,-20.39,21918.98,0.0,162.0,           ,1.0,1.0,160.0
2644,Ravintolat_kahvilat,2020-11-02 23:12:47.213114754,2020-11-02,2020-11-02,2020-11-02,3.0,-6.74,21912.24,0.0,162.0,           ,1.0,1.0,50.0
2645,Ravintolat_kahvilat,2020-11-02 23:36:23.606557377,2020-11-02,2020-11-02,2020-11-02,3.0,-2.15,21910.09,0.0,162.0,           ,1.0,1.0,78.0
2646,Ruoka_paivittaistavarakauppa,2020-11-03 07:04:55.081967213,2020-11-03,2020-11-03,2020-11-03,3.0,-23.55,21886.54,0.0,162.0,           ,1.0,1.0,64.0
2647,Asuminen,2020-11-03 14:57:02.950819672,2020-11-03,2020-11-03,2020-11-03,3.0,-716.94,21169.6,0.0,162.0,           ,1.0,1.0,121.0
2648,Asuminen,2020-11-03 22:49:10.819672131,2020-11-03,2020-11-03,2020-11-03,3.0,-64.87,21104.73,0.0,162.0,           ,1.0,1.0,94.0
2649,Luokittelemattomat,2020-11-04 06:17:42.295081967,2020-11-04,2020-11-04,2020-11-04,3.0,-47.0,21057.73,0.0,162.0,           ,1.0,1.0,120.0
2650,Ruoka_paivittaistavarakauppa,2020-11-04 06:41:18.688524590,2020-11-04,2020-11-04,2020-11-04,3.0,-11.79,21045.94,0.0,162.0,           ,1.0,1.0,68.0
2651,Liikkuminen,2020-11-04 14:09:50.163934426,2020-11-04,2020-11-04,2020-11-04,3.0,-117.05,20928.89,0.0,162.0,           ,1.0,1.0,110.0
2652,Muut,2020-11-04 14:33:26.557377049,2020-11-04,2020-11-04,2020-11-04,3.0,-100.97,20827.92,0.0,163.0,           ,1.0,1.0,173.0
2653,Terveys,2020-11-04 22:25:34.426229508,2020-11-04,2020-11-04,2020-11-04,3.0,246.75,21074.67,0.0,500.0,OKOYFIHH   ,1.0,0.0,185.0
2654,Tulot,2020-11-05 22:01:58.032786885,2020-11-05,2020-11-06,2020-11-05,3.0,573.25,21647.92,710.0,588.0,           ,0.0,1.0,233.0
2655,Shoppailu,2020-11-06 05:30:29.508196721,2020-11-06,2020-11-06,2020-11-06,3.0,-52.57,21595.35,0.0,162.0,           ,1.0,1.0,68.0
2656,Liikkuminen,2020-11-06 05:54:05.901639344,2020-11-06,2020-11-06,2020-11-06,3.0,-205.27,21390.08,0.0,106.0,OKOYFIHH   ,0.0,0.0,8.0
2657,Luottojen_maksut,2020-11-06 13:46:13.770491803,2020-11-06,2020-11-06,2020-11-06,3.0,-13.79,21376.29,0.0,106.0,OKOYFIHH   ,0.0,0.0,8.0
2658,Liikkuminen,2020-11-06 21:38:21.639344262,2020-11-06,2020-11-06,2020-11-06,3.0,-28.6,21347.69,0.0,106.0,OKOYFIHH   ,0.0,0.0,30.0
2659,Tulot,2020-11-07 13:22:37.377049180,2020-11-07,2020-11-07,2020-11-07,3.0,709.38,22057.07,0.0,505.0,           ,1.0,1.0,189.0
2660,Muut,2020-11-07 21:14:45.245901639,2020-11-07,2020-11-07,2020-11-07,3.0,-347.91,21709.16,0.0,163.0,           ,1.0,1.0,173.0
2661,Muut,2020-11-08 20:03:56.065573770,2020-11-08,2020-11-08,2020-11-08,3.0,-142.85,21566.31,0.0,163.0,           ,1.0,1.0,174.0
2662,Ruoka_paivittaistavarakauppa,2020-11-09 04:43:16.721311475,2020-11-09,2020-11-09,2020-11-09,3.0,-23.59,21542.72,0.0,162.0,           ,1.0,1.0,43.0
2663,Hyvinvointijakauneus,2020-11-09 05:06:53.114754098,2020-11-09,2020-11-09,2020-11-09,3.0,-24.51,21518.21,0.0,162.0,           ,1.0,1.0,150.0
2664,Harrastukset,2020-11-09 12:35:24.590163934,2020-11-09,2020-11-09,2020-11-09,3.0,-11.11,21507.1,0.0,162.0,           ,1.0,1.0,64.0
2665,Lapset,2020-11-09 12:59:00.983606557,2020-11-09,2020-11-09,2020-11-09,3.0,-39.21,21467.89,0.0,162.0,           ,1.0,1.0,102.0
2666,Ravintolat_kahvilat,2020-11-09 20:27:32.459016393,2020-11-09,2020-11-09,2020-11-09,3.0,-6.41,21461.48,0.0,162.0,           ,1.0,1.0,64.0
2667,Liikkuminen,2020-11-09 20:51:08.852459016,2020-11-09,2020-11-09,2020-11-09,3.0,-4.96,21456.52,0.0,162.0,           ,1.0,1.0,171.0
2668,Ruoka_paivittaistavarakauppa,2020-11-10 04:19:40.327868852,2020-11-10,2020-11-10,2020-11-10,3.0,-8.06,21448.46,0.0,162.0,           ,1.0,1.0,71.0
2669,Liikkuminen,2020-11-10 11:48:11.803278688,2020-11-10,2020-11-10,2020-11-10,3.0,-37.1,21411.36,706.0,129.0,OKOYFIHH   ,0.0,0.0,211.0
2670,Ruoka_paivittaistavarakauppa,2020-11-10 12:11:48.196721311,2020-11-10,2020-11-10,2020-11-10,3.0,-6.7,21404.66,0.0,162.0,           ,1.0,1.0,124.0
2671,Ruoka_paivittaistavarakauppa,2020-11-11 19:40:19.672131147,2020-11-11,2020-11-12,2020-11-11,3.0,-3.02,21401.64,0.0,162.0,           ,1.0,1.0,126.0
2672,Ruoka_paivittaistavarakauppa,2020-11-12 03:32:27.540983606,2020-11-12,2020-11-12,2020-11-12,3.0,-5.11,21396.53,0.0,162.0,           ,1.0,1.0,143.0
2673,Tulot,2020-11-12 03:56:03.934426229,2020-11-12,2020-11-12,2020-11-12,3.0,930.18,22326.71,701.0,520.0,           ,1.0,1.0,198.0
2674,Liikkuminen,2020-11-12 11:00:59.016393442,2020-11-12,2020-11-12,2020-11-12,3.0,-74.0,22252.71,0.0,162.0,           ,1.0,1.0,123.0
2675,Shoppailu,2020-11-12 11:24:35.409836065,2020-11-12,2020-11-12,2020-11-12,3.0,-36.1,22216.61,0.0,162.0,           ,1.0,1.0,68.0
2676,Liikkuminen,2020-11-12 18:53:06.885245901,2020-11-12,2020-11-12,2020-11-12,3.0,-108.98,22107.63,0.0,162.0,           ,1.0,1.0,155.0
2677,Asuminen,2020-11-12 19:16:43.278688524,2020-11-12,2020-11-12,2020-11-12,3.0,-52.65,22054.98,0.0,162.0,           ,1.0,1.0,101.0
2678,Asuminen,2020-11-13 02:45:14.754098360,2020-11-13,2020-11-13,2020-11-13,3.0,-72.71,21982.27,0.0,162.0,           ,1.0,1.0,44.0
2679,Luokittelemattomat,2020-11-13 18:05:54.098360655,2020-11-13,2020-11-13,2020-11-13,3.0,-6.79,21975.48,0.0,106.0,OKOYFIHH   ,1.0,0.0,30.0
2680,Muut,2020-11-13 18:29:30.491803278,2020-11-13,2020-11-13,2020-11-13,3.0,-7.04,21968.44,0.0,163.0,           ,1.0,1.0,174.0
2681,Muut,2020-11-15 10:13:46.229508196,2020-11-15,2020-11-16,2020-11-15,3.0,-2.04,21966.4,0.0,106.0,OKOYFIHH   ,0.0,0.0,8.0
2682,Ruoka_paivittaistavarakauppa,2020-11-16 01:58:01.967213114,2020-11-16,2020-11-16,2020-11-16,3.0,-15.21,21951.19,0.0,162.0,           ,1.0,1.0,112.0
2683,Tulot,2020-11-16 02:21:38.360655737,2020-11-16,2020-11-16,2020-11-16,3.0,3676.28,25627.47,0.0,505.0,           ,1.0,1.0,187.0
2684,Ravintolat_kahvilat,2020-11-16 03:08:51.147540983,2020-11-16,2020-11-16,2020-11-16,3.0,-8.59,25618.88,0.0,103.0,           ,1.0,1.0,0.0
2685,Asuminen,2020-11-16 09:26:33.442622950,2020-11-16,2020-11-16,2020-11-16,3.0,-170.57,25448.31,0.0,162.0,           ,1.0,1.0,124.0
2686,Saastot_sijoitukset,2020-11-16 09:50:09.836065573,2020-11-16,2020-11-16,2020-11-16,3.0,-21.09,25427.22,0.0,162.0,           ,1.0,1.0,81.0
2687,Lemmikit,2020-11-16 10:37:22.622950819,2020-11-16,2020-11-16,2020-11-16,3.0,-4.37,25422.85,0.0,162.0,           ,1.0,1.0,91.0
2688,Hyvinvointijakauneus,2020-11-16 17:18:41.311475409,2020-11-16,2020-11-16,2020-11-16,3.0,-19.95,25402.9,0.0,162.0,           ,1.0,1.0,71.0
2689,Saastot_sijoitukset,2020-11-16 17:42:17.704918032,2020-11-16,2020-11-16,2020-11-16,3.0,-38.9,25364.0,0.0,162.0,           ,1.0,1.0,106.0
2690,Ruoka_paivittaistavarakauppa,2020-11-18 01:10:49.180327868,2020-11-18,2020-11-18,2020-11-18,3.0,-4.38,25359.62,0.0,162.0,           ,1.0,1.0,53.0
2691,Liikkuminen,2020-11-18 01:34:25.573770491,2020-11-18,2020-11-18,2020-11-18,3.0,-56.18,25303.44,0.0,162.0,           ,1.0,1.0,90.0
2692,Ravintolat_kahvilat,2020-11-18 09:02:57.049180327,2020-11-18,2020-11-18,2020-11-18,3.0,-11.48,25291.96,0.0,162.0,           ,1.0,1.0,82.0
2693,Ruoka_paivittaistavarakauppa,2020-11-18 16:55:04.918032786,2020-11-18,2020-11-18,2020-11-18,3.0,-7.38,25284.58,0.0,162.0,           ,1.0,1.0,149.0
2694,Hyvinvointijakauneus,2020-11-19 00:47:12.786885245,2020-11-19,2020-11-19,2020-11-19,3.0,-17.87,25266.71,0.0,162.0,           ,1.0,1.0,125.0
2695,Ruoka_paivittaistavarakauppa,2020-11-19 08:39:20.655737704,2020-11-19,2020-11-19,2020-11-19,3.0,-82.13,25184.58,0.0,162.0,           ,1.0,1.0,81.0
2696,Kulttuuri_viihde,2020-11-19 16:31:28.524590163,2020-11-19,2020-11-19,2020-11-19,3.0,-13.28,25171.3,0.0,162.0,           ,1.0,1.0,127.0
2697,Ruoka_paivittaistavarakauppa,2020-11-20 00:23:36.393442622,2020-11-20,2020-11-20,2020-11-20,3.0,-27.35,25143.95,0.0,162.0,           ,1.0,1.0,146.0
2698,Liikkuminen,2020-11-20 07:52:07.868852458,2020-11-20,2020-11-20,2020-11-20,3.0,-4.88,25139.07,0.0,162.0,           ,1.0,1.0,99.0
2699,Ruoka_paivittaistavarakauppa,2020-11-20 08:15:44.262295081,2020-11-20,2020-11-20,2020-11-20,3.0,-11.17,25127.9,0.0,162.0,           ,1.0,1.0,94.0
2700,Ravintolat_kahvilat,2020-11-20 15:44:15.737704917,2020-11-20,2020-11-20,2020-11-20,3.0,-3.04,25124.86,0.0,162.0,           ,1.0,1.0,80.0
2701,Ruoka_paivittaistavarakauppa,2020-11-20 16:07:52.131147540,2020-11-20,2020-11-20,2020-11-20,3.0,-11.95,25112.91,0.0,162.0,           ,1.0,1.0,107.0
2702,Ruoka_paivittaistavarakauppa,2020-11-20 23:12:47.213114753,2020-11-20,2020-11-20,2020-11-20,3.0,-26.42,25086.49,0.0,162.0,           ,1.0,1.0,126.0
2703,Ruoka_paivittaistavarakauppa,2020-11-20 23:36:23.606557376,2020-11-20,2020-11-20,2020-11-17,3.0,-24.15,25062.34,0.0,162.0,           ,1.0,1.0,124.0
2704,Asuminen,2020-11-20 23:59:59.999999999,2020-11-20,2020-11-20,2020-11-20,3.0,-33.33,25029.01,0.0,162.0,           ,1.0,1.0,100.0
2705,Tulot,2020-11-23 07:04:55.081967212,2020-11-23,2020-11-23,2020-11-23,3.0,203.66,25232.67,710.0,506.0,           ,1.0,1.0,228.0
2706,Ruoka_paivittaistavarakauppa,2020-11-23 07:28:31.475409835,2020-11-23,2020-11-23,2020-11-23,3.0,-4.51,25228.16,0.0,162.0,           ,1.0,1.0,108.0
2707,Luokittelemattomat,2020-11-23 14:33:26.557377048,2020-11-23,2020-11-23,2020-11-23,3.0,-93.07,25135.09,706.0,106.0,DABAFIHH   ,1.0,0.0,204.0
2708,Luokittelemattomat,2020-11-23 14:57:02.950819671,2020-11-23,2020-11-24,2020-11-23,3.0,-19.85,25115.24,0.0,162.0,           ,1.0,1.0,104.0
2709,Ruoka_paivittaistavarakauppa,2020-11-23 15:20:39.344262294,2020-11-23,2020-11-23,2020-11-23,3.0,-61.34,25053.9,0.0,162.0,           ,1.0,1.0,88.0
2710,Ruoka_paivittaistavarakauppa,2020-11-23 22:25:34.426229507,2020-11-23,2020-11-23,2020-11-23,3.0,-20.83,25033.07,0.0,162.0,           ,1.0,1.0,132.0
2711,Ruoka_paivittaistavarakauppa,2020-11-23 22:49:10.819672130,2020-11-23,2020-11-23,2020-11-23,3.0,-9.54,25023.53,0.0,162.0,           ,1.0,1.0,147.0
2712,Matkailu,2020-11-24 06:41:18.688524589,2020-11-24,2020-11-24,2020-11-24,3.0,-656.7,24366.83,706.0,129.0,NDEAFIHH   ,0.0,0.0,215.0
2713,Ruoka_paivittaistavarakauppa,2020-11-24 22:01:58.032786884,2020-11-24,2020-11-24,2020-11-24,3.0,-26.97,24339.86,0.0,162.0,           ,1.0,1.0,83.0
2714,Liikkuminen,2020-11-25 13:46:13.770491802,2020-11-25,2020-11-25,2020-11-25,3.0,-13.67,24326.19,0.0,162.0,           ,1.0,1.0,100.0
2715,Muut,2020-11-25 14:09:50.163934425,2020-11-25,2020-11-25,2020-11-25,3.0,-493.86,23832.33,0.0,163.0,           ,1.0,1.0,173.0
2716,Ravintolat_kahvilat,2020-11-26 05:54:05.901639343,2020-11-26,2020-11-26,2020-11-26,3.0,-1.4,23830.93,0.0,162.0,           ,1.0,1.0,85.0
2717,Asuminen,2020-11-26 20:51:08.852459015,2020-11-26,2020-11-26,2020-11-26,3.0,-29.85,23801.08,0.0,162.0,           ,1.0,1.0,124.0
2718,Ravintolat_kahvilat,2020-11-26 21:38:21.639344261,2020-11-26,2020-11-26,2020-11-26,3.0,-13.47,23787.61,0.0,162.0,           ,1.0,1.0,68.0
2719,Asuminen,2020-11-27 05:06:53.114754097,2020-11-27,2020-11-27,2020-11-27,3.0,-157.77,23629.84,0.0,162.0,           ,1.0,1.0,43.0
2720,Liikkuminen,2020-11-27 05:30:29.508196720,2020-11-27,2020-11-27,2020-11-27,3.0,-66.58,23563.26,0.0,162.0,           ,1.0,1.0,44.0
2721,Luokittelemattomat,2020-11-27 06:17:42.295081966,2020-11-27,2020-11-27,2020-11-27,3.0,-8.32,23554.94,0.0,162.0,           ,1.0,1.0,81.0
2722,Ruoka_paivittaistavarakauppa,2020-11-27 13:22:37.377049179,2020-11-27,2020-11-27,2020-11-27,3.0,-3.99,23550.95,0.0,162.0,           ,1.0,1.0,53.0
2723,Ruoka_paivittaistavarakauppa,2020-11-27 21:14:45.245901638,2020-11-27,2020-11-27,2020-11-27,3.0,-1.01,23549.94,0.0,162.0,           ,1.0,1.0,113.0
2724,Muut,2020-11-30 04:19:40.327868851,2020-11-30,2020-11-30,2020-11-30,3.0,-353.68,23196.26,0.0,163.0,           ,1.0,1.0,173.0
2725,Ruoka_paivittaistavarakauppa,2020-11-30 04:43:16.721311474,2020-11-30,2020-11-30,2020-11-30,3.0,-15.85,23180.41,0.0,162.0,           ,1.0,1.0,142.0
2726,Ravintolat_kahvilat,2020-11-30 12:11:48.196721310,2020-11-30,2020-11-30,2020-11-30,3.0,-89.24,23091.17,0.0,162.0,           ,1.0,1.0,141.0
2727,Luokittelemattomat,2020-11-30 12:35:24.590163933,2020-11-30,2020-11-30,2020-11-30,3.0,-13.34,23077.83,0.0,162.0,           ,1.0,1.0,53.0
2728,Ruoka_paivittaistavarakauppa,2020-11-30 12:59:00.983606556,2020-11-30,2020-11-30,2020-11-30,3.0,-65.54,23012.29,0.0,162.0,           ,1.0,1.0,115.0
2729,Ravintolat_kahvilat,2020-11-30 20:03:56.065573769,2020-11-30,2020-11-30,2020-11-30,3.0,-2.65,23009.64,0.0,162.0,           ,1.0,1.0,59.0
2730,Luottojen_maksut,2020-11-30 20:27:32.459016392,2020-11-30,2020-11-30,2020-11-30,3.0,-607.85,22401.79,0.0,106.0,OKOYFIHH   ,0.0,0.0,18.0
2731,Asuminen,2020-12-01 09:14:32.049689440,2020-12-01,2020-12-01,2020-12-01,3.0,-34.43,22367.36,706.0,129.0,OKOYFIHH   ,0.0,0.0,211.0
2732,Tulot,2020-12-02 03:43:36.149068320,2020-12-02,2020-12-02,2020-12-02,3.0,2749.46,25116.82,701.0,520.0,           ,1.0,1.0,198.0
2733,Tulot,2020-12-02 12:58:08.198757760,2020-12-02,2020-12-02,2020-12-02,3.0,323.42,25440.24,0.0,505.0,           ,1.0,1.0,191.0
2734,Ruoka_paivittaistavarakauppa,2020-12-02 18:29:04.099378880,2020-12-02,2020-12-02,2020-12-02,3.0,-14.0,25426.24,0.0,162.0,           ,1.0,1.0,53.0
2735,Muut,2020-12-02 22:12:40.248447200,2020-12-02,2020-12-02,2020-12-02,3.0,-89.94,25336.3,0.0,163.0,           ,1.0,1.0,173.0
2736,Ruoka_paivittaistavarakauppa,2020-12-03 05:39:52.546583840,2020-12-03,2020-12-03,2020-12-03,3.0,-18.48,25317.82,0.0,162.0,           ,1.0,1.0,103.0
2737,Ruoka_paivittaistavarakauppa,2020-12-03 07:27:12.298136640,2020-12-03,2020-12-03,2020-12-03,3.0,-27.87,25289.95,0.0,162.0,           ,1.0,1.0,97.0
2738,Liikkuminen,2020-12-03 16:41:44.347826080,2020-12-03,2020-12-03,2020-12-03,3.0,-53.1,25236.85,0.0,162.0,           ,1.0,1.0,56.0
2739,Lemmikit,2020-12-04 01:56:16.397515520,2020-12-04,2020-12-04,2020-12-04,3.0,-47.41,25189.44,0.0,162.0,           ,1.0,1.0,85.0
2740,Lemmikit,2020-12-04 11:10:48.447204960,2020-12-04,2020-12-04,2020-12-04,3.0,-23.93,25165.51,0.0,162.0,           ,1.0,1.0,135.0
2741,Liikkuminen,2020-12-04 14:54:24.596273280,2020-12-04,2020-12-04,2020-12-04,3.0,-58.31,25107.2,0.0,162.0,           ,1.0,1.0,146.0
2742,Hyvinvointijakauneus,2020-12-04 20:25:20.496894400,2020-12-04,2020-12-04,2020-12-04,3.0,-13.81,25093.39,0.0,162.0,           ,1.0,1.0,152.0
2743,Ruoka_paivittaistavarakauppa,2020-12-07 00:08:56.645962720,2020-12-07,2020-12-07,2020-12-07,3.0,-14.85,25078.54,0.0,162.0,           ,1.0,1.0,108.0
2744,Ruoka_paivittaistavarakauppa,2020-12-07 03:52:32.795031040,2020-12-07,2020-12-07,2020-12-07,3.0,-39.32,25039.22,0.0,162.0,           ,1.0,1.0,122.0
2745,Saastot_sijoitukset,2020-12-07 09:23:28.695652160,2020-12-07,2020-12-07,2020-12-07,3.0,-17.25,25021.97,0.0,162.0,           ,1.0,1.0,140.0
2746,Shoppailu,2020-12-07 13:07:04.844720480,2020-12-07,2020-12-07,2020-12-07,3.0,-63.29,24958.68,0.0,162.0,           ,1.0,1.0,100.0
2747,Liikkuminen,2020-12-07 18:38:00.745341600,2020-12-07,2020-12-07,2020-12-07,3.0,-25.48,24933.2,0.0,162.0,           ,1.0,1.0,76.0
2748,Ruoka_paivittaistavarakauppa,2020-12-07 22:21:36.894409920,2020-12-07,2020-12-07,2020-12-07,3.0,-3.94,24929.26,0.0,162.0,           ,1.0,1.0,68.0
2749,Ruoka_paivittaistavarakauppa,2020-12-08 02:05:13.043478240,2020-12-08,2020-12-08,2020-12-10,3.0,-9.16,24920.1,0.0,162.0,           ,1.0,1.0,160.0
2750,Ruoka_paivittaistavarakauppa,2020-12-08 07:36:08.944099360,2020-12-08,2020-12-08,2020-12-08,3.0,-9.67,24910.43,0.0,162.0,           ,1.0,1.0,159.0
2751,Matkailu,2020-12-08 11:19:45.093167680,2020-12-08,2020-12-08,2020-12-08,3.0,-218.82,24691.61,0.0,106.0,OKOYFIHH   ,1.0,0.0,33.0
2752,Ravintolat_kahvilat,2020-12-08 16:50:40.993788800,2020-12-08,2020-12-09,2020-12-08,3.0,-196.8,24494.81,0.0,162.0,           ,1.0,1.0,138.0
2753,Saastot_sijoitukset,2020-12-08 20:34:17.142857120,2020-12-08,2020-12-08,2020-12-08,3.0,-20.51,24474.3,0.0,162.0,           ,1.0,1.0,136.0
2754,Ruoka_paivittaistavarakauppa,2020-12-09 05:48:49.192546560,2020-12-09,2020-12-09,2020-12-09,3.0,-37.3,24437.0,0.0,162.0,           ,1.0,1.0,103.0
2755,Hyvinvointijakauneus,2020-12-10 15:03:21.242236000,2020-12-10,2020-12-10,2020-12-10,3.0,-50.26,24386.74,0.0,162.0,           ,1.0,1.0,117.0
2756,Harrastukset,2020-12-10 18:46:57.391304320,2020-12-10,2020-12-10,2020-12-10,3.0,-31.81,24354.93,706.0,129.0,OKOYFIHH   ,0.0,0.0,214.0
2757,Ravintolat_kahvilat,2020-12-11 00:17:53.291925440,2020-12-11,2020-12-11,2020-12-11,3.0,-8.15,24346.78,0.0,162.0,           ,1.0,1.0,46.0
2758,Ruoka_paivittaistavarakauppa,2020-12-11 07:45:05.590062080,2020-12-11,2020-12-11,2020-12-11,3.0,-10.72,24336.06,0.0,162.0,           ,1.0,1.0,102.0
2759,Luottojen_maksut,2020-12-11 09:32:25.341614880,2020-12-11,2020-12-11,2020-12-11,3.0,-19.33,24316.73,0.0,162.0,           ,1.0,1.0,71.0
2760,Tulot,2020-12-11 13:16:01.490683200,2020-12-11,2020-12-11,2020-12-11,3.0,935.6,25252.33,0.0,505.0,           ,1.0,1.0,188.0
2761,Luokittelemattomat,2020-12-12 22:30:33.540372640,2020-12-12,2020-12-12,2020-12-12,3.0,-66.65,25185.68,0.0,106.0,OKOYFIHH   ,1.0,0.0,35.0
2762,Luokittelemattomat,2020-12-13 04:01:29.440993760,2020-12-13,2020-12-13,2020-12-13,3.0,-1125.57,24060.11,0.0,106.0,OKOYFIHH   ,1.0,0.0,25.0
2763,Ruoka_paivittaistavarakauppa,2020-12-14 02:14:09.689440960,2020-12-14,2020-12-16,2020-12-14,3.0,-6.2,24053.91,0.0,162.0,           ,1.0,1.0,86.0
2764,Matkailu,2020-12-14 11:28:41.739130400,2020-12-14,2020-12-14,2020-12-14,3.0,-9.33,24044.58,0.0,162.0,           ,1.0,1.0,149.0
2765,Terveys,2020-12-14 16:59:37.639751520,2020-12-14,2020-12-14,2020-12-14,3.0,-12.07,24032.51,0.0,162.0,           ,1.0,1.0,44.0
2766,Liikkuminen,2020-12-14 20:43:13.788819840,2020-12-14,2020-12-14,2020-12-14,3.0,-10.3,24022.21,0.0,162.0,           ,1.0,1.0,117.0
2767,Asuminen,2020-12-15 05:57:45.838509280,2020-12-15,2020-12-15,2020-12-15,3.0,-79.01,23943.2,706.0,129.0,NDEAFIHH   ,0.0,0.0,211.0
2768,Ruoka_paivittaistavarakauppa,2020-12-15 15:12:17.888198720,2020-12-15,2020-12-15,2020-12-15,3.0,-23.17,23920.03,0.0,162.0,           ,1.0,1.0,103.0
2769,Saastot_sijoitukset,2020-12-16 00:26:49.937888160,2020-12-16,2020-12-16,2020-12-16,3.0,-48.85,23871.18,0.0,162.0,           ,1.0,1.0,114.0
2770,Ruoka_paivittaistavarakauppa,2020-12-16 04:10:26.086956480,2020-12-16,2020-12-18,2020-12-16,3.0,-2.65,23868.53,0.0,162.0,           ,1.0,1.0,52.0
2771,Ravintolat_kahvilat,2020-12-16 09:41:21.987577600,2020-12-16,2020-12-16,2020-12-16,3.0,-36.3,23832.23,0.0,162.0,           ,1.0,1.0,106.0
2772,Ruoka_paivittaistavarakauppa,2020-12-16 18:55:54.037267040,2020-12-16,2020-12-16,2020-12-16,3.0,-40.43,23791.8,0.0,162.0,           ,1.0,1.0,44.0
2773,Ruoka_paivittaistavarakauppa,2020-12-17 13:24:58.136645920,2020-12-17,2020-12-17,2020-12-17,3.0,-10.74,23781.06,0.0,162.0,           ,1.0,1.0,106.0
2774,Asuminen,2020-12-17 22:39:30.186335360,2020-12-17,2020-12-17,2020-12-17,3.0,-10.59,23770.47,706.0,129.0,OKOYFIHH   ,0.0,0.0,215.0
2775,Luottojen_maksut,2020-12-18 07:54:02.236024800,2020-12-18,2020-12-18,2020-12-18,3.0,-53.44,23717.03,0.0,106.0,OKOYFIHH   ,0.0,0.0,11.0
2776,Ravintolat_kahvilat,2020-12-18 11:37:38.385093120,2020-12-18,2020-12-18,2020-12-18,3.0,-86.66,23630.37,0.0,162.0,           ,1.0,1.0,146.0
2777,Ruoka_paivittaistavarakauppa,2020-12-18 17:08:34.285714240,2020-12-18,2020-12-18,2020-12-18,3.0,-14.12,23616.25,0.0,162.0,           ,1.0,1.0,160.0
2778,Ruoka_paivittaistavarakauppa,2020-12-18 20:52:10.434782560,2020-12-18,2020-12-18,2020-12-18,3.0,-16.37,23599.88,0.0,162.0,           ,1.0,1.0,123.0
2779,Muut,2020-12-21 00:35:46.583850880,2020-12-21,2020-12-21,2020-12-21,3.0,-9.79,23590.09,0.0,162.0,           ,1.0,1.0,112.0
2780,Shoppailu,2020-12-21 02:23:06.335403680,2020-12-21,2020-12-21,2020-12-21,3.0,-36.77,23553.32,0.0,162.0,           ,1.0,1.0,130.0
2781,Ravintolat_kahvilat,2020-12-21 06:06:42.484472000,2020-12-21,2020-12-21,2020-12-21,3.0,-38.46,23514.86,0.0,162.0,           ,1.0,1.0,165.0
2782,Ruoka_paivittaistavarakauppa,2020-12-21 08:02:58.881987520,2020-12-21,2020-12-21,2020-12-21,3.0,-11.21,23503.65,0.0,162.0,           ,1.0,1.0,156.0
2783,Ruoka_paivittaistavarakauppa,2020-12-21 09:50:18.633540320,2020-12-21,2020-12-22,2020-12-21,3.0,-6.49,23497.16,0.0,162.0,           ,1.0,1.0,76.0
2784,Matkailu,2020-12-21 15:21:14.534161440,2020-12-21,2020-12-21,2020-12-21,3.0,-14.16,23483.0,0.0,162.0,           ,1.0,1.0,116.0
2785,Ruoka_paivittaistavarakauppa,2020-12-21 19:04:50.683229760,2020-12-21,2020-12-21,2020-12-21,3.0,-17.01,23465.99,0.0,162.0,           ,1.0,1.0,82.0
2786,Ruoka_paivittaistavarakauppa,2020-12-22 22:48:26.832298080,2020-12-22,2020-12-22,2020-12-22,3.0,-57.93,23408.06,0.0,162.0,           ,1.0,1.0,113.0
2787,Ruoka_paivittaistavarakauppa,2020-12-23 13:33:54.782608640,2020-12-23,2020-12-23,2020-12-23,3.0,-1.69,23406.37,0.0,162.0,           ,1.0,1.0,156.0
2788,Ruoka_paivittaistavarakauppa,2020-12-24 02:32:02.981366400,2020-12-24,2020-12-24,2020-12-24,3.0,-71.8,23334.57,0.0,162.0,           ,1.0,1.0,68.0
2789,Muut,2020-12-24 04:19:22.732919200,2020-12-24,2020-12-24,2020-12-24,3.0,-6.52,23328.05,0.0,162.0,           ,1.0,1.0,135.0
2790,Ravintolat_kahvilat,2020-12-24 06:15:39.130434720,2020-12-24,2020-12-24,2020-12-24,3.0,-3.68,23324.37,0.0,162.0,           ,1.0,1.0,68.0
2791,Kulttuuri_viihde,2020-12-24 11:46:35.031055840,2020-12-24,2020-12-24,2020-12-24,3.0,-12.39,23311.98,0.0,162.0,           ,1.0,1.0,72.0
2792,Liikkuminen,2020-12-24 15:30:11.180124160,2020-12-24,2020-12-24,2020-12-24,3.0,-13.4,23298.58,0.0,162.0,           ,1.0,1.0,165.0
2793,Liikkuminen,2020-12-24 17:17:30.931676960,2020-12-24,2020-12-24,2020-12-24,3.0,-35.66,23262.92,0.0,162.0,           ,1.0,1.0,68.0
2794,Luokittelemattomat,2020-12-24 21:01:07.080745280,2020-12-24,2020-12-24,2020-12-24,3.0,-166.13,23096.79,706.0,129.0,NDEAFIHH   ,0.0,0.0,212.0
2795,Ruoka_paivittaistavarakauppa,2020-12-25 09:59:15.279503040,2020-12-25,2020-12-25,2020-12-25,3.0,-46.9,23049.89,0.0,162.0,           ,1.0,1.0,109.0
2796,Ruoka_paivittaistavarakauppa,2020-12-28 00:44:43.229813600,2020-12-28,2020-12-28,2020-12-28,3.0,-22.51,23027.38,0.0,162.0,           ,1.0,1.0,44.0
2797,Liikkuminen,2020-12-28 04:28:19.378881920,2020-12-28,2020-12-28,2020-12-28,3.0,-6.81,23020.57,0.0,162.0,           ,1.0,1.0,44.0
2798,Ruoka_paivittaistavarakauppa,2020-12-28 08:11:55.527950240,2020-12-28,2020-12-28,2020-12-28,3.0,-15.02,23005.55,0.0,162.0,           ,1.0,1.0,107.0
2799,Asuminen,2020-12-28 13:42:51.428571360,2020-12-28,2020-12-28,2020-12-28,3.0,-192.57,22812.98,0.0,162.0,           ,1.0,1.0,132.0
2800,Terveys,2020-12-28 15:39:07.826086880,2020-12-28,2020-12-28,2020-12-28,3.0,-13.99,22798.99,0.0,162.0,           ,1.0,1.0,143.0
2801,Ruoka_paivittaistavarakauppa,2020-12-28 17:26:27.577639680,2020-12-28,2020-12-28,2020-12-28,3.0,-7.64,22791.35,0.0,162.0,           ,1.0,1.0,51.0
2802,Asuminen,2020-12-28 19:13:47.329192480,2020-12-28,2020-12-28,2020-12-28,3.0,-37.92,22753.43,706.0,129.0,OKOYFIHH   ,0.0,0.0,211.0
2803,Ravintolat_kahvilat,2020-12-28 21:10:03.726708000,2020-12-28,2020-12-30,2020-12-28,3.0,-1.72,22751.71,0.0,162.0,           ,1.0,1.0,167.0
2804,Muut,2020-12-28 22:57:23.478260800,2020-12-28,2020-12-28,2020-12-28,3.0,-16.98,22734.73,0.0,162.0,           ,1.0,1.0,124.0
2805,Harrastukset,2020-12-29 02:40:59.627329120,2020-12-29,2020-12-29,2020-12-29,3.0,-12.28,22722.45,706.0,129.0,OKOYFIHH   ,0.0,0.0,214.0
2806,Kulttuuri_viihde,2020-12-29 06:24:35.776397440,2020-12-29,2020-12-29,2020-12-29,3.0,-31.65,22690.8,0.0,162.0,           ,1.0,1.0,148.0
2807,Ruoka_paivittaistavarakauppa,2020-12-29 11:55:31.677018560,2020-12-29,2020-12-29,2020-12-29,3.0,-58.99,22631.81,0.0,162.0,           ,1.0,1.0,129.0
2808,Liikkuminen,2020-12-30 10:08:11.925465760,2020-12-30,2020-12-30,2020-12-30,3.0,-28.94,22602.87,0.0,162.0,           ,1.0,1.0,68.0
2809,Liikkuminen,2020-12-30 19:22:43.975155200,2020-12-30,2020-12-30,2020-12-30,3.0,-108.75,22494.12,0.0,162.0,           ,1.0,1.0,124.0
2810,Luokittelemattomat,2020-12-31 00:53:39.875776320,2020-12-31,2020-12-31,2020-12-31,3.0,-16.5,22477.62,0.0,162.0,           ,1.0,1.0,108.0
2811,Ruoka_paivittaistavarakauppa,2019-01-01 00:00:00.000000000,2019-01-01,2019-01-01,2019-01-01,4.0,-38.84,9947.41,0.0,162.0,           ,1.0,1.0,181.0
2812,Ruoka_paivittaistavarakauppa,2019-01-03 03:18:37.241379310,2019-01-03,2019-01-03,2019-01-03,4.0,-12.5,9934.91,0.0,162.0,           ,1.0,1.0,56.0
2813,Liikkuminen,2019-01-07 06:37:14.482758620,2019-01-07,2019-01-07,2019-01-07,4.0,-107.7,9827.21,0.0,162.0,           ,1.0,1.0,133.0
2814,Ruoka_paivittaistavarakauppa,2019-01-07 09:55:51.724137930,2019-01-07,2019-01-07,2019-01-07,4.0,-22.98,9804.23,0.0,162.0,           ,1.0,1.0,132.0
2815,Ruoka_paivittaistavarakauppa,2019-01-10 13:14:28.965517240,2019-01-10,2019-01-10,2019-01-10,4.0,-18.3,9785.93,0.0,162.0,           ,1.0,1.0,124.0
2816,Luokittelemattomat,2019-01-11 16:33:06.206896550,2019-01-11,2019-01-11,2019-01-11,4.0,-8.22,9777.71,0.0,162.0,           ,1.0,1.0,119.0
2817,Lemmikit,2019-01-14 19:51:43.448275860,2019-01-14,2019-01-14,2019-01-14,4.0,-13.62,9764.09,0.0,162.0,           ,1.0,1.0,133.0
2818,Luokittelemattomat,2019-01-17 23:10:20.689655170,2019-01-17,2019-01-17,2019-01-17,4.0,-5.71,9758.38,0.0,162.0,           ,1.0,1.0,69.0
2819,Ruoka_paivittaistavarakauppa,2019-01-18 02:28:57.931034480,2019-01-18,2019-01-18,2019-01-18,4.0,-30.32,9728.06,0.0,162.0,           ,1.0,1.0,116.0
2820,Tulot,2019-01-18 05:47:35.172413790,2019-01-18,2019-01-18,2019-01-18,4.0,101.39,9829.45,701.0,506.0,           ,1.0,1.0,217.0
2821,Asuminen,2019-01-21 09:06:12.413793100,2019-01-21,2019-01-21,2019-01-21,4.0,-9.52,9819.93,0.0,162.0,           ,1.0,1.0,116.0
2822,Ruoka_paivittaistavarakauppa,2019-01-25 12:24:49.655172410,2019-01-25,2019-01-25,2019-01-25,4.0,-3.65,9816.28,0.0,162.0,           ,1.0,1.0,149.0
2823,Muut,2019-01-25 15:43:26.896551720,2019-01-25,2019-01-25,2019-01-25,4.0,-65.7,9750.58,0.0,162.0,           ,1.0,1.0,142.0
2824,Ravintolat_kahvilat,2019-01-28 19:02:04.137931030,2019-01-28,2019-01-28,2019-01-28,4.0,-4.37,9746.21,0.0,162.0,           ,1.0,1.0,121.0
2825,Asuminen,2019-01-29 22:20:41.379310340,2019-01-29,2019-01-29,2019-01-28,4.0,-175.51,9570.7,0.0,162.0,           ,1.0,1.0,64.0
2826,Ruoka_paivittaistavarakauppa,2019-02-01 15:06:04.044943820,2019-02-01,2019-02-01,2019-02-01,4.0,-17.65,9553.05,0.0,162.0,           ,1.0,1.0,111.0
2827,Ravintolat_kahvilat,2019-02-04 03:30:20.224719100,2019-02-04,2019-02-04,2019-02-04,4.0,-100.03,9453.02,706.0,129.0,OKOYFIHH   ,0.0,0.0,231.0
2828,Liikkuminen,2019-02-04 06:12:08.089887640,2019-02-04,2019-02-04,2019-02-04,4.0,-177.83,9275.19,0.0,162.0,           ,1.0,1.0,127.0
2829,Ravintolat_kahvilat,2019-02-04 12:24:16.179775280,2019-02-04,2019-02-04,2019-02-04,4.0,-15.41,9259.78,0.0,162.0,           ,1.0,1.0,70.0
2830,Muut,2019-02-04 18:36:24.269662920,2019-02-04,2019-02-04,2019-02-04,4.0,-487.17,8772.61,0.0,105.0,OKOYFIHH   ,1.0,0.0,5.0
2831,Asuminen,2019-02-04 21:18:12.134831460,2019-02-04,2019-02-05,2019-02-04,4.0,-37.47,8735.14,706.0,129.0,OKOYFIHH   ,0.0,0.0,228.0
2832,Liikkuminen,2019-02-05 00:48:32.359550560,2019-02-05,2019-02-05,2019-02-05,4.0,-12.63,8722.51,0.0,162.0,           ,1.0,1.0,93.0
2833,Muut,2019-02-05 09:42:28.314606740,2019-02-05,2019-02-07,2019-02-05,4.0,-250.39,8472.12,0.0,163.0,           ,1.0,1.0,190.0
2834,Ruoka_paivittaistavarakauppa,2019-02-05 15:54:36.404494380,2019-02-05,2019-02-05,2019-02-05,4.0,-2.97,8469.15,0.0,162.0,           ,1.0,1.0,53.0
2835,Ravintolat_kahvilat,2019-02-07 07:00:40.449438200,2019-02-07,2019-02-07,2019-02-07,4.0,-2.53,8466.62,0.0,162.0,           ,1.0,1.0,121.0
2836,Asuminen,2019-02-07 22:06:44.494382020,2019-02-07,2019-02-07,2019-02-07,4.0,-206.09,8260.53,0.0,162.0,           ,1.0,1.0,106.0
2837,Harrastukset,2019-02-08 04:18:52.584269660,2019-02-08,2019-02-08,2019-02-08,4.0,-97.8,8162.73,706.0,129.0,OKOYFIHH   ,0.0,0.0,227.0
2838,Ruoka_paivittaistavarakauppa,2019-02-08 13:12:48.539325840,2019-02-08,2019-02-08,2019-02-08,4.0,-9.81,8152.92,0.0,162.0,           ,1.0,1.0,117.0
2839,Luokittelemattomat,2019-02-08 19:24:56.629213480,2019-02-08,2019-02-08,2019-02-08,4.0,-71.42,8081.5,0.0,162.0,           ,1.0,1.0,141.0
2840,Ruoka_paivittaistavarakauppa,2019-02-11 01:37:04.719101120,2019-02-11,2019-02-11,2019-02-11,4.0,-6.43,8075.07,0.0,162.0,           ,1.0,1.0,170.0
2841,Ravintolat_kahvilat,2019-02-11 10:31:00.674157300,2019-02-11,2019-02-11,2019-02-11,4.0,-3.2,8071.87,0.0,162.0,           ,1.0,1.0,149.0
2842,Lapset,2019-02-11 16:43:08.764044940,2019-02-11,2019-02-11,2019-02-11,4.0,-4.62,8067.25,0.0,162.0,           ,1.0,1.0,128.0
2843,Tulot,2019-02-12 07:49:12.808988760,2019-02-12,2019-02-12,2019-02-12,4.0,-54.73,8012.52,0.0,162.0,           ,1.0,1.0,97.0
2844,Liikkuminen,2019-02-12 22:55:16.853932580,2019-02-12,2019-02-13,2019-02-12,4.0,-68.15,7944.37,0.0,162.0,           ,1.0,1.0,170.0
2845,Ravintolat_kahvilat,2019-02-13 11:19:33.033707860,2019-02-13,2019-02-13,2019-02-13,4.0,-4.3,7940.07,0.0,162.0,           ,1.0,1.0,123.0
2846,Ravintolat_kahvilat,2019-02-13 14:01:20.898876400,2019-02-13,2019-02-13,2019-02-13,4.0,-2.15,7937.92,0.0,162.0,           ,1.0,1.0,66.0
2847,Ruoka_paivittaistavarakauppa,2019-02-14 20:13:28.988764040,2019-02-14,2019-02-14,2019-02-14,4.0,-24.69,7913.23,0.0,162.0,           ,1.0,1.0,125.0
2848,Ravintolat_kahvilat,2019-02-15 02:25:37.078651680,2019-02-15,2019-02-15,2019-02-15,4.0,-3.75,7909.48,0.0,162.0,           ,1.0,1.0,111.0
2849,Ruoka_paivittaistavarakauppa,2019-02-15 05:07:24.943820220,2019-02-15,2019-02-15,2019-02-15,4.0,-74.35,7835.13,0.0,162.0,           ,1.0,1.0,60.0
2850,Tulot,2019-02-16 17:31:41.123595500,2019-02-16,2019-02-16,2019-02-16,4.0,524.17,8359.3,0.0,505.0,           ,1.0,1.0,204.0
2851,Liikkuminen,2019-02-18 08:37:45.168539320,2019-02-18,2019-02-18,2019-02-18,4.0,-74.77,8284.53,0.0,162.0,           ,1.0,1.0,124.0
2852,Ruoka_paivittaistavarakauppa,2019-02-18 14:49:53.258426960,2019-02-18,2019-02-18,2019-02-18,4.0,-23.21,8261.32,0.0,162.0,           ,1.0,1.0,63.0
2853,Asuminen,2019-02-18 23:43:49.213483140,2019-02-18,2019-02-18,2019-02-18,4.0,-116.63,8144.69,0.0,162.0,           ,1.0,1.0,64.0
2854,Ruoka_paivittaistavarakauppa,2019-02-19 05:55:57.303370780,2019-02-19,2019-02-19,2019-02-19,4.0,-15.28,8129.41,0.0,162.0,           ,1.0,1.0,62.0
2855,Ruoka_paivittaistavarakauppa,2019-02-19 12:08:05.393258420,2019-02-19,2019-02-19,2019-02-19,4.0,-17.23,8112.18,0.0,162.0,           ,1.0,1.0,80.0
2856,Ravintolat_kahvilat,2019-02-19 21:02:01.348314600,2019-02-19,2019-02-19,2019-02-19,4.0,-27.06,8085.12,0.0,162.0,           ,1.0,1.0,76.0
2857,Luokittelemattomat,2019-02-21 03:14:09.438202240,2019-02-21,2019-02-21,2019-02-21,4.0,-325.81,7759.31,706.0,129.0,OKOYFIHH   ,0.0,0.0,227.0
2858,Asuminen,2019-02-21 18:20:13.483146060,2019-02-21,2019-02-21,2019-02-21,4.0,-218.14,7541.17,706.0,147.0,OKOYFIHH   ,0.0,0.0,234.0
2859,Ruoka_paivittaistavarakauppa,2019-02-22 00:32:21.573033700,2019-02-22,2019-02-22,2019-02-22,4.0,-22.34,7518.83,0.0,162.0,           ,1.0,1.0,118.0
2860,Liikkuminen,2019-02-22 09:26:17.528089880,2019-02-22,2019-02-22,2019-02-21,4.0,-13.43,7505.4,0.0,162.0,           ,1.0,1.0,62.0
2861,Liikkuminen,2019-02-25 06:44:29.662921340,2019-02-25,2019-02-25,2019-02-25,4.0,-14.7,7490.7,0.0,162.0,           ,1.0,1.0,53.0
2862,Asuminen,2019-02-25 12:56:37.752808980,2019-02-25,2019-02-25,2019-02-25,4.0,-629.09,6861.61,706.0,129.0,NDEAFIHH   ,0.0,0.0,228.0
2863,Luokittelemattomat,2019-02-25 15:38:25.617977520,2019-02-25,2019-02-25,2019-02-25,4.0,-9.9,6851.71,0.0,162.0,           ,1.0,1.0,132.0
2864,Ruoka_paivittaistavarakauppa,2019-02-25 21:50:33.707865160,2019-02-25,2019-02-25,2019-02-25,4.0,-19.89,6831.82,0.0,162.0,           ,1.0,1.0,93.0
2865,Ravintolat_kahvilat,2019-02-26 04:02:41.797752800,2019-02-26,2019-02-26,2019-02-26,4.0,-59.54,6772.28,0.0,162.0,           ,1.0,1.0,181.0
2866,Tulot,2019-02-26 19:08:45.842696620,2019-02-26,2019-02-26,2019-02-26,4.0,1223.07,7995.35,0.0,505.0,           ,1.0,1.0,204.0
2867,Ruoka_paivittaistavarakauppa,2019-02-27 10:14:49.887640440,2019-02-27,2019-02-27,2019-02-27,4.0,-28.85,7966.5,0.0,162.0,           ,1.0,1.0,109.0
2868,Liikkuminen,2019-02-28 01:20:53.932584260,2019-02-28,2019-02-28,2019-02-28,4.0,-16.73,7949.77,0.0,162.0,           ,1.0,1.0,139.0
2869,Ruoka_paivittaistavarakauppa,2019-02-28 16:26:57.977528080,2019-02-28,2019-02-28,2019-02-28,4.0,-28.4,7921.37,0.0,162.0,           ,1.0,1.0,121.0
2870,Vakuutukset,2019-03-01 13:09:02.465753424,2019-03-01,2019-03-01,2019-03-01,4.0,-198.11,7723.26,706.0,129.0,SBANFIHH   ,0.0,0.0,227.0
2871,Ruoka_paivittaistavarakauppa,2019-03-01 20:23:00.821917808,2019-03-01,2019-03-01,2019-03-01,4.0,-6.61,7716.65,0.0,162.0,           ,1.0,1.0,54.0
2872,Kulttuuri_viihde,2019-03-04 09:32:03.287671232,2019-03-04,2019-03-04,2019-03-04,4.0,-30.32,7686.33,0.0,162.0,           ,1.0,1.0,169.0
2873,Terveys,2019-03-04 16:46:01.643835616,2019-03-04,2019-03-04,2019-03-04,4.0,-88.57,7597.76,0.0,162.0,           ,1.0,1.0,102.0
2874,Matkailu,2019-03-05 05:55:04.109589040,2019-03-05,2019-03-05,2019-03-05,4.0,-321.28,7276.48,0.0,162.0,           ,1.0,1.0,70.0
2875,Ruoka_paivittaistavarakauppa,2019-03-06 22:41:05.753424656,2019-03-06,2019-03-06,2019-03-06,4.0,-2.67,7273.81,0.0,162.0,           ,1.0,1.0,119.0
2876,Ruoka_paivittaistavarakauppa,2019-03-07 19:04:06.575342464,2019-03-07,2019-03-07,2019-03-07,4.0,-12.1,7261.71,0.0,162.0,           ,1.0,1.0,135.0
2877,Asuminen,2019-03-08 02:18:04.931506848,2019-03-08,2019-03-08,2019-03-08,4.0,-4.96,7256.75,0.0,162.0,           ,1.0,1.0,57.0
2878,Tulot,2019-03-08 15:27:07.397260272,2019-03-08,2019-03-08,2019-03-08,4.0,2.61,7259.36,0.0,505.0,           ,1.0,1.0,203.0
2879,Ruoka_paivittaistavarakauppa,2019-03-11 04:36:09.863013696,2019-03-11,2019-03-11,2019-03-11,4.0,-20.68,7238.68,0.0,162.0,           ,1.0,1.0,54.0
2880,Ravintolat_kahvilat,2019-03-11 08:13:09.041095888,2019-03-11,2019-03-11,2019-03-11,4.0,-11.96,7226.72,0.0,162.0,           ,1.0,1.0,120.0
2881,Asuminen,2019-03-11 11:50:08.219178080,2019-03-11,2019-03-11,2019-03-11,4.0,-264.8,6961.92,0.0,106.0,OKOYFIHH   ,0.0,0.0,8.0
2882,Ruoka_paivittaistavarakauppa,2019-03-11 17:45:12.328767120,2019-03-11,2019-03-11,2019-03-11,4.0,-41.84,6920.08,0.0,162.0,           ,1.0,1.0,70.0
2883,Ruoka_paivittaistavarakauppa,2019-03-12 00:59:10.684931504,2019-03-12,2019-03-12,2019-03-12,4.0,-58.65,6861.43,0.0,162.0,           ,1.0,1.0,139.0
2884,Ravintolat_kahvilat,2019-03-12 21:22:11.506849312,2019-03-12,2019-03-12,2019-03-12,4.0,-6.48,6854.95,0.0,162.0,           ,1.0,1.0,146.0
2885,Liikkuminen,2019-03-13 14:08:13.150684928,2019-03-13,2019-03-13,2019-03-13,4.0,-20.26,6834.69,0.0,162.0,           ,1.0,1.0,160.0
2886,Matkailu,2019-03-15 10:31:13.972602736,2019-03-15,2019-03-15,2019-03-15,4.0,-17.22,6817.47,0.0,162.0,           ,1.0,1.0,126.0
2887,Lapset,2019-03-18 03:17:15.616438352,2019-03-18,2019-03-18,2019-03-18,4.0,-6.17,6811.3,0.0,162.0,           ,1.0,1.0,131.0
2888,Lapset,2019-03-18 06:54:14.794520544,2019-03-18,2019-03-18,2019-03-18,4.0,-8.86,6802.44,0.0,162.0,           ,1.0,1.0,160.0
2889,Ruoka_paivittaistavarakauppa,2019-03-18 20:03:17.260273968,2019-03-18,2019-03-18,2019-03-18,4.0,-35.2,6767.24,0.0,162.0,           ,1.0,1.0,127.0
2890,Kulttuuri_viihde,2019-03-18 23:40:16.438356160,2019-03-18,2019-03-18,2019-03-18,4.0,-66.99,6700.25,0.0,162.0,           ,1.0,1.0,180.0
2891,Ravintolat_kahvilat,2019-03-19 12:49:18.904109584,2019-03-19,2019-03-19,2019-03-19,4.0,-33.35,6666.9,0.0,162.0,           ,1.0,1.0,109.0
2892,Saastot_sijoitukset,2019-03-19 16:26:18.082191776,2019-03-19,2019-03-19,2019-03-19,4.0,-11.98,6654.92,0.0,162.0,           ,1.0,1.0,55.0
2893,Liikkuminen,2019-03-20 05:35:20.547945200,2019-03-20,2019-03-20,2019-03-20,4.0,-5.11,6649.81,0.0,162.0,           ,1.0,1.0,133.0
2894,Luottojen_maksut,2019-03-20 09:12:19.726027392,2019-03-20,2019-03-20,2019-03-20,4.0,-31.95,6617.86,0.0,162.0,           ,1.0,1.0,54.0
2895,Liikkuminen,2019-03-22 01:58:21.369863008,2019-03-22,2019-03-22,2019-03-22,4.0,-60.34,6557.52,0.0,162.0,           ,1.0,1.0,128.0
2896,Asuminen,2019-03-22 22:21:22.191780816,2019-03-22,2019-03-22,2019-03-22,4.0,-7.51,6550.01,0.0,162.0,           ,1.0,1.0,82.0
2897,Tulot,2019-03-24 18:44:23.013698624,2019-03-24,2019-03-24,2019-03-24,4.0,383.1,6933.11,0.0,505.0,           ,1.0,1.0,203.0
2898,Ruoka_paivittaistavarakauppa,2019-03-25 15:07:23.835616432,2019-03-25,2019-03-25,2019-03-25,4.0,-2.93,6930.18,0.0,162.0,           ,1.0,1.0,162.0
2899,Muut,2019-03-26 11:30:24.657534240,2019-03-26,2019-03-26,2019-03-26,4.0,-2.42,6927.76,0.0,162.0,           ,1.0,1.0,107.0
2900,Ravintolat_kahvilat,2019-03-27 07:53:25.479452048,2019-03-27,2019-03-28,2019-03-27,4.0,-3.57,6924.19,0.0,162.0,           ,1.0,1.0,170.0
2901,Hyvinvointi,2019-03-28 04:16:26.301369856,2019-03-28,2019-03-28,2019-03-28,4.0,-9.01,6915.18,0.0,162.0,           ,1.0,1.0,120.0
2902,Tulot,2019-03-28 17:25:28.767123280,2019-03-28,2019-03-28,2019-03-28,4.0,631.3,7546.48,710.0,505.0,           ,1.0,1.0,237.0
2903,Liikkuminen,2019-03-29 00:39:27.123287664,2019-03-29,2019-03-29,2019-03-29,4.0,-84.19,7462.29,0.0,162.0,           ,1.0,1.0,99.0
2904,Ruoka_paivittaistavarakauppa,2019-03-29 13:48:29.589041088,2019-03-29,2019-03-29,2019-03-29,4.0,-0.64,7461.65,0.0,162.0,           ,1.0,1.0,93.0
2905,Ruoka_paivittaistavarakauppa,2019-03-29 21:02:27.945205472,2019-03-29,2019-03-29,2019-03-29,4.0,-7.99,7453.66,0.0,162.0,           ,1.0,1.0,103.0
2906,Liikkuminen,2019-04-02 09:29:18.139534883,2019-04-02,2019-04-02,2019-04-02,4.0,-22.09,7431.57,0.0,162.0,           ,1.0,1.0,110.0
2907,Ravintolat_kahvilat,2019-04-03 18:58:36.279069766,2019-04-03,2019-04-05,2019-04-03,4.0,-33.08,7398.49,0.0,162.0,           ,1.0,1.0,151.0
2908,Tulot,2019-04-05 04:27:54.418604649,2019-04-05,2019-04-05,2019-04-05,4.0,884.86,8283.35,0.0,505.0,           ,1.0,1.0,204.0
2909,Ruoka_paivittaistavarakauppa,2019-04-05 13:57:12.558139532,2019-04-05,2019-04-05,2019-04-04,4.0,-3.26,8280.09,0.0,162.0,           ,1.0,1.0,151.0
2910,Ruoka_paivittaistavarakauppa,2019-04-08 23:26:30.697674415,2019-04-08,2019-04-08,2019-04-08,4.0,-26.8,8253.29,0.0,162.0,           ,1.0,1.0,133.0
2911,Ravintolat_kahvilat,2019-04-09 08:55:48.837209298,2019-04-09,2019-04-09,2019-04-09,4.0,-0.93,8252.36,0.0,162.0,           ,1.0,1.0,129.0
2912,Ruoka_paivittaistavarakauppa,2019-04-10 18:25:06.976744181,2019-04-10,2019-04-10,2019-04-10,4.0,-104.79,8147.57,0.0,162.0,           ,1.0,1.0,135.0
2913,Ruoka_paivittaistavarakauppa,2019-04-11 13:23:43.255813947,2019-04-11,2019-04-11,2019-04-11,4.0,-3.59,8143.98,0.0,162.0,           ,1.0,1.0,150.0
2914,Muut,2019-04-12 03:54:25.116279064,2019-04-12,2019-04-12,2019-04-12,4.0,-1.92,8142.06,0.0,162.0,           ,1.0,1.0,134.0
2915,Muut,2019-04-15 22:53:01.395348830,2019-04-15,2019-04-15,2019-04-15,4.0,-9.03,8133.03,0.0,103.0,           ,0.0,1.0,2.0
2916,Liikkuminen,2019-04-16 08:22:19.534883713,2019-04-16,2019-04-17,2019-04-16,4.0,-120.93,8012.1,0.0,162.0,           ,1.0,1.0,123.0
2917,Luokittelemattomat,2019-04-16 17:51:37.674418596,2019-04-16,2019-04-16,2019-04-16,4.0,-10.8,8001.3,0.0,162.0,           ,1.0,1.0,122.0
2918,Luottojen_maksut,2019-04-19 03:20:55.813953479,2019-04-19,2019-04-19,2019-04-19,4.0,-20.19,7981.11,0.0,162.0,           ,1.0,1.0,110.0
2919,Asuminen,2019-04-19 12:50:13.953488362,2019-04-19,2019-04-19,2019-04-19,4.0,-98.11,7883.0,0.0,162.0,           ,1.0,1.0,166.0
2920,Terveys,2019-04-22 22:19:32.093023245,2019-04-22,2019-04-22,2019-04-22,4.0,325.13,8208.13,0.0,505.0,           ,1.0,1.0,205.0
2921,Lemmikit,2019-04-23 07:48:50.232558128,2019-04-23,2019-04-23,2019-04-23,4.0,-5.37,8202.76,0.0,162.0,           ,1.0,1.0,53.0
2922,Ruoka_paivittaistavarakauppa,2019-04-24 17:18:08.372093011,2019-04-24,2019-04-26,2019-04-24,4.0,-15.03,8187.73,0.0,162.0,           ,1.0,1.0,76.0
2923,Ruoka_paivittaistavarakauppa,2019-04-25 12:16:44.651162777,2019-04-25,2019-04-25,2019-04-25,4.0,-16.07,8171.66,0.0,162.0,           ,1.0,1.0,112.0
2924,Asuminen,2019-04-26 02:47:26.511627894,2019-04-26,2019-04-26,2019-04-26,4.0,-6.01,8165.65,0.0,162.0,           ,1.0,1.0,103.0
2925,Terveys,2019-04-29 21:46:02.790697660,2019-04-29,2019-04-29,2019-04-29,4.0,-54.59,8111.06,0.0,162.0,           ,1.0,1.0,146.0
2926,Ruoka_paivittaistavarakauppa,2019-04-30 07:15:20.930232543,2019-04-30,2019-04-30,2019-05-02,4.0,-41.96,8069.1,0.0,162.0,           ,1.0,1.0,140.0
2927,Tulot,2019-05-03 11:31:12.000000000,2019-05-03,2019-05-03,2019-05-03,4.0,3.76,8072.86,0.0,505.0,           ,1.0,1.0,203.0
2928,Matkailu,2019-05-07 23:02:24.000000000,2019-05-07,2019-05-07,2019-05-07,4.0,-77.04,7995.82,0.0,100.0,           ,1.0,1.0,0.0
2929,Harrastukset,2019-05-09 10:33:36.000000000,2019-05-09,2019-05-09,2019-05-09,4.0,-5.1,7990.72,0.0,162.0,           ,1.0,1.0,102.0
2930,Liikkuminen,2019-05-10 22:04:48.000000000,2019-05-10,2019-05-10,2019-05-10,4.0,-40.94,7949.78,0.0,162.0,           ,1.0,1.0,181.0
2931,Ruoka_paivittaistavarakauppa,2019-05-13 09:36:00.000000000,2019-05-13,2019-05-13,2019-05-13,4.0,-2.97,7946.81,0.0,162.0,           ,1.0,1.0,64.0
2932,Liikkuminen,2019-05-16 21:07:12.000000000,2019-05-16,2019-05-16,2019-05-16,4.0,-16.86,7929.95,0.0,162.0,           ,1.0,1.0,178.0
2933,Luokittelemattomat,2019-05-17 08:38:24.000000000,2019-05-17,2019-05-17,2019-05-17,4.0,-3.37,7926.58,0.0,162.0,           ,1.0,1.0,133.0
2934,Ruoka_paivittaistavarakauppa,2019-05-20 20:09:36.000000000,2019-05-20,2019-05-20,2019-05-20,4.0,-79.42,7847.16,0.0,162.0,           ,1.0,1.0,106.0
2935,Muut,2019-05-22 07:40:48.000000000,2019-05-22,2019-05-22,2019-05-22,4.0,-204.77,7642.39,0.0,162.0,           ,1.0,1.0,93.0
2936,Harrastukset,2019-05-23 19:12:00.000000000,2019-05-23,2019-05-23,2019-05-23,4.0,-26.97,7615.42,0.0,162.0,           ,1.0,1.0,64.0
2937,Liikkuminen,2019-05-30 06:43:12.000000000,2019-05-30,2019-05-30,2019-05-30,4.0,-26.83,7588.59,0.0,162.0,           ,1.0,1.0,109.0
2938,Tulot,2019-05-31 18:14:24.000000000,2019-05-31,2019-05-31,2019-05-31,4.0,1164.85,8753.44,0.0,505.0,           ,1.0,1.0,203.0
2939,Tulot,2019-06-03 19:38:10.909090909,2019-06-03,2019-06-03,2019-06-03,4.0,2361.87,11115.31,710.0,505.0,           ,1.0,1.0,236.0
2940,Ruoka_paivittaistavarakauppa,2019-06-04 15:16:21.818181818,2019-06-04,2019-06-04,2019-06-04,4.0,-14.85,11100.46,0.0,162.0,           ,1.0,1.0,157.0
2941,Ruoka_paivittaistavarakauppa,2019-06-07 10:54:32.727272727,2019-06-07,2019-06-07,2019-06-07,4.0,-49.84,11050.62,0.0,162.0,           ,1.0,1.0,183.0
2942,Terveys,2019-06-10 02:10:54.545454545,2019-06-10,2019-06-10,2019-06-10,4.0,-41.1,11009.52,0.0,162.0,           ,1.0,1.0,99.0
2943,Hyvinvointi,2019-06-10 06:32:43.636363636,2019-06-10,2019-06-10,2019-06-10,4.0,-219.8,10789.72,0.0,162.0,           ,1.0,1.0,160.0
2944,Ravintolat_kahvilat,2019-06-11 21:49:05.454545454,2019-06-11,2019-06-11,2019-06-11,4.0,-4.9,10784.82,0.0,162.0,           ,1.0,1.0,183.0
2945,Ruoka_paivittaistavarakauppa,2019-06-14 17:27:16.363636363,2019-06-14,2019-06-14,2019-06-14,4.0,-19.26,10765.56,0.0,162.0,           ,1.0,1.0,115.0
2946,Tulot,2019-06-15 13:05:27.272727272,2019-06-15,2019-06-15,2019-06-15,4.0,2871.14,13636.7,0.0,505.0,           ,1.0,1.0,205.0
2947,Ravintolat_kahvilat,2019-06-17 08:43:38.181818181,2019-06-17,2019-06-17,2019-06-17,4.0,-5.03,13631.67,0.0,162.0,           ,1.0,1.0,103.0
2948,Ruoka_paivittaistavarakauppa,2019-06-19 04:21:49.090909090,2019-06-19,2019-06-19,2019-06-19,4.0,-24.6,13607.07,0.0,162.0,           ,1.0,1.0,117.0
2949,Ruoka_paivittaistavarakauppa,2019-06-20 23:59:59.999999999,2019-06-20,2019-06-20,2019-06-19,4.0,-13.7,13593.37,0.0,162.0,           ,1.0,1.0,139.0
2950,Ruoka_paivittaistavarakauppa,2019-06-21 19:38:10.909090908,2019-06-21,2019-06-21,2019-06-21,4.0,-2.12,13591.25,0.0,162.0,           ,1.0,1.0,71.0
2951,Liikkuminen,2019-06-24 15:16:21.818181817,2019-06-24,2019-06-24,2019-06-24,4.0,-6.14,13585.11,0.0,162.0,           ,1.0,1.0,162.0
2952,Tulot,2019-06-27 10:54:32.727272726,2019-06-27,2019-06-27,2019-06-27,4.0,45.24,13630.35,0.0,505.0,           ,1.0,1.0,204.0
2953,Ruoka_paivittaistavarakauppa,2019-06-28 02:10:54.545454544,2019-06-28,2019-06-28,2019-06-28,4.0,-8.29,13622.06,0.0,162.0,           ,1.0,1.0,165.0
2954,Muut,2019-06-28 06:32:43.636363635,2019-06-28,2019-06-28,2019-06-28,4.0,-106.63,13515.43,0.0,105.0,OKOYFIHH   ,1.0,0.0,5.0
2955,Tulot,2019-07-02 10:36:16.744186046,2019-07-02,2019-07-02,2019-07-02,4.0,1126.14,14641.57,710.0,505.0,           ,1.0,1.0,236.0
2956,Liikkuminen,2019-07-03 21:12:33.488372092,2019-07-03,2019-07-03,2019-07-03,4.0,-24.03,14617.54,0.0,162.0,           ,1.0,1.0,110.0
2957,Tulot,2019-07-05 07:48:50.232558138,2019-07-05,2019-07-05,2019-07-05,4.0,5683.51,20301.05,0.0,505.0,           ,1.0,1.0,206.0
2958,Ruoka_paivittaistavarakauppa,2019-07-08 05:01:23.720930230,2019-07-08,2019-07-08,2019-07-08,4.0,-1.39,20299.66,0.0,162.0,           ,1.0,1.0,54.0
2959,Ruoka_paivittaistavarakauppa,2019-07-08 18:25:06.976744184,2019-07-08,2019-07-08,2019-07-08,4.0,-8.61,20291.05,0.0,162.0,           ,1.0,1.0,124.0
2960,Ruoka_paivittaistavarakauppa,2019-07-09 15:37:40.465116276,2019-07-09,2019-07-09,2019-07-09,4.0,-32.04,20259.01,0.0,162.0,           ,1.0,1.0,99.0
2961,Lemmikit,2019-07-11 02:13:57.209302322,2019-07-11,2019-07-11,2019-07-11,4.0,-195.91,20063.1,0.0,162.0,           ,1.0,1.0,91.0
2962,Matkailu,2019-07-12 12:50:13.953488368,2019-07-12,2019-07-12,2019-07-12,4.0,-32.01,20031.09,0.0,162.0,           ,1.0,1.0,140.0
2963,Ruoka_paivittaistavarakauppa,2019-07-12 23:26:30.697674414,2019-07-12,2019-07-12,2019-07-12,4.0,-9.29,20021.8,0.0,162.0,           ,1.0,1.0,178.0
2964,Tulot,2019-07-15 10:02:47.441860460,2019-07-15,2019-07-15,2019-07-15,4.0,4694.28,24716.08,0.0,505.0,           ,1.0,1.0,204.0
2965,Tulot,2019-07-16 20:39:04.186046506,2019-07-16,2019-07-16,2019-07-16,4.0,127.77,24843.85,0.0,505.0,           ,1.0,1.0,203.0
2966,Tulot,2019-07-18 07:15:20.930232552,2019-07-18,2019-07-18,2019-07-18,4.0,667.07,25510.92,0.0,505.0,           ,1.0,1.0,203.0
2967,Ruoka_paivittaistavarakauppa,2019-07-19 17:51:37.674418598,2019-07-19,2019-07-19,2019-07-19,4.0,-27.08,25483.84,0.0,162.0,           ,1.0,1.0,139.0
2968,Muut,2019-07-21 04:27:54.418604644,2019-07-21,2019-07-21,2019-07-21,4.0,-78.01,25405.83,0.0,105.0,OKOYFIHH   ,1.0,0.0,4.0
2969,Ruoka_paivittaistavarakauppa,2019-07-22 15:04:11.162790690,2019-07-22,2019-07-22,2019-07-22,4.0,-42.74,25363.09,0.0,162.0,           ,1.0,1.0,131.0
2970,Terveys,2019-07-23 01:40:27.906976736,2019-07-23,2019-07-23,2019-07-23,4.0,-167.67,25195.42,0.0,162.0,           ,1.0,1.0,114.0
2971,Tulot,2019-07-23 12:16:44.651162782,2019-07-23,2019-07-23,2019-07-23,4.0,123.39,25318.81,0.0,505.0,           ,1.0,1.0,205.0
2972,Ruoka_paivittaistavarakauppa,2019-07-26 22:53:01.395348828,2019-07-26,2019-07-26,2019-07-26,4.0,-15.59,25303.22,0.0,162.0,           ,1.0,1.0,102.0
2973,Saastot_sijoitukset,2019-07-29 06:41:51.627906966,2019-07-29,2019-07-29,2019-07-29,4.0,-19.06,25284.16,0.0,162.0,           ,1.0,1.0,131.0
2974,Ravintolat_kahvilat,2019-07-29 09:29:18.139534874,2019-07-29,2019-07-29,2019-07-29,4.0,-30.23,25253.93,0.0,162.0,           ,1.0,1.0,187.0
2975,Muut,2019-07-29 20:05:34.883720920,2019-07-29,2019-07-29,2019-07-29,4.0,-25.14,25228.79,0.0,162.0,           ,1.0,1.0,126.0
2976,Tulot,2019-08-01 12:30:15.126050420,2019-08-01,2019-08-01,2019-08-01,4.0,656.95,25885.74,710.0,505.0,           ,1.0,1.0,236.0
2977,Ruoka_paivittaistavarakauppa,2019-08-02 01:00:30.252100840,2019-08-02,2019-08-02,2019-08-02,4.0,-34.98,25850.76,0.0,162.0,           ,1.0,1.0,171.0
2978,Liikkuminen,2019-08-02 13:30:45.378151260,2019-08-02,2019-08-02,2019-08-02,4.0,-4.64,25846.12,0.0,162.0,           ,1.0,1.0,160.0
2979,Ruoka_paivittaistavarakauppa,2019-08-02 14:31:15.630252100,2019-08-02,2019-08-02,2019-08-02,4.0,-6.36,25839.76,0.0,162.0,           ,1.0,1.0,76.0
2980,Terveys,2019-08-05 02:01:00.504201680,2019-08-05,2019-08-05,2019-08-05,4.0,-22.14,25817.62,0.0,162.0,           ,1.0,1.0,54.0
2981,Ravintolat_kahvilat,2019-08-05 03:01:30.756302520,2019-08-05,2019-08-05,2019-08-05,4.0,-2.34,25815.28,0.0,162.0,           ,1.0,1.0,123.0
2982,Ruoka_paivittaistavarakauppa,2019-08-05 04:02:01.008403360,2019-08-05,2019-08-05,2019-08-05,4.0,-10.37,25804.91,0.0,162.0,           ,1.0,1.0,110.0
2983,Ruoka_paivittaistavarakauppa,2019-08-05 15:31:45.882352940,2019-08-05,2019-08-05,2019-08-05,4.0,-33.14,25771.77,0.0,162.0,           ,1.0,1.0,142.0
2984,Ravintolat_kahvilat,2019-08-05 16:32:16.134453780,2019-08-05,2019-08-05,2019-08-05,4.0,-143.36,25628.41,0.0,171.0,           ,1.0,1.0,194.0
2985,Muut,2019-08-06 05:02:31.260504200,2019-08-06,2019-08-07,2019-08-06,4.0,-15.5,25612.91,0.0,105.0,OKOYFIHH   ,1.0,0.0,4.0
2986,Luokittelemattomat,2019-08-06 17:32:46.386554620,2019-08-06,2019-08-06,2019-08-06,4.0,-8.5,25604.41,0.0,162.0,           ,1.0,1.0,156.0
2987,Saastot_sijoitukset,2019-08-06 19:33:46.890756300,2019-08-06,2019-08-06,2019-08-06,4.0,-43.04,25561.37,0.0,162.0,           ,1.0,1.0,80.0
2988,Muut,2019-08-08 06:03:01.512605040,2019-08-08,2019-08-08,2019-08-08,4.0,-9.56,25551.81,0.0,162.0,           ,1.0,1.0,160.0
2989,Ravintolat_kahvilat,2019-08-08 07:03:31.764705880,2019-08-08,2019-08-08,2019-08-08,4.0,-2.37,25549.44,0.0,162.0,           ,1.0,1.0,111.0
2990,Liikkuminen,2019-08-09 08:04:02.016806720,2019-08-09,2019-08-09,2019-08-09,4.0,-46.97,25502.47,0.0,162.0,           ,1.0,1.0,55.0
2991,Tulot,2019-08-09 09:04:32.268907560,2019-08-09,2019-08-09,2019-08-09,4.0,807.51,26309.98,0.0,505.0,           ,1.0,1.0,204.0
2992,Muut,2019-08-09 18:33:16.638655460,2019-08-09,2019-08-09,2019-08-09,4.0,-6.53,26303.45,0.0,162.0,           ,1.0,1.0,95.0
2993,Asuminen,2019-08-09 20:34:17.142857140,2019-08-09,2019-08-09,2019-08-09,4.0,-84.28,26219.17,0.0,162.0,           ,1.0,1.0,116.0
2994,Ruoka_paivittaistavarakauppa,2019-08-09 21:34:47.394957980,2019-08-09,2019-08-09,2019-08-09,4.0,-51.76,26167.41,0.0,162.0,           ,1.0,1.0,103.0
2995,Ruoka_paivittaistavarakauppa,2019-08-09 22:35:17.647058820,2019-08-09,2019-08-09,2019-08-09,4.0,-24.05,26143.36,0.0,162.0,           ,1.0,1.0,53.0
2996,Tulot,2019-08-12 10:05:02.521008400,2019-08-12,2019-08-12,2019-08-12,4.0,305.92,26449.28,0.0,505.0,           ,1.0,1.0,203.0
2997,Ruoka_paivittaistavarakauppa,2019-08-12 11:05:32.773109240,2019-08-12,2019-08-12,2019-08-12,4.0,-42.99,26406.29,0.0,162.0,           ,1.0,1.0,115.0
2998,Ruoka_paivittaistavarakauppa,2019-08-12 23:35:47.899159660,2019-08-12,2019-08-12,2019-08-12,4.0,-25.75,26380.54,0.0,162.0,           ,1.0,1.0,163.0
2999,Liikkuminen,2019-08-13 00:36:18.151260500,2019-08-13,2019-08-13,2019-08-13,4.0,-47.11,26333.43,0.0,162.0,           ,1.0,1.0,117.0
3000,Luokittelemattomat,2019-08-14 14:07:03.529411760,2019-08-14,2019-08-14,2019-08-14,4.0,-34.33,26299.1,0.0,162.0,           ,1.0,1.0,117.0
3001,Ruoka_paivittaistavarakauppa,2019-08-15 12:06:03.025210080,2019-08-15,2019-08-15,2019-08-15,4.0,-36.91,26262.19,0.0,162.0,           ,1.0,1.0,53.0
3002,Liikkuminen,2019-08-15 13:06:33.277310920,2019-08-15,2019-08-15,2019-08-15,4.0,-13.16,26249.03,0.0,162.0,           ,1.0,1.0,120.0
3003,Ravintolat_kahvilat,2019-08-16 01:36:48.403361340,2019-08-16,2019-08-16,2019-08-16,4.0,-217.56,26031.47,0.0,162.0,           ,1.0,1.0,132.0
3004,Ruoka_paivittaistavarakauppa,2019-08-16 02:37:18.655462180,2019-08-16,2019-08-16,2019-08-16,4.0,-4.06,26027.41,0.0,162.0,           ,1.0,1.0,53.0
3005,Ruoka_paivittaistavarakauppa,2019-08-16 03:37:48.907563020,2019-08-16,2019-08-16,2019-08-16,4.0,-10.46,26016.95,0.0,162.0,           ,1.0,1.0,91.0
3006,Ruoka_paivittaistavarakauppa,2019-08-16 15:07:33.781512600,2019-08-16,2019-08-16,2019-08-16,4.0,-3.05,26013.9,0.0,162.0,           ,1.0,1.0,53.0
3007,Liikkuminen,2019-08-19 04:38:19.159663860,2019-08-19,2019-08-19,2019-08-19,4.0,-70.96,25942.94,0.0,162.0,           ,1.0,1.0,181.0
3008,Liikkuminen,2019-08-19 05:38:49.411764700,2019-08-19,2019-08-19,2019-08-19,4.0,-31.05,25911.89,0.0,162.0,           ,1.0,1.0,70.0
3009,Ravintolat_kahvilat,2019-08-19 16:08:04.033613440,2019-08-19,2019-08-19,2019-08-19,4.0,-50.2,25861.69,0.0,162.0,           ,1.0,1.0,93.0
3010,Ruoka_paivittaistavarakauppa,2019-08-19 17:08:34.285714280,2019-08-19,2019-08-19,2019-08-19,4.0,-42.04,25819.65,0.0,162.0,           ,1.0,1.0,102.0
3011,Ruoka_paivittaistavarakauppa,2019-08-19 18:09:04.537815120,2019-08-19,2019-08-19,2019-08-19,4.0,-4.54,25815.11,0.0,162.0,           ,1.0,1.0,126.0
3012,Tulot,2019-08-20 06:39:19.663865540,2019-08-20,2019-08-20,2019-08-20,4.0,2038.14,27853.25,0.0,505.0,           ,1.0,1.0,205.0
3013,Luottojen_maksut,2019-08-20 07:39:49.915966380,2019-08-20,2019-08-20,2019-08-20,4.0,-14.1,27839.15,0.0,162.0,           ,1.0,1.0,105.0
3014,Matkailu,2019-08-20 19:09:34.789915960,2019-08-20,2019-08-20,2019-08-20,4.0,-23.37,27815.78,0.0,162.0,           ,1.0,1.0,105.0
3015,Ruoka_paivittaistavarakauppa,2019-08-21 08:40:20.168067220,2019-08-21,2019-08-21,2019-08-21,4.0,-29.48,27786.3,0.0,162.0,           ,1.0,1.0,123.0
3016,Liikkuminen,2019-08-21 20:10:05.042016800,2019-08-21,2019-08-21,2019-08-21,4.0,-50.16,27736.14,0.0,162.0,           ,1.0,1.0,64.0
3017,Ruoka_paivittaistavarakauppa,2019-08-21 21:10:35.294117640,2019-08-21,2019-08-21,2019-08-21,4.0,-53.96,27682.18,0.0,162.0,           ,1.0,1.0,109.0
3018,Matkailu,2019-08-21 22:11:05.546218480,2019-08-21,2019-08-21,2019-08-21,4.0,-37.07,27645.11,0.0,162.0,           ,1.0,1.0,124.0
3019,Ruoka_paivittaistavarakauppa,2019-08-23 09:40:50.420168060,2019-08-23,2019-08-23,2019-08-23,4.0,-18.7,27626.41,0.0,162.0,           ,1.0,1.0,57.0
3020,Ravintolat_kahvilat,2019-08-23 10:41:20.672268900,2019-08-23,2019-08-23,2019-08-23,4.0,-2.61,27623.8,0.0,162.0,           ,1.0,1.0,107.0
3021,Ruoka_paivittaistavarakauppa,2019-08-23 23:11:35.798319320,2019-08-23,2019-08-23,2019-08-23,4.0,-6.25,27617.55,0.0,162.0,           ,1.0,1.0,83.0
3022,Hyvinvointijakauneus,2019-08-26 00:12:06.050420160,2019-08-26,2019-08-26,2019-08-26,4.0,-73.62,27543.93,0.0,162.0,           ,1.0,1.0,99.0
3023,Ravintolat_kahvilat,2019-08-26 11:41:50.924369740,2019-08-26,2019-08-26,2019-08-26,4.0,-9.4,27534.53,0.0,162.0,           ,1.0,1.0,181.0
3024,Luokittelemattomat,2019-08-26 12:42:21.176470580,2019-08-26,2019-08-26,2019-08-26,4.0,-8.91,27525.62,0.0,162.0,           ,1.0,1.0,95.0
3025,Ruoka_paivittaistavarakauppa,2019-08-27 01:12:36.302521000,2019-08-27,2019-08-27,2019-08-27,4.0,-15.3,27510.32,0.0,162.0,           ,1.0,1.0,116.0
3026,Ruoka_paivittaistavarakauppa,2019-08-27 02:13:06.554621840,2019-08-27,2019-08-27,2019-08-27,4.0,-4.74,27505.58,0.0,162.0,           ,1.0,1.0,140.0
3027,Ruoka_paivittaistavarakauppa,2019-08-27 13:42:51.428571420,2019-08-27,2019-08-28,2019-08-27,4.0,-106.95,27398.63,0.0,162.0,           ,1.0,1.0,121.0
3028,Kulttuuri_viihde,2019-08-29 03:13:36.806722680,2019-08-29,2019-08-30,2019-08-29,4.0,-317.06,27081.57,0.0,162.0,           ,1.0,1.0,138.0
3029,Kulttuuri_viihde,2019-08-29 04:14:07.058823520,2019-08-29,2019-08-29,2019-08-29,4.0,-15.53,27066.04,0.0,162.0,           ,1.0,1.0,109.0
3030,Saastot_sijoitukset,2019-08-29 14:43:21.680672260,2019-08-29,2019-08-29,2019-08-29,4.0,-38.01,27028.03,0.0,162.0,           ,1.0,1.0,161.0
3031,Tulot,2019-08-29 15:43:51.932773100,2019-08-29,2019-08-29,2019-08-29,4.0,520.58,27548.61,0.0,505.0,           ,1.0,1.0,205.0
3032,Muut,2019-08-29 16:44:22.184873940,2019-08-29,2019-08-29,2019-08-29,4.0,-7.9,27540.71,0.0,162.0,           ,1.0,1.0,111.0
3033,Muut,2019-08-30 05:14:37.310924360,2019-08-30,2019-08-30,2019-08-30,4.0,-81.61,27459.1,0.0,162.0,           ,1.0,1.0,138.0
3034,Lapset,2019-08-30 17:44:52.436974780,2019-08-30,2019-08-30,2019-08-30,4.0,-23.77,27435.33,0.0,162.0,           ,1.0,1.0,125.0
3035,Ruoka_paivittaistavarakauppa,2019-09-02 02:34:05.756457560,2019-09-02,2019-09-02,2019-09-02,4.0,-18.99,27416.34,0.0,162.0,           ,1.0,1.0,62.0
3036,Lapset,2019-09-02 05:18:49.151291512,2019-09-02,2019-09-02,2019-09-02,4.0,-175.35,27240.99,0.0,162.0,           ,1.0,1.0,132.0
3037,Ruoka_paivittaistavarakauppa,2019-09-02 07:52:54.907749072,2019-09-02,2019-09-02,2019-09-02,4.0,-12.35,27228.64,0.0,162.0,           ,1.0,1.0,158.0
3038,Liikkuminen,2019-09-02 10:37:38.302583024,2019-09-02,2019-09-02,2019-09-02,4.0,-33.93,27194.71,0.0,162.0,           ,1.0,1.0,95.0
3039,Tulot,2019-09-02 13:11:44.059040584,2019-09-02,2019-09-02,2019-09-02,4.0,2395.45,29590.16,701.0,506.0,           ,1.0,1.0,216.0
3040,Saastot_sijoitukset,2019-09-02 15:56:27.453874536,2019-09-02,2019-09-02,2019-09-02,4.0,-11.93,29578.23,0.0,162.0,           ,1.0,1.0,70.0
3041,Saastot_sijoitukset,2019-09-02 18:30:33.210332096,2019-09-02,2019-09-02,2019-09-02,4.0,-29.69,29548.54,0.0,162.0,           ,1.0,1.0,150.0
3042,Luottojen_maksut,2019-09-02 21:15:16.605166048,2019-09-02,2019-09-02,2019-09-02,4.0,-310.57,29237.97,0.0,162.0,           ,1.0,1.0,139.0
3043,Asuminen,2019-09-02 23:49:22.361623608,2019-09-02,2019-09-02,2019-09-02,4.0,-12.29,29225.68,0.0,162.0,           ,1.0,1.0,106.0
3044,Liikkuminen,2019-09-03 05:08:11.512915120,2019-09-03,2019-09-03,2019-09-03,4.0,-123.68,29102.0,0.0,162.0,           ,1.0,1.0,116.0
3045,Ruoka_paivittaistavarakauppa,2019-09-03 10:27:00.664206632,2019-09-03,2019-09-03,2019-09-03,4.0,-4.32,29097.68,0.0,162.0,           ,1.0,1.0,120.0
3046,Asuminen,2019-09-03 15:45:49.815498144,2019-09-03,2019-09-03,2019-09-03,4.0,-13.37,29084.31,0.0,162.0,           ,1.0,1.0,119.0
3047,Saastot_sijoitukset,2019-09-03 21:04:38.966789656,2019-09-03,2019-09-03,2019-09-03,4.0,-51.53,29032.78,0.0,162.0,           ,1.0,1.0,129.0
3048,Ruoka_paivittaistavarakauppa,2019-09-04 02:23:28.118081168,2019-09-04,2019-09-04,2019-09-04,4.0,-5.68,29027.1,0.0,162.0,           ,1.0,1.0,116.0
3049,Ruoka_paivittaistavarakauppa,2019-09-04 04:57:33.874538728,2019-09-04,2019-09-04,2019-09-04,4.0,-15.97,29011.13,0.0,162.0,           ,1.0,1.0,82.0
3050,Shoppailu,2019-09-04 07:42:17.269372680,2019-09-04,2019-09-04,2019-09-04,4.0,-22.17,28988.96,0.0,162.0,           ,1.0,1.0,64.0
3051,Saastot_sijoitukset,2019-09-04 13:01:06.420664192,2019-09-04,2019-09-04,2019-09-04,4.0,-7.73,28981.23,0.0,162.0,           ,1.0,1.0,158.0
3052,Ruoka_paivittaistavarakauppa,2019-09-04 18:19:55.571955704,2019-09-04,2019-09-04,2019-09-04,4.0,-5.48,28975.75,0.0,162.0,           ,1.0,1.0,54.0
3053,Liikkuminen,2019-09-04 20:54:01.328413264,2019-09-04,2019-09-04,2019-09-04,4.0,-47.54,28928.21,0.0,162.0,           ,1.0,1.0,76.0
3054,Terveys,2019-09-04 23:38:44.723247216,2019-09-04,2019-09-04,2019-09-04,4.0,-89.4,28838.81,0.0,162.0,           ,1.0,1.0,174.0
3055,Shoppailu,2019-09-05 10:16:23.025830240,2019-09-05,2019-09-05,2019-09-05,4.0,-47.15,28791.66,0.0,162.0,           ,1.0,1.0,120.0
3056,Liikkuminen,2019-09-05 15:35:12.177121752,2019-09-05,2019-09-05,2019-09-05,4.0,-9.39,28782.27,0.0,162.0,           ,1.0,1.0,181.0
3057,Kulttuuri_viihde,2019-09-06 02:12:50.479704776,2019-09-06,2019-09-06,2019-09-06,4.0,-208.25,28574.02,0.0,106.0,OKOYFIHH   ,0.0,0.0,29.0
3058,Ruoka_paivittaistavarakauppa,2019-09-06 04:46:56.236162336,2019-09-06,2019-09-06,2019-09-06,4.0,-22.92,28551.1,0.0,162.0,           ,1.0,1.0,165.0
3059,Asuminen,2019-09-06 07:31:39.630996288,2019-09-06,2019-09-06,2019-09-06,4.0,-31.59,28519.51,0.0,106.0,OKOYFIHH   ,0.0,0.0,17.0
3060,Ravintolat_kahvilat,2019-09-06 10:05:45.387453848,2019-09-06,2019-09-06,2019-09-06,4.0,-2.62,28516.89,0.0,162.0,           ,1.0,1.0,105.0
3061,Liikkuminen,2019-09-06 12:50:28.782287800,2019-09-06,2019-09-06,2019-09-06,4.0,-1460.23,27056.66,0.0,106.0,OKOYFIHH   ,0.0,0.0,8.0
3062,Asuminen,2019-09-06 18:09:17.933579312,2019-09-06,2019-09-06,2019-09-06,4.0,-10.46,27046.2,0.0,106.0,OKOYFIHH   ,0.0,0.0,15.0
3063,Luokittelemattomat,2019-09-06 23:17:29.446494432,2019-09-06,2019-09-06,2019-09-06,4.0,-26.01,27020.19,0.0,106.0,OKOYFIHH   ,1.0,0.0,7.0
3064,Ravintolat_kahvilat,2019-09-06 23:28:07.084870824,2019-09-06,2019-09-06,2019-09-06,4.0,-20.4,26999.79,0.0,106.0,OKOYFIHH   ,0.0,0.0,10.0
3065,Saastot_sijoitukset,2019-09-09 02:02:12.841328384,2019-09-09,2019-09-09,2019-09-09,4.0,-18.21,26981.58,0.0,162.0,           ,1.0,1.0,99.0
3066,Luokittelemattomat,2019-09-09 04:36:18.597785944,2019-09-09,2019-09-09,2019-09-09,4.0,-23.61,26957.97,0.0,106.0,OKOYFIHH   ,0.0,0.0,16.0
3067,Luokittelemattomat,2019-09-09 07:21:01.992619896,2019-09-09,2019-09-09,2019-09-09,4.0,-19.35,26938.62,0.0,162.0,           ,1.0,1.0,88.0
3068,Vakuutukset,2019-09-09 09:55:07.749077456,2019-09-09,2019-09-10,2019-09-09,4.0,-84.81,26853.81,0.0,106.0,DABAFIHH   ,0.0,0.0,8.0
3069,Asuminen,2019-09-09 15:13:56.900368968,2019-09-09,2019-09-09,2019-09-09,4.0,-38.81,26815.0,0.0,106.0,OKOYFIHH   ,0.0,0.0,25.0
3070,Lapset,2019-09-09 15:24:34.538745360,2019-09-09,2019-09-09,2019-09-09,4.0,-10.1,26804.9,0.0,162.0,           ,1.0,1.0,102.0
3071,Liikkuminen,2019-09-09 17:58:40.295202920,2019-09-09,2019-09-09,2019-09-09,4.0,-57.19,26747.71,0.0,162.0,           ,1.0,1.0,103.0
3072,Shoppailu,2019-09-09 20:32:46.051660480,2019-09-09,2019-09-09,2019-09-09,4.0,-80.08,26667.63,0.0,162.0,           ,1.0,1.0,131.0
3073,Ravintolat_kahvilat,2019-09-09 20:43:23.690036872,2019-09-09,2019-09-09,2019-09-10,4.0,-2.43,26665.2,0.0,162.0,           ,1.0,1.0,64.0
3074,Ruoka_paivittaistavarakauppa,2019-09-10 01:51:35.202951992,2019-09-10,2019-09-10,2019-09-10,4.0,-11.41,26653.79,0.0,162.0,           ,1.0,1.0,54.0
3075,Ruoka_paivittaistavarakauppa,2019-09-10 07:10:24.354243504,2019-09-10,2019-09-10,2019-09-09,4.0,-56.01,26597.78,0.0,162.0,           ,1.0,1.0,157.0
3076,Tulot,2019-09-10 12:29:13.505535016,2019-09-10,2019-09-10,2019-09-10,4.0,53.11,26650.89,710.0,506.0,           ,1.0,1.0,239.0
3077,Tulot,2019-09-10 12:39:51.143911408,2019-09-10,2019-09-10,2019-09-10,4.0,51.84,26702.73,701.0,506.0,           ,1.0,1.0,216.0
3078,Liikkuminen,2019-09-10 17:48:02.656826528,2019-09-10,2019-09-10,2019-09-10,4.0,-33.91,26668.82,0.0,162.0,           ,1.0,1.0,127.0
3079,Ruoka_paivittaistavarakauppa,2019-09-10 23:06:51.808118040,2019-09-10,2019-09-10,2019-09-10,4.0,-10.55,26658.27,0.0,162.0,           ,1.0,1.0,128.0
3080,Ruoka_paivittaistavarakauppa,2019-09-11 04:15:03.321033160,2019-09-11,2019-09-11,2019-09-11,4.0,-70.05,26588.22,0.0,162.0,           ,1.0,1.0,85.0
3081,Matkailu,2019-09-11 04:25:40.959409552,2019-09-11,2019-09-11,2019-09-11,4.0,-4.19,26584.03,0.0,162.0,           ,1.0,1.0,112.0
3082,Ruoka_paivittaistavarakauppa,2019-09-11 09:44:30.110701064,2019-09-11,2019-09-11,2019-09-11,4.0,-44.61,26539.42,0.0,162.0,           ,1.0,1.0,70.0
3083,Ruoka_paivittaistavarakauppa,2019-09-11 15:03:19.261992576,2019-09-11,2019-09-11,2019-09-11,4.0,-105.71,26433.71,0.0,162.0,           ,1.0,1.0,132.0
3084,Ruoka_paivittaistavarakauppa,2019-09-11 20:22:08.413284088,2019-09-11,2019-09-11,2019-09-11,4.0,-91.14,26342.57,0.0,162.0,           ,1.0,1.0,91.0
3085,Matkailu,2019-09-12 01:40:57.564575600,2019-09-12,2019-09-12,2019-09-12,4.0,-263.35,26079.22,0.0,162.0,           ,1.0,1.0,91.0
3086,Saastot_sijoitukset,2019-09-12 06:59:46.715867112,2019-09-12,2019-09-12,2019-09-12,4.0,-9.31,26069.91,0.0,162.0,           ,1.0,1.0,128.0
3087,Muut,2019-09-12 12:18:35.867158624,2019-09-12,2019-09-12,2019-09-12,4.0,-11.77,26058.14,0.0,162.0,           ,1.0,1.0,95.0
3088,Ruoka_paivittaistavarakauppa,2019-09-12 17:37:25.018450136,2019-09-12,2019-09-12,2019-09-12,4.0,-51.8,26006.34,0.0,162.0,           ,1.0,1.0,81.0
3089,Lemmikit,2019-09-12 20:11:30.774907696,2019-09-12,2019-09-12,2019-09-12,4.0,-67.85,25938.49,0.0,162.0,           ,1.0,1.0,106.0
3090,Ravintolat_kahvilat,2019-09-12 22:56:14.169741648,2019-09-12,2019-09-12,2019-09-12,4.0,-8.24,25930.25,0.0,162.0,           ,1.0,1.0,65.0
3091,Liikkuminen,2019-09-13 01:30:19.926199208,2019-09-13,2019-09-13,2019-09-13,4.0,-47.44,25882.81,0.0,162.0,           ,1.0,1.0,120.0
3092,Ruoka_paivittaistavarakauppa,2019-09-13 09:33:52.472324672,2019-09-13,2019-09-13,2019-09-13,4.0,-9.18,25873.63,0.0,162.0,           ,1.0,1.0,76.0
3093,Ruoka_paivittaistavarakauppa,2019-09-13 14:52:41.623616184,2019-09-13,2019-09-13,2019-09-13,4.0,-33.86,25839.77,0.0,162.0,           ,1.0,1.0,75.0
3094,Ruoka_paivittaistavarakauppa,2019-09-13 17:26:47.380073744,2019-09-13,2019-09-13,2019-09-13,4.0,-38.83,25800.94,0.0,162.0,           ,1.0,1.0,149.0
3095,Luokittelemattomat,2019-09-16 01:19:42.287822816,2019-09-16,2019-09-16,2019-09-16,4.0,-20.08,25780.86,0.0,162.0,           ,1.0,1.0,149.0
3096,Asuminen,2019-09-16 03:53:48.044280376,2019-09-16,2019-09-16,2019-09-16,4.0,-37.14,25743.72,0.0,162.0,           ,1.0,1.0,123.0
3097,Terveys,2019-09-16 04:04:25.682656768,2019-09-16,2019-09-18,2019-09-16,4.0,-41.07,25702.65,0.0,162.0,           ,1.0,1.0,110.0
3098,Hyvinvointijakauneus,2019-09-16 06:38:31.439114328,2019-09-16,2019-09-16,2019-09-16,4.0,-74.67,25627.98,0.0,162.0,           ,1.0,1.0,108.0
3099,Liikkuminen,2019-09-16 06:49:09.077490720,2019-09-16,2019-09-16,2019-09-16,4.0,-79.54,25548.44,0.0,162.0,           ,1.0,1.0,181.0
3100,Luokittelemattomat,2019-09-16 09:23:14.833948280,2019-09-16,2019-09-16,2019-09-16,4.0,-18.32,25530.12,0.0,162.0,           ,1.0,1.0,140.0
3101,Saastot_sijoitukset,2019-09-16 11:57:20.590405840,2019-09-16,2019-09-16,2019-09-16,4.0,-12.8,25517.32,0.0,162.0,           ,1.0,1.0,128.0
3102,Liikkuminen,2019-09-16 12:07:58.228782232,2019-09-16,2019-09-16,2019-09-16,4.0,-13.0,25504.32,0.0,162.0,           ,1.0,1.0,80.0
3103,Ruoka_paivittaistavarakauppa,2019-09-16 14:31:26.346863400,2019-09-16,2019-09-16,2019-09-16,4.0,-26.72,25477.6,0.0,162.0,           ,1.0,1.0,147.0
3104,Luottojen_maksut,2019-09-16 17:16:09.741697352,2019-09-16,2019-09-16,2019-09-16,4.0,-10.27,25467.33,0.0,162.0,           ,1.0,1.0,154.0
3105,Liikkuminen,2019-09-16 19:50:15.498154912,2019-09-16,2019-09-16,2019-09-16,4.0,-52.16,25415.17,0.0,162.0,           ,1.0,1.0,180.0
3106,Hyvinvointi,2019-09-16 20:00:53.136531304,2019-09-16,2019-09-16,2019-09-16,4.0,-166.79,25248.38,0.0,162.0,           ,1.0,1.0,125.0
3107,Ravintolat_kahvilat,2019-09-16 22:34:58.892988864,2019-09-16,2019-09-18,2019-09-16,4.0,-73.89,25174.49,0.0,162.0,           ,1.0,1.0,130.0
3108,Saastot_sijoitukset,2019-09-16 22:45:36.531365256,2019-09-16,2019-09-16,2019-09-16,4.0,-50.55,25123.94,0.0,162.0,           ,1.0,1.0,116.0
3109,Ruoka_paivittaistavarakauppa,2019-09-17 14:42:03.985239792,2019-09-17,2019-09-17,2019-09-17,4.0,-8.83,25115.11,0.0,162.0,           ,1.0,1.0,124.0
3110,Liikkuminen,2019-09-18 01:09:04.649446424,2019-09-18,2019-09-18,2019-09-18,4.0,-17.84,25097.27,0.0,162.0,           ,1.0,1.0,111.0
3111,Ruoka_paivittaistavarakauppa,2019-09-18 06:27:53.800737936,2019-09-18,2019-09-20,2019-09-18,4.0,-12.35,25084.92,0.0,162.0,           ,1.0,1.0,113.0
3112,Luottojen_maksut,2019-09-18 09:12:37.195571888,2019-09-18,2019-09-18,2019-09-18,4.0,-28.49,25056.43,0.0,162.0,           ,1.0,1.0,105.0
3113,Saastot_sijoitukset,2019-09-18 11:46:42.952029448,2019-09-18,2019-09-18,2019-09-18,4.0,-48.87,25007.56,0.0,162.0,           ,1.0,1.0,135.0
3114,Ruoka_paivittaistavarakauppa,2019-09-18 17:05:32.103320960,2019-09-18,2019-09-18,2019-09-18,4.0,-49.79,24957.77,0.0,162.0,           ,1.0,1.0,135.0
3115,Ruoka_paivittaistavarakauppa,2019-09-18 22:24:21.254612472,2019-09-18,2019-09-18,2019-09-18,4.0,-24.61,24933.16,0.0,162.0,           ,1.0,1.0,60.0
3116,Ravintolat_kahvilat,2019-09-19 03:43:10.405903984,2019-09-19,2019-09-19,2019-09-19,4.0,-1.87,24931.29,0.0,162.0,           ,1.0,1.0,170.0
3117,Liikkuminen,2019-09-19 09:01:59.557195496,2019-09-19,2019-09-19,2019-09-19,4.0,-13.56,24917.73,0.0,162.0,           ,1.0,1.0,55.0
3118,Liikkuminen,2019-09-19 14:20:48.708487008,2019-09-19,2019-09-19,2019-09-19,4.0,-77.36,24840.37,0.0,162.0,           ,1.0,1.0,103.0
3119,Saastot_sijoitukset,2019-09-19 19:39:37.859778520,2019-09-19,2019-09-19,2019-09-19,4.0,-65.87,24774.5,0.0,162.0,           ,1.0,1.0,53.0
3120,Luottojen_maksut,2019-09-20 00:58:27.011070032,2019-09-20,2019-09-20,2019-09-17,4.0,-21.52,24752.98,0.0,162.0,           ,1.0,1.0,102.0
3121,Saastot_sijoitukset,2019-09-20 06:17:16.162361544,2019-09-20,2019-09-20,2019-09-20,4.0,-15.0,24737.98,0.0,162.0,           ,1.0,1.0,129.0
3122,Liikkuminen,2019-09-20 08:51:21.918819104,2019-09-20,2019-09-20,2019-09-20,4.0,-22.63,24715.35,0.0,162.0,           ,1.0,1.0,136.0
3123,Tulot,2019-09-20 11:36:05.313653056,2019-09-20,2019-09-20,2019-09-20,4.0,8.35,24723.7,701.0,506.0,           ,1.0,1.0,216.0
3124,Liikkuminen,2019-09-20 14:10:11.070110616,2019-09-20,2019-09-20,2019-09-20,4.0,-40.59,24683.11,0.0,162.0,           ,1.0,1.0,138.0
3125,Ruoka_paivittaistavarakauppa,2019-09-20 16:54:54.464944568,2019-09-20,2019-09-20,2019-09-20,4.0,-7.82,24675.29,0.0,162.0,           ,1.0,1.0,116.0
3126,Luottojen_maksut,2019-09-20 22:13:43.616236080,2019-09-20,2019-09-20,2019-09-20,4.0,-1303.15,23372.14,0.0,106.0,HELSFIHH   ,1.0,0.0,20.0
3127,Luokittelemattomat,2019-09-21 03:32:32.767527592,2019-09-21,2019-09-21,2019-09-21,4.0,-6211.61,17160.53,0.0,106.0,OKOYFIHH   ,1.0,0.0,20.0
3128,Saastot_sijoitukset,2019-09-23 00:37:11.734317248,2019-09-23,2019-09-23,2019-09-23,4.0,-55.2,17105.33,0.0,162.0,           ,1.0,1.0,176.0
3129,Ruoka_paivittaistavarakauppa,2019-09-23 00:47:49.372693640,2019-09-23,2019-09-23,2019-09-23,4.0,-22.06,17083.27,0.0,162.0,           ,1.0,1.0,157.0
3130,Ruoka_paivittaistavarakauppa,2019-09-23 03:11:17.490774808,2019-09-23,2019-09-23,2019-09-23,4.0,-18.97,17064.3,0.0,162.0,           ,1.0,1.0,54.0
3131,Ravintolat_kahvilat,2019-09-23 03:21:55.129151200,2019-09-23,2019-09-23,2019-09-23,4.0,-1.92,17062.38,0.0,162.0,           ,1.0,1.0,148.0
3132,Liikkuminen,2019-09-23 06:06:38.523985152,2019-09-23,2019-09-23,2019-09-23,4.0,-22.16,17040.22,0.0,162.0,           ,1.0,1.0,80.0
3133,Asuminen,2019-09-23 08:40:44.280442712,2019-09-23,2019-09-23,2019-09-23,4.0,-13.91,17026.31,0.0,162.0,           ,1.0,1.0,173.0
3134,Lapset,2019-09-23 11:25:27.675276664,2019-09-23,2019-09-23,2019-09-23,4.0,-5.27,17021.04,0.0,162.0,           ,1.0,1.0,151.0
3135,Ruoka_paivittaistavarakauppa,2019-09-23 13:59:33.431734224,2019-09-23,2019-09-23,2019-09-23,4.0,-109.02,16912.02,0.0,162.0,           ,1.0,1.0,166.0
3136,Asuminen,2019-09-23 16:33:39.188191784,2019-09-23,2019-09-23,2019-09-23,4.0,-6.47,16905.55,0.0,162.0,           ,1.0,1.0,95.0
3137,Liikkuminen,2019-09-23 16:44:16.826568176,2019-09-23,2019-09-23,2019-09-23,4.0,-30.33,16875.22,0.0,162.0,           ,1.0,1.0,54.0
3138,Ruoka_paivittaistavarakauppa,2019-09-23 19:18:22.583025736,2019-09-23,2019-09-23,2019-09-23,4.0,-43.53,16831.69,0.0,162.0,           ,1.0,1.0,124.0
3139,Ruoka_paivittaistavarakauppa,2019-09-23 19:29:00.221402128,2019-09-23,2019-09-23,2019-09-23,4.0,-41.35,16790.34,0.0,162.0,           ,1.0,1.0,102.0
3140,Ruoka_paivittaistavarakauppa,2019-09-23 22:03:05.977859688,2019-09-23,2019-09-23,2019-09-23,4.0,-31.08,16759.26,0.0,162.0,           ,1.0,1.0,170.0
3141,Ruoka_paivittaistavarakauppa,2019-09-24 11:14:50.036900272,2019-09-24,2019-09-24,2019-09-24,4.0,-53.22,16706.04,0.0,162.0,           ,1.0,1.0,95.0
3142,Ravintolat_kahvilat,2019-09-24 21:41:50.701106904,2019-09-24,2019-09-24,2019-09-24,4.0,-1.65,16704.39,0.0,162.0,           ,1.0,1.0,181.0
3143,Harrastukset,2019-09-24 21:52:28.339483296,2019-09-24,2019-09-24,2019-09-24,4.0,-102.02,16602.37,0.0,106.0,OKOYFIHH   ,0.0,0.0,8.0
3144,Ravintolat_kahvilat,2019-09-25 05:56:00.885608760,2019-09-25,2019-09-25,2019-09-25,4.0,-93.75,16508.62,0.0,162.0,           ,1.0,1.0,182.0
3145,Liikkuminen,2019-09-25 08:30:06.642066320,2019-09-25,2019-09-25,2019-09-25,4.0,-26.99,16481.63,0.0,162.0,           ,1.0,1.0,149.0
3146,Ruoka_paivittaistavarakauppa,2019-09-25 19:07:44.944649344,2019-09-25,2019-09-25,2019-09-25,4.0,-73.1,16408.53,0.0,162.0,           ,1.0,1.0,132.0
3147,Ruoka_paivittaistavarakauppa,2019-09-26 13:48:55.793357832,2019-09-26,2019-09-26,2019-09-26,4.0,-68.11,16340.42,0.0,162.0,           ,1.0,1.0,64.0
3148,Ruoka_paivittaistavarakauppa,2019-09-26 16:23:01.549815392,2019-09-26,2019-09-26,2019-09-26,4.0,-3.22,16337.2,0.0,162.0,           ,1.0,1.0,145.0
3149,Asuminen,2019-09-27 00:15:56.457564464,2019-09-27,2019-09-27,2019-09-27,4.0,-31.47,16305.73,0.0,162.0,           ,1.0,1.0,139.0
3150,Muut,2019-09-27 00:26:34.095940856,2019-09-27,2019-09-27,2019-09-27,4.0,-42.4,16263.33,0.0,162.0,           ,1.0,1.0,56.0
3151,Ruoka_paivittaistavarakauppa,2019-09-27 03:00:39.852398416,2019-09-27,2019-09-27,2019-09-27,4.0,-6.65,16256.68,0.0,162.0,           ,1.0,1.0,54.0
3152,Ruoka_paivittaistavarakauppa,2019-09-27 05:34:45.608855976,2019-09-27,2019-09-27,2019-09-27,4.0,-6.66,16250.02,0.0,162.0,           ,1.0,1.0,131.0
3153,Matkailu,2019-09-27 05:45:23.247232368,2019-09-27,2019-09-27,2019-09-27,4.0,-14.58,16235.44,0.0,162.0,           ,1.0,1.0,104.0
3154,Asuminen,2019-09-27 08:08:51.365313536,2019-09-27,2019-09-27,2019-09-27,4.0,-14.34,16221.1,0.0,162.0,           ,1.0,1.0,133.0
3155,Ravintolat_kahvilat,2019-09-27 08:19:29.003689928,2019-09-27,2019-09-27,2019-09-26,4.0,-16.21,16204.89,0.0,162.0,           ,1.0,1.0,76.0
3156,Luottojen_maksut,2019-09-27 11:04:12.398523880,2019-09-27,2019-09-27,2019-09-27,4.0,-15.24,16189.65,0.0,162.0,           ,1.0,1.0,139.0
3157,Liikkuminen,2019-09-27 13:27:40.516605048,2019-09-27,2019-09-27,2019-09-27,4.0,-32.32,16157.33,0.0,162.0,           ,1.0,1.0,145.0
3158,Luokittelemattomat,2019-09-27 13:38:18.154981440,2019-09-27,2019-09-27,2019-09-27,4.0,-5.08,16152.25,0.0,162.0,           ,1.0,1.0,70.0
3159,Ruoka_paivittaistavarakauppa,2019-09-27 16:12:23.911439000,2019-09-27,2019-09-27,2019-09-27,4.0,-42.91,16109.34,0.0,162.0,           ,1.0,1.0,106.0
3160,Ravintolat_kahvilat,2019-09-27 18:57:07.306272952,2019-09-27,2019-09-27,2019-09-27,4.0,-9.42,16099.92,0.0,162.0,           ,1.0,1.0,125.0
3161,Ruoka_paivittaistavarakauppa,2019-09-27 21:31:13.062730512,2019-09-27,2019-09-27,2019-09-27,4.0,-7.66,16092.26,0.0,162.0,           ,1.0,1.0,110.0
3162,Liikkuminen,2019-09-30 00:05:18.819188072,2019-09-30,2019-09-30,2019-09-30,4.0,-57.68,16034.58,0.0,162.0,           ,1.0,1.0,130.0
3163,Liikkuminen,2019-09-30 02:50:02.214022024,2019-09-30,2019-09-30,2019-09-30,4.0,-1.32,16033.26,0.0,162.0,           ,1.0,1.0,94.0
3164,Tulot,2019-09-30 05:24:07.970479584,2019-09-30,2019-09-30,2019-09-30,4.0,16.27,16049.53,0.0,505.0,           ,1.0,1.0,203.0
3165,Tulot,2019-09-30 10:42:57.121771096,2019-09-30,2019-09-30,2019-09-30,4.0,258.12,16307.65,701.0,506.0,           ,1.0,1.0,217.0
3166,Ravintolat_kahvilat,2019-09-30 10:53:34.760147488,2019-09-30,2019-09-30,2019-09-30,4.0,-35.32,16272.33,0.0,162.0,           ,1.0,1.0,127.0
3167,Lapset,2019-09-30 16:01:46.273062608,2019-09-30,2019-09-30,2019-09-30,4.0,-772.21,15500.12,0.0,106.0,NDEAFIHH   ,0.0,0.0,28.0
3168,Ruoka_paivittaistavarakauppa,2019-09-30 18:46:29.667896560,2019-09-30,2019-09-30,2019-09-30,4.0,-3.73,15496.39,0.0,162.0,           ,1.0,1.0,178.0
3169,Matkailu,2019-09-30 21:20:35.424354120,2019-09-30,2019-09-30,2019-09-30,4.0,-625.08,14871.31,0.0,106.0,DABAFIHH   ,0.0,0.0,15.0
3170,Tulot,2019-10-01 10:33:11.489361702,2019-10-01,2019-10-01,2019-10-01,4.0,251.28,15122.59,701.0,506.0,           ,1.0,1.0,216.0
3171,Ruoka_paivittaistavarakauppa,2019-10-01 21:06:22.978723404,2019-10-01,2019-10-01,2019-10-01,4.0,-5.64,15116.95,0.0,162.0,           ,1.0,1.0,112.0
3172,Tulot,2019-10-02 07:39:34.468085106,2019-10-02,2019-10-02,2019-10-02,4.0,47.37,15164.32,0.0,506.0,           ,1.0,1.0,210.0
3173,Shoppailu,2019-10-02 18:12:45.957446808,2019-10-02,2019-10-02,2019-10-02,4.0,-24.89,15139.43,0.0,162.0,           ,1.0,1.0,110.0
3174,Liikkuminen,2019-10-03 04:45:57.446808510,2019-10-03,2019-10-03,2019-10-03,4.0,-107.81,15031.62,0.0,162.0,           ,1.0,1.0,69.0
3175,Lapset,2019-10-03 15:19:08.936170212,2019-10-03,2019-10-03,2019-10-03,4.0,-16.66,15014.96,0.0,106.0,OKOYFIHH   ,0.0,0.0,45.0
3176,Saastot_sijoitukset,2019-10-03 20:05:06.382978722,2019-10-03,2019-10-03,2019-10-03,4.0,-1354.33,13660.63,0.0,192.0,           ,0.0,1.0,200.0
3177,Kulttuuri_viihde,2019-10-04 01:52:20.425531914,2019-10-04,2019-10-04,2019-10-04,4.0,-9.78,13650.85,0.0,106.0,OKOYFIHH   ,0.0,0.0,47.0
3178,Asuminen,2019-10-04 12:25:31.914893616,2019-10-04,2019-10-04,2019-10-04,4.0,-99.49,13551.36,0.0,106.0,OKOYFIHH   ,0.0,0.0,37.0
3179,Ravintolat_kahvilat,2019-10-04 22:58:43.404255318,2019-10-04,2019-10-04,2019-10-04,4.0,-2.97,13548.39,0.0,162.0,           ,1.0,1.0,62.0
3180,Ruoka_paivittaistavarakauppa,2019-10-07 03:44:40.851063828,2019-10-07,2019-10-07,2019-10-07,4.0,-4.23,13544.16,0.0,162.0,           ,1.0,1.0,173.0
3181,Matkailu,2019-10-07 06:38:17.872340424,2019-10-07,2019-10-07,2019-10-07,4.0,-1834.94,11709.22,0.0,172.0,           ,1.0,1.0,198.0
3182,Luottojen_maksut,2019-10-07 08:30:38.297872338,2019-10-07,2019-10-07,2019-10-07,4.0,-53.97,11655.25,0.0,172.0,           ,1.0,1.0,198.0
3183,Ruoka_paivittaistavarakauppa,2019-10-07 09:31:54.893617020,2019-10-07,2019-10-07,2019-10-07,4.0,-31.01,11624.24,0.0,162.0,           ,1.0,1.0,124.0
3184,Ruoka_paivittaistavarakauppa,2019-10-07 14:17:52.340425530,2019-10-07,2019-10-08,2019-10-07,4.0,-3.83,11620.41,0.0,162.0,           ,1.0,1.0,132.0
3185,Liikkuminen,2019-10-08 00:51:03.829787232,2019-10-08,2019-10-08,2019-10-08,4.0,-65.47,11554.94,0.0,162.0,           ,1.0,1.0,118.0
3186,Saastot_sijoitukset,2019-10-08 11:24:15.319148934,2019-10-08,2019-10-08,2019-10-08,4.0,-64.0,11490.94,0.0,162.0,           ,1.0,1.0,128.0
3187,Ruoka_paivittaistavarakauppa,2019-10-08 17:11:29.361702126,2019-10-08,2019-10-08,2019-10-08,4.0,-48.34,11442.6,0.0,162.0,           ,1.0,1.0,77.0
3188,Tulot,2019-10-08 21:57:26.808510636,2019-10-08,2019-10-11,2019-10-08,4.0,280.63,11723.23,701.0,506.0,           ,1.0,1.0,215.0
3189,Ruoka_paivittaistavarakauppa,2019-10-10 05:37:01.276595742,2019-10-10,2019-10-10,2019-10-10,4.0,-3.44,11719.79,0.0,162.0,           ,1.0,1.0,148.0
3190,Ruoka_paivittaistavarakauppa,2019-10-10 16:10:12.765957444,2019-10-10,2019-10-10,2019-10-10,4.0,-47.17,11672.62,0.0,162.0,           ,1.0,1.0,132.0
3191,Luottojen_maksut,2019-10-10 19:03:49.787234040,2019-10-10,2019-10-10,2019-10-10,4.0,-84.88,11587.74,0.0,172.0,           ,1.0,1.0,195.0
3192,Saastot_sijoitukset,2019-10-11 02:43:24.255319146,2019-10-11,2019-10-11,2019-10-11,4.0,-52.98,11534.76,0.0,162.0,           ,1.0,1.0,68.0
3193,Tulot,2019-10-11 10:22:58.723404252,2019-10-11,2019-10-11,2019-10-11,4.0,65.33,11600.09,701.0,506.0,           ,1.0,1.0,216.0
3194,Lemmikit,2019-10-11 13:16:35.744680848,2019-10-11,2019-10-11,2019-10-11,4.0,-24.07,11576.02,0.0,162.0,           ,1.0,1.0,117.0
3195,Ravintolat_kahvilat,2019-10-11 18:02:33.191489358,2019-10-11,2019-10-11,2019-10-11,4.0,-7.7,11568.32,0.0,162.0,           ,1.0,1.0,119.0
3196,Ruoka_paivittaistavarakauppa,2019-10-11 20:56:10.212765954,2019-10-11,2019-10-11,2019-10-11,4.0,-12.06,11556.26,0.0,162.0,           ,1.0,1.0,85.0
3197,Saastot_sijoitukset,2019-10-11 23:49:47.234042550,2019-10-11,2019-10-11,2019-10-11,4.0,-32.16,11524.1,0.0,162.0,           ,1.0,1.0,101.0
3198,Ruoka_paivittaistavarakauppa,2019-10-14 04:35:44.680851060,2019-10-14,2019-10-14,2019-10-14,4.0,-7.74,11516.36,0.0,162.0,           ,1.0,1.0,95.0
3199,Ruoka_paivittaistavarakauppa,2019-10-14 07:29:21.702127656,2019-10-14,2019-10-14,2019-10-14,4.0,-13.69,11502.67,0.0,162.0,           ,1.0,1.0,53.0
3200,Ruoka_paivittaistavarakauppa,2019-10-14 12:15:19.148936166,2019-10-14,2019-10-14,2019-10-14,4.0,-80.67,11422.0,0.0,162.0,           ,1.0,1.0,117.0
3201,Liikkuminen,2019-10-14 15:08:56.170212762,2019-10-14,2019-10-14,2019-10-14,4.0,-7.62,11414.38,0.0,162.0,           ,1.0,1.0,117.0
3202,Hyvinvointijakauneus,2019-10-14 22:48:30.638297868,2019-10-14,2019-10-14,2019-10-14,4.0,-304.66,11109.72,0.0,162.0,           ,1.0,1.0,145.0
3203,Muut,2019-10-16 06:28:05.106382974,2019-10-16,2019-10-16,2019-10-16,4.0,-3.81,11105.91,0.0,162.0,           ,1.0,1.0,91.0
3204,Ruoka_paivittaistavarakauppa,2019-10-16 09:21:42.127659570,2019-10-16,2019-10-16,2019-10-16,4.0,-73.56,11032.35,0.0,162.0,           ,1.0,1.0,119.0
3205,Ruoka_paivittaistavarakauppa,2019-10-17 01:42:07.659574464,2019-10-17,2019-10-17,2019-10-17,4.0,-17.88,11014.47,0.0,162.0,           ,1.0,1.0,102.0
3206,Ruoka_paivittaistavarakauppa,2019-10-17 19:54:53.617021272,2019-10-17,2019-10-17,2019-10-17,4.0,-13.7,11000.77,0.0,162.0,           ,1.0,1.0,160.0
3207,Asuminen,2019-10-18 00:40:51.063829782,2019-10-18,2019-10-18,2019-10-18,4.0,-7.39,10993.38,0.0,162.0,           ,1.0,1.0,70.0
3208,Shoppailu,2019-10-18 03:34:28.085106378,2019-10-18,2019-10-18,2019-10-18,4.0,-16.83,10976.55,0.0,162.0,           ,1.0,1.0,109.0
3209,Luokittelemattomat,2019-10-18 11:14:02.553191484,2019-10-18,2019-10-21,2019-10-18,4.0,-17.15,10959.4,0.0,162.0,           ,1.0,1.0,172.0
3210,Ruoka_paivittaistavarakauppa,2019-10-18 14:07:39.574468080,2019-10-18,2019-10-18,2019-10-18,4.0,-5.7,10953.7,0.0,162.0,           ,1.0,1.0,110.0
3211,Liikkuminen,2019-10-18 17:01:16.595744676,2019-10-18,2019-10-18,2019-10-18,4.0,-9.19,10944.51,0.0,162.0,           ,1.0,1.0,132.0
3212,Terveys,2019-10-18 18:53:37.021276590,2019-10-18,2019-10-18,2019-10-18,4.0,-5.76,10938.75,0.0,162.0,           ,1.0,1.0,134.0
3213,Ravintolat_kahvilat,2019-10-18 21:47:14.042553186,2019-10-18,2019-10-18,2019-10-18,4.0,-2.9,10935.85,0.0,162.0,           ,1.0,1.0,149.0
3214,Ruoka_paivittaistavarakauppa,2019-10-21 02:33:11.489361696,2019-10-21,2019-10-21,2019-10-21,4.0,-10.67,10925.18,0.0,162.0,           ,1.0,1.0,84.0
3215,Ruoka_paivittaistavarakauppa,2019-10-21 05:26:48.510638292,2019-10-21,2019-10-21,2019-10-21,4.0,-44.56,10880.62,0.0,162.0,           ,1.0,1.0,160.0
3216,Ruoka_paivittaistavarakauppa,2019-10-21 08:20:25.531914888,2019-10-21,2019-10-21,2019-10-21,4.0,-23.17,10857.45,0.0,162.0,           ,1.0,1.0,53.0
3217,Luokittelemattomat,2019-10-21 13:06:22.978723398,2019-10-21,2019-10-21,2019-10-21,4.0,-14.26,10843.19,0.0,162.0,           ,1.0,1.0,137.0
3218,Ruoka_paivittaistavarakauppa,2019-10-21 15:59:59.999999994,2019-10-21,2019-10-21,2019-10-21,4.0,-33.43,10809.76,0.0,162.0,           ,1.0,1.0,76.0
3219,Asuminen,2019-10-21 23:39:34.468085100,2019-10-21,2019-10-21,2019-10-21,4.0,-59.43,10750.33,0.0,162.0,           ,1.0,1.0,139.0
3220,Kulttuuri_viihde,2019-10-23 10:12:45.957446802,2019-10-23,2019-10-23,2019-10-23,4.0,-3.46,10746.87,0.0,162.0,           ,1.0,1.0,124.0
3221,Ruoka_paivittaistavarakauppa,2019-10-23 17:52:20.425531908,2019-10-23,2019-10-23,2019-10-23,4.0,-31.33,10715.54,0.0,162.0,           ,1.0,1.0,168.0
3222,Ruoka_paivittaistavarakauppa,2019-10-23 20:45:57.446808504,2019-10-23,2019-10-23,2019-10-23,4.0,-29.5,10686.04,0.0,162.0,           ,1.0,1.0,138.0
3223,Ruoka_paivittaistavarakauppa,2019-10-24 07:19:08.936170206,2019-10-24,2019-10-24,2019-10-24,4.0,-84.97,10601.07,0.0,162.0,           ,1.0,1.0,95.0
3224,Ravintolat_kahvilat,2019-10-24 14:58:43.404255312,2019-10-24,2019-10-24,2019-10-24,4.0,-129.81,10471.26,0.0,162.0,           ,1.0,1.0,111.0
3225,Tulot,2019-10-25 04:25:31.914893610,2019-10-25,2019-10-25,2019-10-25,4.0,102.95,10574.21,710.0,506.0,           ,1.0,1.0,242.0
3226,Ruoka_paivittaistavarakauppa,2019-10-25 22:38:17.872340418,2019-10-25,2019-10-25,2019-10-25,4.0,-12.65,10561.56,0.0,162.0,           ,1.0,1.0,150.0
3227,Saastot_sijoitukset,2019-10-28 01:31:54.893617014,2019-10-28,2019-10-28,2019-10-28,4.0,-85.83,10475.73,0.0,162.0,           ,1.0,1.0,105.0
3228,Ruoka_paivittaistavarakauppa,2019-10-28 06:17:52.340425524,2019-10-28,2019-10-30,2019-10-28,4.0,-25.99,10449.74,0.0,162.0,           ,1.0,1.0,76.0
3229,Ravintolat_kahvilat,2019-10-28 09:11:29.361702120,2019-10-28,2019-10-28,2019-10-28,4.0,-13.03,10436.71,0.0,162.0,           ,1.0,1.0,155.0
3230,Terveys,2019-10-28 12:05:06.382978716,2019-10-28,2019-10-28,2019-10-28,4.0,-56.67,10380.04,0.0,162.0,           ,1.0,1.0,112.0
3231,Ruoka_paivittaistavarakauppa,2019-10-28 16:51:03.829787226,2019-10-28,2019-10-28,2019-10-28,4.0,-22.09,10357.95,0.0,162.0,           ,1.0,1.0,135.0
3232,Ravintolat_kahvilat,2019-10-28 19:44:40.851063822,2019-10-28,2019-10-28,2019-10-28,4.0,-22.25,10335.7,0.0,162.0,           ,1.0,1.0,102.0
3233,Ruoka_paivittaistavarakauppa,2019-10-29 03:24:15.319148928,2019-10-29,2019-10-29,2019-10-29,4.0,-39.14,10296.56,0.0,162.0,           ,1.0,1.0,105.0
3234,Harrastukset,2019-10-29 13:57:26.808510630,2019-10-29,2019-10-29,2019-10-29,4.0,-41.28,10255.28,0.0,162.0,           ,1.0,1.0,156.0
3235,Ravintolat_kahvilat,2019-10-30 00:30:38.297872332,2019-10-30,2019-11-01,2019-10-30,4.0,-2.6,10252.68,0.0,162.0,           ,1.0,1.0,106.0
3236,Liikkuminen,2019-10-30 11:03:49.787234034,2019-10-30,2019-10-30,2019-10-30,4.0,-6.01,10246.67,0.0,162.0,           ,1.0,1.0,122.0
3237,Luottojen_maksut,2019-10-30 21:37:01.276595736,2019-10-30,2019-10-30,2019-10-30,4.0,-2100.44,8146.23,0.0,172.0,           ,1.0,1.0,196.0
3238,Ruoka_paivittaistavarakauppa,2019-10-31 08:10:12.765957438,2019-10-31,2019-10-31,2019-10-31,4.0,-15.53,8130.7,0.0,162.0,           ,1.0,1.0,102.0
3239,Ruoka_paivittaistavarakauppa,2019-10-31 18:43:24.255319140,2019-10-31,2019-10-31,2019-10-31,4.0,-38.83,8091.87,0.0,162.0,           ,1.0,1.0,160.0
3240,Tulot,2019-11-01 19:12:00.000000000,2019-11-01,2019-11-01,2019-11-01,4.0,551.97,8643.84,701.0,524.0,           ,1.0,1.0,223.0
3241,Luottojen_maksut,2019-11-04 04:48:00.000000000,2019-11-04,2019-11-04,2019-11-04,4.0,-62.9,8580.94,0.0,162.0,           ,1.0,1.0,139.0
3242,Tulot,2019-11-04 09:36:00.000000000,2019-11-04,2019-11-04,2019-11-04,4.0,143.8,8724.74,701.0,506.0,           ,1.0,1.0,215.0
3243,Liikkuminen,2019-11-04 14:24:00.000000000,2019-11-04,2019-11-04,2019-11-04,4.0,-11.38,8713.36,0.0,162.0,           ,1.0,1.0,110.0
3244,Ruoka_paivittaistavarakauppa,2019-11-05 00:00:00.000000000,2019-11-05,2019-11-05,2019-11-05,4.0,-10.8,8702.56,0.0,162.0,           ,1.0,1.0,93.0
3245,Ruoka_paivittaistavarakauppa,2019-11-05 19:12:00.000000000,2019-11-05,2019-11-05,2019-11-05,4.0,-44.94,8657.62,0.0,162.0,           ,1.0,1.0,153.0
3246,Ruoka_paivittaistavarakauppa,2019-11-06 14:24:00.000000000,2019-11-06,2019-11-06,2019-11-06,4.0,-8.7,8648.92,0.0,162.0,           ,1.0,1.0,54.0
3247,Ruoka_paivittaistavarakauppa,2019-11-07 04:48:00.000000000,2019-11-07,2019-11-07,2019-11-07,4.0,-4.89,8644.03,0.0,162.0,           ,1.0,1.0,130.0
3248,Luokittelemattomat,2019-11-07 09:36:00.000000000,2019-11-07,2019-11-07,2019-11-07,4.0,-3.17,8640.86,0.0,162.0,           ,1.0,1.0,102.0
3249,Ruoka_paivittaistavarakauppa,2019-11-08 00:00:00.000000000,2019-11-08,2019-11-08,2019-11-08,4.0,-11.67,8629.19,0.0,162.0,           ,1.0,1.0,109.0
3250,Muut,2019-11-11 09:36:00.000000000,2019-11-11,2019-11-11,2019-11-11,4.0,-52.91,8576.28,0.0,162.0,           ,1.0,1.0,87.0
3251,Liikkuminen,2019-11-11 14:24:00.000000000,2019-11-11,2019-11-11,2019-11-11,4.0,-37.49,8538.79,0.0,162.0,           ,1.0,1.0,105.0
3252,Ruoka_paivittaistavarakauppa,2019-11-11 19:12:00.000000000,2019-11-11,2019-11-11,2019-11-11,4.0,-12.94,8525.85,0.0,162.0,           ,1.0,1.0,131.0
3253,Luokittelemattomat,2019-11-12 00:00:00.000000000,2019-11-12,2019-11-12,2019-11-12,4.0,-353.95,8171.9,0.0,106.0,OKOYFIHH   ,1.0,0.0,17.0
3254,Ruoka_paivittaistavarakauppa,2019-11-12 04:48:00.000000000,2019-11-12,2019-11-12,2019-11-12,4.0,-25.44,8146.46,0.0,162.0,           ,1.0,1.0,55.0
3255,Ruoka_paivittaistavarakauppa,2019-11-14 09:36:00.000000000,2019-11-14,2019-11-14,2019-11-14,4.0,-34.65,8111.81,0.0,162.0,           ,1.0,1.0,55.0
3256,Ruoka_paivittaistavarakauppa,2019-11-14 14:24:00.000000000,2019-11-14,2019-11-14,2019-11-14,4.0,-21.79,8090.02,0.0,162.0,           ,1.0,1.0,117.0
3257,Ravintolat_kahvilat,2019-11-14 19:12:00.000000000,2019-11-14,2019-11-14,2019-11-14,4.0,-10.09,8079.93,0.0,162.0,           ,1.0,1.0,160.0
3258,Muut,2019-11-15 04:48:00.000000000,2019-11-15,2019-11-15,2019-11-15,4.0,-8.79,8071.14,0.0,106.0,OKOYFIHH   ,0.0,0.0,40.0
3259,Muut,2019-11-18 00:00:00.000000000,2019-11-18,2019-11-18,2019-11-18,4.0,-1.42,8069.72,0.0,162.0,           ,1.0,1.0,91.0
3260,Luokittelemattomat,2019-11-18 14:24:00.000000000,2019-11-18,2019-11-18,2019-11-18,4.0,-3.91,8065.81,0.0,162.0,           ,1.0,1.0,105.0
3261,Tulot,2019-11-18 19:12:00.000000000,2019-11-18,2019-11-18,2019-11-18,4.0,30.7,8096.51,710.0,506.0,           ,1.0,1.0,238.0
3262,Ruoka_paivittaistavarakauppa,2019-11-19 09:36:00.000000000,2019-11-19,2019-11-19,2019-11-19,4.0,-20.19,8076.32,0.0,162.0,           ,1.0,1.0,101.0
3263,Ravintolat_kahvilat,2019-11-20 00:00:00.000000000,2019-11-20,2019-11-20,2019-11-20,4.0,-7.11,8069.21,0.0,162.0,           ,1.0,1.0,172.0
3264,Liikkuminen,2019-11-20 04:48:00.000000000,2019-11-20,2019-11-21,2019-11-20,4.0,-3.01,8066.2,0.0,162.0,           ,1.0,1.0,144.0
3265,Harrastukset,2019-11-20 14:24:00.000000000,2019-11-20,2019-11-20,2019-11-20,4.0,-16.45,8049.75,0.0,162.0,           ,1.0,1.0,123.0
3266,Ruoka_paivittaistavarakauppa,2019-11-20 19:12:00.000000000,2019-11-20,2019-11-20,2019-11-20,4.0,-1.78,8047.97,0.0,162.0,           ,1.0,1.0,63.0
3267,Tulot,2019-11-23 09:36:00.000000000,2019-11-23,2019-11-23,2019-11-23,4.0,327.2,8375.17,0.0,505.0,           ,1.0,1.0,203.0
3268,Luokittelemattomat,2019-11-24 04:48:00.000000000,2019-11-24,2019-11-24,2019-11-24,4.0,-763.29,7611.88,0.0,106.0,OKOYFIHH   ,1.0,0.0,41.0
3269,Ravintolat_kahvilat,2019-11-25 00:00:00.000000000,2019-11-25,2019-11-25,2019-11-25,4.0,-20.75,7591.13,0.0,106.0,DABAFIHH   ,0.0,0.0,33.0
3270,Asuminen,2019-11-25 14:24:00.000000000,2019-11-25,2019-11-25,2019-11-25,4.0,-7.45,7583.68,0.0,106.0,OKOYFIHH   ,0.0,0.0,35.0
3271,Ravintolat_kahvilat,2019-11-25 19:12:00.000000000,2019-11-25,2019-11-25,2019-11-25,4.0,-42.96,7540.72,0.0,106.0,OKOYFIHH   ,0.0,0.0,45.0
3272,Muut,2019-11-27 04:48:00.000000000,2019-11-27,2019-11-27,2019-11-27,4.0,-245.79,7294.93,0.0,163.0,           ,1.0,1.0,189.0
3273,Ruoka_paivittaistavarakauppa,2019-11-27 09:36:00.000000000,2019-11-27,2019-11-27,2019-11-27,4.0,-92.01,7202.92,0.0,162.0,           ,1.0,1.0,70.0
3274,Luottojen_maksut,2019-11-29 00:00:00.000000000,2019-11-29,2019-11-29,2019-11-29,4.0,-16.29,7186.63,0.0,162.0,           ,1.0,1.0,128.0
3275,Luottojen_maksut,2019-11-29 14:24:00.000000000,2019-11-29,2019-11-29,2019-11-29,4.0,-5.77,7180.86,0.0,162.0,           ,1.0,1.0,171.0
3276,Ruoka_paivittaistavarakauppa,2019-11-29 19:12:00.000000000,2019-11-29,2019-11-29,2019-11-29,4.0,-40.0,7140.86,0.0,162.0,           ,1.0,1.0,153.0
3277,Luottojen_maksut,2019-12-02 01:19:39.574468084,2019-12-02,2019-12-02,2019-12-02,4.0,-21.51,7119.35,0.0,172.0,           ,1.0,1.0,195.0
3278,Tulot,2019-12-02 06:19:54.893617021,2019-12-02,2019-12-02,2019-12-02,4.0,38.96,7158.31,0.0,506.0,           ,1.0,1.0,209.0
3279,Vakuutukset,2019-12-02 07:39:34.468085105,2019-12-02,2019-12-02,2019-12-02,4.0,-149.15,7009.16,0.0,106.0,OKOYFIHH   ,0.0,0.0,7.0
3280,Ruoka_paivittaistavarakauppa,2019-12-02 12:39:49.787234042,2019-12-02,2019-12-02,2019-12-02,4.0,-7.66,7001.5,0.0,162.0,           ,1.0,1.0,139.0
3281,Tulot,2019-12-02 13:59:29.361702126,2019-12-02,2019-12-02,2019-12-02,4.0,1284.93,8286.43,0.0,505.0,           ,1.0,1.0,203.0
3282,Ruoka_paivittaistavarakauppa,2019-12-02 20:19:24.255319147,2019-12-02,2019-12-02,2019-12-02,4.0,-4.21,8282.22,0.0,162.0,           ,1.0,1.0,99.0
3283,Liikkuminen,2019-12-03 02:39:19.148936168,2019-12-03,2019-12-03,2019-12-03,4.0,-121.5,8160.72,0.0,162.0,           ,1.0,1.0,181.0
3284,Luokittelemattomat,2019-12-03 08:59:14.042553189,2019-12-03,2019-12-03,2019-12-03,4.0,-3.63,8157.09,0.0,162.0,           ,1.0,1.0,145.0
3285,Terveys,2019-12-03 15:19:08.936170210,2019-12-03,2019-12-03,2019-12-03,4.0,-27.13,8129.96,0.0,162.0,           ,1.0,1.0,138.0
3286,Luottojen_maksut,2019-12-03 18:59:44.680851063,2019-12-03,2019-12-03,2019-12-03,4.0,-63.79,8066.17,0.0,172.0,           ,1.0,1.0,196.0
3287,Luottojen_maksut,2019-12-03 21:39:03.829787231,2019-12-03,2019-12-03,2019-12-03,4.0,-75.14,7991.03,0.0,162.0,           ,1.0,1.0,62.0
3288,Shoppailu,2019-12-04 03:58:58.723404252,2019-12-04,2019-12-04,2019-12-04,4.0,-142.29,7848.74,0.0,162.0,           ,1.0,1.0,139.0
3289,Ruoka_paivittaistavarakauppa,2019-12-04 05:18:38.297872336,2019-12-04,2019-12-04,2019-12-04,4.0,-6.37,7842.37,0.0,162.0,           ,1.0,1.0,80.0
3290,Ravintolat_kahvilat,2019-12-04 10:18:53.617021273,2019-12-04,2019-12-04,2019-12-04,4.0,-16.3,7826.07,0.0,162.0,           ,1.0,1.0,132.0
3291,Lapset,2019-12-04 16:38:48.510638294,2019-12-04,2019-12-04,2019-12-04,4.0,-3.25,7822.82,0.0,162.0,           ,1.0,1.0,178.0
3292,Ruoka_paivittaistavarakauppa,2019-12-04 22:58:43.404255315,2019-12-04,2019-12-04,2019-12-04,4.0,-2.47,7820.35,0.0,162.0,           ,1.0,1.0,139.0
3293,Muut,2019-12-05 11:38:33.191489357,2019-12-05,2019-12-05,2019-12-05,4.0,-37.15,7783.2,0.0,163.0,           ,1.0,1.0,189.0
3294,Luokittelemattomat,2019-12-05 17:58:28.085106378,2019-12-05,2019-12-05,2019-12-05,4.0,-609.97,7173.23,0.0,106.0,OKOYFIHH   ,1.0,0.0,45.0
3295,Luokittelemattomat,2019-12-06 00:18:22.978723399,2019-12-06,2019-12-06,2019-12-06,4.0,-54.99,7118.24,0.0,106.0,OKOYFIHH   ,1.0,0.0,9.0
3296,Ravintolat_kahvilat,2019-12-06 01:38:02.553191483,2019-12-06,2019-12-06,2019-12-06,4.0,-6.33,7111.91,0.0,162.0,           ,1.0,1.0,74.0
3297,Tulot,2019-12-06 06:38:17.872340420,2019-12-06,2019-12-06,2019-12-05,4.0,72.97,7184.88,710.0,506.0,           ,1.0,1.0,238.0
3298,Ravintolat_kahvilat,2019-12-06 12:58:12.765957441,2019-12-06,2019-12-06,2019-12-06,4.0,-77.36,7107.52,0.0,162.0,           ,1.0,1.0,67.0
3299,Ruoka_paivittaistavarakauppa,2019-12-06 19:18:07.659574462,2019-12-06,2019-12-06,2019-12-06,4.0,-8.54,7098.98,0.0,162.0,           ,1.0,1.0,102.0
3300,Muut,2019-12-07 15:37:31.914893609,2019-12-07,2019-12-07,2019-12-07,4.0,-115.09,6983.89,0.0,163.0,           ,1.0,1.0,190.0
3301,Luokittelemattomat,2019-12-07 20:37:47.234042546,2019-12-07,2019-12-07,2019-12-07,4.0,-311.58,6672.31,0.0,106.0,NDEAFIHH   ,1.0,0.0,9.0
3302,Muut,2019-12-09 02:57:42.127659567,2019-12-09,2019-12-09,2019-12-09,4.0,-36.96,6635.35,0.0,100.0,           ,1.0,1.0,0.0
3303,Luottojen_maksut,2019-12-09 04:17:21.702127651,2019-12-09,2019-12-09,2019-12-09,4.0,-26.8,6608.55,0.0,106.0,DABAFIHH   ,1.0,0.0,45.0
3304,Ruoka_paivittaistavarakauppa,2019-12-09 06:56:40.851063819,2019-12-09,2019-12-09,2019-12-09,4.0,-24.12,6584.43,0.0,162.0,           ,1.0,1.0,160.0
3305,Hyvinvointijakauneus,2019-12-09 07:57:57.446808504,2019-12-09,2019-12-09,2019-12-09,4.0,-23.68,6560.75,0.0,106.0,OKOYFIHH   ,0.0,0.0,7.0
3306,Liikkuminen,2019-12-09 09:17:37.021276588,2019-12-09,2019-12-09,2019-12-09,4.0,-15.86,6544.89,0.0,162.0,           ,1.0,1.0,53.0
3307,Harrastukset,2019-12-09 10:37:16.595744672,2019-12-09,2019-12-09,2019-12-09,4.0,-38.14,6506.75,0.0,162.0,           ,1.0,1.0,122.0
3308,Matkailu,2019-12-09 14:17:52.340425525,2019-12-09,2019-12-09,2019-12-09,4.0,-87.08,6419.67,0.0,106.0,OKOYFIHH   ,0.0,0.0,44.0
3309,Liikkuminen,2019-12-09 16:57:11.489361693,2019-12-09,2019-12-09,2019-12-09,4.0,-12.48,6407.19,0.0,162.0,           ,1.0,1.0,85.0
3310,Tulot,2019-12-09 21:57:26.808510630,2019-12-09,2019-12-09,2019-12-09,4.0,2871.14,9278.33,0.0,505.0,           ,1.0,1.0,203.0
3311,Liikkuminen,2019-12-09 23:17:06.382978714,2019-12-09,2019-12-09,2019-12-09,4.0,-40.61,9237.72,0.0,162.0,           ,1.0,1.0,174.0
3312,Liikkuminen,2019-12-10 00:36:45.957446798,2019-12-10,2019-12-10,2019-12-10,4.0,-3.3,9234.42,0.0,162.0,           ,1.0,1.0,125.0
3313,Ruoka_paivittaistavarakauppa,2019-12-10 05:37:01.276595735,2019-12-10,2019-12-10,2019-12-10,4.0,-92.25,9142.17,0.0,162.0,           ,1.0,1.0,95.0
3314,Luokittelemattomat,2019-12-10 11:56:56.170212756,2019-12-10,2019-12-10,2019-12-10,4.0,-121.4,9020.77,0.0,162.0,           ,1.0,1.0,125.0
3315,Ruoka_paivittaistavarakauppa,2019-12-10 18:16:51.063829777,2019-12-10,2019-12-10,2019-12-10,4.0,-6.01,9014.76,0.0,162.0,           ,1.0,1.0,100.0
3316,Liikkuminen,2019-12-12 01:56:25.531914882,2019-12-12,2019-12-12,2019-12-12,4.0,-82.07,8932.69,0.0,162.0,           ,1.0,1.0,85.0
3317,Hyvinvointijakauneus,2019-12-12 03:16:05.106382966,2019-12-12,2019-12-12,2019-12-12,4.0,-65.21,8867.48,706.0,129.0,OKOYFIHH   ,0.0,0.0,232.0
3318,Liikkuminen,2019-12-12 08:16:20.425531903,2019-12-12,2019-12-12,2019-12-12,4.0,-225.0,8642.48,0.0,162.0,           ,1.0,1.0,117.0
3319,Luottojen_maksut,2019-12-12 10:55:39.574468071,2019-12-12,2019-12-12,2019-12-12,4.0,-393.12,8249.36,0.0,172.0,           ,1.0,1.0,199.0
3320,Tulot,2019-12-12 13:16:35.744680840,2019-12-12,2019-12-12,2019-12-12,4.0,1406.86,9656.22,0.0,506.0,           ,1.0,1.0,209.0
3321,Liikkuminen,2019-12-12 17:15:34.468085092,2019-12-12,2019-12-12,2019-12-12,4.0,-23.78,9632.44,0.0,162.0,           ,1.0,1.0,166.0
3322,Ruoka_paivittaistavarakauppa,2019-12-12 19:36:30.638297861,2019-12-12,2019-12-12,2019-12-12,4.0,-13.49,9618.95,0.0,162.0,           ,1.0,1.0,181.0
3323,Luokittelemattomat,2019-12-13 09:35:59.999999987,2019-12-13,2019-12-13,2019-12-13,4.0,-1106.09,8512.86,0.0,106.0,NDEAFIHH   ,1.0,0.0,18.0
3324,Tulot,2019-12-13 14:36:15.319148924,2019-12-13,2019-12-13,2019-12-13,4.0,226.04,8738.9,701.0,506.0,           ,1.0,1.0,215.0
3325,Vakuutukset,2019-12-13 15:55:54.893617008,2019-12-13,2019-12-13,2019-12-13,4.0,-20.1,8718.8,0.0,106.0,OKOYFIHH   ,0.0,0.0,31.0
3326,Luottojen_maksut,2019-12-13 20:56:10.212765945,2019-12-13,2019-12-13,2019-12-13,4.0,-1042.13,7676.67,0.0,172.0,           ,1.0,1.0,195.0
3327,Liikkuminen,2019-12-13 22:15:49.787234029,2019-12-13,2019-12-13,2019-12-13,4.0,-12.58,7664.09,0.0,106.0,OKOYFIHH   ,1.0,0.0,36.0
3328,Lemmikit,2019-12-13 23:35:29.361702113,2019-12-13,2019-12-13,2019-12-13,4.0,-5.62,7658.47,0.0,162.0,           ,1.0,1.0,95.0
3329,Hyvinvointijakauneus,2019-12-14 04:35:44.680851050,2019-12-14,2019-12-14,2019-12-14,4.0,-7.68,7650.79,0.0,106.0,OKOYFIHH   ,0.0,0.0,28.0
3330,Liikkuminen,2019-12-16 00:55:08.936170197,2019-12-16,2019-12-16,2019-12-16,4.0,-23.53,7627.26,0.0,162.0,           ,1.0,1.0,111.0
3331,Lapset,2019-12-16 05:55:24.255319134,2019-12-16,2019-12-16,2019-12-16,4.0,-26.57,7600.69,0.0,162.0,           ,1.0,1.0,168.0
3332,Ruoka_paivittaistavarakauppa,2019-12-16 07:15:03.829787218,2019-12-16,2019-12-16,2019-12-16,4.0,-15.16,7585.53,0.0,162.0,           ,1.0,1.0,147.0
3333,Tulot,2019-12-16 08:34:43.404255302,2019-12-16,2019-12-16,2019-12-16,4.0,582.03,8167.56,0.0,505.0,           ,1.0,1.0,205.0
3334,Muut,2019-12-16 12:15:19.148936155,2019-12-16,2019-12-16,2019-12-16,4.0,-7.98,8159.58,0.0,162.0,           ,1.0,1.0,139.0
3335,Liikkuminen,2019-12-16 13:34:58.723404239,2019-12-16,2019-12-16,2019-12-16,4.0,-30.99,8128.59,0.0,162.0,           ,1.0,1.0,111.0
3336,Luokittelemattomat,2019-12-16 18:35:14.042553176,2019-12-16,2019-12-16,2019-12-16,4.0,-47.48,8081.11,0.0,162.0,           ,1.0,1.0,102.0
3337,Ruoka_paivittaistavarakauppa,2019-12-16 19:54:53.617021260,2019-12-16,2019-12-16,2019-12-16,4.0,-17.28,8063.83,0.0,162.0,           ,1.0,1.0,160.0
3338,Ruoka_paivittaistavarakauppa,2019-12-17 14:54:38.297872323,2019-12-17,2019-12-17,2019-12-17,4.0,-2.8,8061.03,0.0,162.0,           ,1.0,1.0,79.0
3339,Asuminen,2019-12-17 16:14:17.872340407,2019-12-17,2019-12-17,2019-12-17,4.0,-28.71,8032.32,0.0,106.0,OKOYFIHH   ,0.0,0.0,44.0
3340,Ravintolat_kahvilat,2019-12-18 02:14:48.510638281,2019-12-18,2019-12-18,2019-12-18,4.0,-3.6,8028.72,0.0,162.0,           ,1.0,1.0,143.0
3341,Ruoka_paivittaistavarakauppa,2019-12-18 03:34:28.085106365,2019-12-18,2019-12-18,2019-12-18,4.0,-14.59,8014.13,0.0,162.0,           ,1.0,1.0,99.0
3342,Tulot,2019-12-18 21:14:33.191489344,2019-12-18,2019-12-18,2019-12-18,4.0,3581.25,11595.38,701.0,506.0,           ,1.0,1.0,215.0
3343,Asuminen,2019-12-19 04:54:07.659574449,2019-12-19,2019-12-19,2019-12-19,4.0,-37.51,11557.87,0.0,106.0,OKOYFIHH   ,0.0,0.0,7.0
3344,Vakuutukset,2019-12-19 09:54:22.978723386,2019-12-19,2019-12-19,2019-12-19,4.0,-454.26,11103.61,0.0,106.0,OKOYFIHH   ,0.0,0.0,8.0
3345,Ruoka_paivittaistavarakauppa,2019-12-19 11:14:02.553191470,2019-12-19,2019-12-19,2019-12-19,4.0,-7.99,11095.62,0.0,162.0,           ,1.0,1.0,160.0
3346,Liikkuminen,2019-12-19 17:33:57.446808491,2019-12-19,2019-12-19,2019-12-19,4.0,-11.81,11083.81,0.0,162.0,           ,1.0,1.0,64.0
3347,Luottojen_maksut,2019-12-19 22:34:12.765957428,2019-12-19,2019-12-19,2019-12-19,4.0,-180.81,10903.0,0.0,106.0,OKOYFIHH   ,1.0,0.0,45.0
3348,Ravintolat_kahvilat,2019-12-19 23:53:52.340425512,2019-12-19,2019-12-19,2019-12-19,4.0,-109.41,10793.59,0.0,162.0,           ,1.0,1.0,103.0
3349,Saastot_sijoitukset,2019-12-20 01:13:31.914893596,2019-12-20,2019-12-20,2019-12-19,4.0,-37.91,10755.68,0.0,162.0,           ,1.0,1.0,130.0
3350,Liikkuminen,2019-12-20 06:13:47.234042533,2019-12-20,2019-12-20,2019-12-20,4.0,-11.63,10744.05,0.0,162.0,           ,1.0,1.0,137.0
3351,Ravintolat_kahvilat,2019-12-20 07:33:26.808510617,2019-12-20,2019-12-20,2019-12-20,4.0,-8.55,10735.5,0.0,162.0,           ,1.0,1.0,144.0
3352,Liikkuminen,2019-12-20 12:33:42.127659554,2019-12-20,2019-12-20,2019-12-20,4.0,-93.18,10642.32,0.0,162.0,           ,1.0,1.0,136.0
3353,Ravintolat_kahvilat,2019-12-20 18:53:37.021276575,2019-12-20,2019-12-20,2019-12-20,4.0,-5.69,10636.63,0.0,162.0,           ,1.0,1.0,109.0
3354,Ruoka_paivittaistavarakauppa,2019-12-20 20:13:16.595744659,2019-12-20,2019-12-20,2019-12-20,4.0,-16.67,10619.96,0.0,162.0,           ,1.0,1.0,100.0
3355,Muut,2019-12-22 22:52:35.744680827,2019-12-22,2019-12-22,2019-12-22,4.0,-29.94,10590.02,0.0,105.0,OKOYFIHH   ,1.0,0.0,4.0
3356,Ravintolat_kahvilat,2019-12-23 02:33:11.489361680,2019-12-23,2019-12-23,2019-12-23,4.0,-16.68,10573.34,0.0,162.0,           ,1.0,1.0,116.0
3357,Ruoka_paivittaistavarakauppa,2019-12-23 03:52:51.063829764,2019-12-23,2019-12-23,2019-12-23,4.0,-171.37,10401.97,0.0,162.0,           ,1.0,1.0,103.0
3358,Luokittelemattomat,2019-12-23 08:53:06.382978701,2019-12-23,2019-12-23,2019-12-23,4.0,-23.71,10378.26,0.0,162.0,           ,1.0,1.0,103.0
3359,Liikkuminen,2019-12-23 10:12:45.957446785,2019-12-23,2019-12-23,2019-12-23,4.0,-88.19,10290.07,0.0,162.0,           ,1.0,1.0,123.0
3360,Luottojen_maksut,2019-12-23 13:53:21.702127638,2019-12-23,2019-12-23,2019-12-23,4.0,-20.83,10269.24,0.0,162.0,           ,1.0,1.0,61.0
3361,Liikkuminen,2019-12-23 15:13:01.276595722,2019-12-23,2019-12-23,2019-12-23,4.0,-13.23,10256.01,0.0,162.0,           ,1.0,1.0,152.0
3362,Asuminen,2019-12-23 17:52:20.425531890,2019-12-23,2019-12-24,2019-12-23,4.0,-21.65,10234.36,0.0,162.0,           ,1.0,1.0,85.0
3363,Terveys,2019-12-23 21:32:56.170212743,2019-12-23,2019-12-23,2019-12-23,4.0,-25.3,10209.06,0.0,162.0,           ,1.0,1.0,139.0
3364,Ruoka_paivittaistavarakauppa,2019-12-24 11:32:25.531914869,2019-12-24,2019-12-24,2019-12-24,4.0,-348.56,9860.5,0.0,162.0,           ,1.0,1.0,112.0
3365,Luottojen_maksut,2019-12-25 12:52:05.106382953,2019-12-25,2019-12-25,2019-12-25,4.0,-59.99,9800.51,0.0,129.0,HANDFIHH   ,0.0,0.0,49.0
3366,Luottojen_maksut,2019-12-25 16:32:40.851063806,2019-12-25,2019-12-25,2019-12-25,4.0,-35.66,9764.85,0.0,106.0,OKOYFIHH   ,0.0,0.0,44.0
3367,Liikkuminen,2019-12-25 16:51:03.829787205,2019-12-25,2019-12-25,2019-12-25,4.0,-41.49,9723.36,0.0,162.0,           ,1.0,1.0,122.0
3368,Luokittelemattomat,2019-12-25 19:11:59.999999974,2019-12-25,2019-12-25,2019-12-25,4.0,-36.31,9687.05,0.0,106.0,OKOYFIHH   ,1.0,0.0,15.0
3369,Liikkuminen,2019-12-25 20:31:39.574468058,2019-12-25,2019-12-25,2019-12-25,4.0,-40.92,9646.13,0.0,162.0,           ,1.0,1.0,160.0
3370,Asuminen,2019-12-26 00:12:15.319148911,2019-12-26,2019-12-26,2019-12-26,4.0,-27.01,9619.12,0.0,162.0,           ,1.0,1.0,116.0
3371,Asuminen,2019-12-26 01:31:54.893616995,2019-12-26,2019-12-27,2019-12-26,4.0,-25.29,9593.83,0.0,106.0,OKOYFIHH   ,0.0,0.0,13.0
3372,Muut,2019-12-26 05:12:30.638297848,2019-12-26,2019-12-26,2019-12-26,4.0,-471.57,9122.26,0.0,105.0,OKOYFIHH   ,1.0,0.0,5.0
3373,Liikkuminen,2019-12-26 06:32:10.212765932,2019-12-26,2019-12-26,2019-12-26,4.0,-66.79,9055.47,0.0,162.0,           ,1.0,1.0,128.0
3374,Liikkuminen,2019-12-26 10:31:08.936170184,2019-12-26,2019-12-26,2019-12-26,4.0,-129.73,8925.74,0.0,162.0,           ,1.0,1.0,139.0
3375,Asuminen,2019-12-26 14:11:44.680851037,2019-12-26,2019-12-26,2019-12-26,4.0,-23.92,8901.82,0.0,162.0,           ,1.0,1.0,135.0
3376,Asuminen,2019-12-26 23:10:58.723404226,2019-12-26,2019-12-26,2019-12-26,4.0,-64.84,8836.98,0.0,162.0,           ,1.0,1.0,107.0
3377,Saastot_sijoitukset,2019-12-27 02:51:34.468085079,2019-12-27,2019-12-27,2019-12-27,4.0,-29.78,8807.2,0.0,162.0,           ,1.0,1.0,93.0
3378,Saastot_sijoitukset,2019-12-27 04:11:14.042553163,2019-12-27,2019-12-27,2019-12-26,4.0,-44.15,8763.05,0.0,162.0,           ,1.0,1.0,177.0
3379,Ruoka_paivittaistavarakauppa,2019-12-27 07:51:49.787234016,2019-12-27,2019-12-27,2019-12-27,4.0,-19.27,8743.78,0.0,162.0,           ,1.0,1.0,80.0
3380,Lapset,2019-12-27 09:11:29.361702100,2019-12-27,2019-12-27,2019-12-27,4.0,-64.89,8678.89,0.0,162.0,           ,1.0,1.0,54.0
3381,Ruoka_paivittaistavarakauppa,2019-12-27 15:31:24.255319121,2019-12-27,2019-12-27,2019-12-27,4.0,-95.6,8583.29,0.0,162.0,           ,1.0,1.0,123.0
3382,Liikkuminen,2019-12-27 21:51:19.148936142,2019-12-27,2019-12-27,2019-12-27,4.0,-48.07,8535.22,0.0,162.0,           ,1.0,1.0,139.0
3383,Ravintolat_kahvilat,2019-12-30 00:30:38.297872310,2019-12-30,2019-12-31,2019-12-30,4.0,-1.75,8533.47,0.0,162.0,           ,1.0,1.0,132.0
3384,Asuminen,2019-12-30 05:30:53.617021247,2019-12-30,2019-12-30,2019-12-30,4.0,-70.22,8463.25,0.0,162.0,           ,1.0,1.0,152.0
3385,Ruoka_paivittaistavarakauppa,2019-12-30 06:50:33.191489331,2019-12-30,2019-12-30,2019-12-30,4.0,-32.59,8430.66,0.0,162.0,           ,1.0,1.0,184.0
3386,Liikkuminen,2019-12-30 08:10:12.765957415,2019-12-30,2019-12-30,2019-12-30,4.0,-12.42,8418.24,0.0,162.0,           ,1.0,1.0,123.0
3387,Hyvinvointi,2019-12-30 19:30:22.978723373,2019-12-30,2019-12-30,2019-12-30,4.0,-30.11,8388.13,0.0,162.0,           ,1.0,1.0,84.0
3388,Ruoka_paivittaistavarakauppa,2019-12-30 20:50:02.553191457,2019-12-30,2019-12-30,2019-12-30,4.0,-13.27,8374.86,0.0,162.0,           ,1.0,1.0,106.0
3389,Ruoka_paivittaistavarakauppa,2019-12-31 01:50:17.872340394,2019-12-31,2019-12-31,2019-12-31,4.0,-3.14,8371.72,0.0,162.0,           ,1.0,1.0,120.0
3390,Liikkuminen,2019-12-31 11:50:48.510638268,2019-12-31,2019-12-31,2019-12-31,4.0,-12.55,8359.17,0.0,162.0,           ,1.0,1.0,106.0
3391,Muut,2019-12-31 13:10:28.085106352,2019-12-31,2019-12-31,2019-12-31,4.0,-1035.86,7323.31,0.0,163.0,           ,1.0,1.0,190.0
3392,Asuminen,2019-12-31 14:30:07.659574436,2019-12-31,2019-12-31,2019-12-31,4.0,-15.64,7307.67,0.0,162.0,           ,1.0,1.0,170.0
3393,Luokittelemattomat,2019-12-31 18:10:43.404255289,2019-12-31,2019-12-31,2019-12-31,4.0,-16.22,7291.45,0.0,162.0,           ,1.0,1.0,160.0
3394,Tulot,2020-01-01 10:15:43.448275862,2020-01-01,2020-01-01,2020-01-01,4.0,7.5,7298.95,710.0,506.0,           ,1.0,1.0,240.0
3395,Ruoka_paivittaistavarakauppa,2020-01-01 20:31:26.896551724,2020-01-01,2020-01-01,2020-01-01,4.0,-79.8,7219.15,0.0,162.0,           ,1.0,1.0,127.0
3396,Ruoka_paivittaistavarakauppa,2020-01-02 06:47:10.344827586,2020-01-02,2020-01-02,2020-01-02,4.0,-44.35,7174.8,0.0,162.0,           ,1.0,1.0,158.0
3397,Ravintolat_kahvilat,2020-01-02 17:02:53.793103448,2020-01-02,2020-01-02,2020-01-02,4.0,-6.15,7168.65,0.0,162.0,           ,1.0,1.0,181.0
3398,Ruoka_paivittaistavarakauppa,2020-01-03 03:18:37.241379310,2020-01-03,2020-01-03,2020-01-03,4.0,-57.59,7111.06,0.0,162.0,           ,1.0,1.0,72.0
3399,Tulot,2020-01-03 10:05:47.586206896,2020-01-03,2020-01-03,2020-01-03,4.0,424.64,7535.7,0.0,505.0,           ,1.0,1.0,203.0
3400,Luokittelemattomat,2020-01-03 13:34:20.689655172,2020-01-03,2020-01-03,2020-01-03,4.0,-9.04,7526.66,0.0,162.0,           ,1.0,1.0,93.0
3401,Muut,2020-01-03 20:21:31.034482758,2020-01-03,2020-01-03,2020-01-03,4.0,-23.44,7503.22,0.0,162.0,           ,1.0,1.0,95.0
3402,Matkailu,2020-01-03 23:50:04.137931034,2020-01-03,2020-01-03,2020-01-03,4.0,-60.65,7442.57,0.0,162.0,           ,1.0,1.0,168.0
3403,Saastot_sijoitukset,2020-01-06 03:08:41.379310344,2020-01-06,2020-01-06,2020-01-06,4.0,-13.86,7428.71,0.0,162.0,           ,1.0,1.0,135.0
3404,Liikkuminen,2020-01-06 06:27:18.620689654,2020-01-06,2020-01-06,2020-01-06,4.0,-32.62,7396.09,0.0,162.0,           ,1.0,1.0,57.0
3405,Ruoka_paivittaistavarakauppa,2020-01-06 06:37:14.482758620,2020-01-06,2020-01-06,2020-01-06,4.0,-65.73,7330.36,0.0,162.0,           ,1.0,1.0,160.0
3406,Liikkuminen,2020-01-06 13:24:24.827586206,2020-01-06,2020-01-06,2020-01-06,4.0,-38.39,7291.97,0.0,162.0,           ,1.0,1.0,115.0
3407,Ruoka_paivittaistavarakauppa,2020-01-06 16:52:57.931034482,2020-01-06,2020-01-06,2020-01-06,4.0,-52.49,7239.48,0.0,162.0,           ,1.0,1.0,181.0
3408,Muut,2020-01-07 09:55:51.724137930,2020-01-07,2020-01-07,2020-01-07,4.0,-86.36,7153.12,0.0,163.0,           ,1.0,1.0,189.0
3409,Liikkuminen,2020-01-07 20:11:35.172413792,2020-01-07,2020-01-07,2020-01-07,4.0,-37.82,7115.3,0.0,162.0,           ,1.0,1.0,95.0
3410,Tulot,2020-01-07 23:40:08.275862068,2020-01-07,2020-01-07,2020-01-07,4.0,210.07,7325.37,0.0,505.0,           ,1.0,1.0,204.0
3411,Ruoka_paivittaistavarakauppa,2020-01-08 16:43:02.068965516,2020-01-08,2020-01-08,2020-01-08,4.0,-108.05,7217.32,0.0,162.0,           ,1.0,1.0,139.0
3412,Liikkuminen,2020-01-09 02:58:45.517241378,2020-01-09,2020-01-09,2020-01-09,4.0,-13.85,7203.47,0.0,162.0,           ,1.0,1.0,125.0
3413,Luokittelemattomat,2020-01-09 13:14:28.965517240,2020-01-09,2020-01-09,2020-01-09,4.0,-31.96,7171.51,0.0,162.0,           ,1.0,1.0,117.0
3414,Liikkuminen,2020-01-09 23:30:12.413793102,2020-01-09,2020-01-09,2020-01-09,4.0,-54.76,7116.75,0.0,162.0,           ,1.0,1.0,54.0
3415,Tulot,2020-01-10 09:45:55.862068964,2020-01-10,2020-01-10,2020-01-10,4.0,52.82,7169.57,0.0,506.0,           ,1.0,1.0,211.0
3416,Ravintolat_kahvilat,2020-01-10 16:33:06.206896550,2020-01-10,2020-01-10,2020-01-10,4.0,-99.35,7070.22,0.0,162.0,           ,1.0,1.0,139.0
3417,Kulttuuri_viihde,2020-01-10 20:01:39.310344826,2020-01-10,2020-01-10,2020-01-10,4.0,-7.4,7062.82,0.0,106.0,OKOYFIHH   ,0.0,0.0,45.0
3418,Lemmikit,2020-01-13 02:38:53.793103446,2020-01-13,2020-01-13,2020-01-13,4.0,-14.08,7048.74,0.0,162.0,           ,1.0,1.0,185.0
3419,Ruoka_paivittaistavarakauppa,2020-01-13 02:48:49.655172412,2020-01-13,2020-01-13,2020-01-13,4.0,-2.49,7046.25,0.0,162.0,           ,1.0,1.0,183.0
3420,Ravintolat_kahvilat,2020-01-13 06:17:22.758620688,2020-01-13,2020-01-13,2020-01-13,4.0,-7.76,7038.49,0.0,141.0,           ,1.0,1.0,52.0
3421,Ruoka_paivittaistavarakauppa,2020-01-13 09:35:59.999999998,2020-01-13,2020-01-13,2020-01-13,4.0,-6.87,7031.62,0.0,162.0,           ,1.0,1.0,109.0
3422,Ruoka_paivittaistavarakauppa,2020-01-13 13:04:33.103448274,2020-01-13,2020-01-13,2020-01-13,4.0,-35.26,6996.36,0.0,162.0,           ,1.0,1.0,134.0
3423,Ruoka_paivittaistavarakauppa,2020-01-13 16:23:10.344827584,2020-01-13,2020-01-13,2020-01-13,4.0,-12.14,6984.22,0.0,162.0,           ,1.0,1.0,71.0
3424,Ruoka_paivittaistavarakauppa,2020-01-13 19:51:43.448275860,2020-01-13,2020-01-15,2020-01-13,4.0,-10.31,6973.91,0.0,162.0,           ,1.0,1.0,120.0
3425,Liikkuminen,2020-01-13 23:20:16.551724136,2020-01-13,2020-01-13,2020-01-13,4.0,-4.48,6969.43,0.0,162.0,           ,1.0,1.0,116.0
3426,Tulot,2020-01-14 06:07:26.896551722,2020-01-14,2020-01-14,2020-01-14,4.0,1583.52,8552.95,710.0,506.0,           ,1.0,1.0,240.0
3427,Ravintolat_kahvilat,2020-01-14 12:54:37.241379308,2020-01-14,2020-01-14,2020-01-14,4.0,-67.52,8485.43,0.0,162.0,           ,1.0,1.0,177.0
3428,Ruoka_paivittaistavarakauppa,2020-01-14 19:41:47.586206894,2020-01-14,2020-01-14,2020-01-14,4.0,-1.48,8483.95,0.0,162.0,           ,1.0,1.0,140.0
3429,Ravintolat_kahvilat,2020-01-14 23:10:20.689655170,2020-01-14,2020-01-14,2020-01-14,4.0,-4.43,8479.52,0.0,162.0,           ,1.0,1.0,160.0
3430,Tulot,2020-01-16 09:16:08.275862066,2020-01-16,2020-01-16,2020-01-16,4.0,184.63,8664.15,701.0,506.0,           ,1.0,1.0,215.0
3431,Ruoka_paivittaistavarakauppa,2020-01-16 09:26:04.137931032,2020-01-16,2020-01-16,2020-01-16,4.0,-81.05,8583.1,0.0,162.0,           ,1.0,1.0,115.0
3432,Luottojen_maksut,2020-01-16 23:00:24.827586204,2020-01-16,2020-01-16,2020-01-16,4.0,-1105.11,7477.99,0.0,172.0,           ,1.0,1.0,195.0
3433,Muut,2020-01-17 02:28:57.931034480,2020-01-17,2020-01-17,2020-01-17,4.0,-50.14,7427.85,0.0,192.0,           ,0.0,1.0,201.0
3434,Ruoka_paivittaistavarakauppa,2020-01-17 05:57:31.034482756,2020-01-17,2020-01-17,2020-01-17,4.0,-23.17,7404.68,0.0,162.0,           ,1.0,1.0,59.0
3435,Luottojen_maksut,2020-01-17 12:44:41.379310342,2020-01-17,2020-01-17,2020-01-17,4.0,-153.13,7251.55,0.0,172.0,           ,1.0,1.0,197.0
3436,Terveys,2020-01-17 16:13:14.482758618,2020-01-17,2020-01-17,2020-01-17,4.0,406.48,7658.03,0.0,505.0,           ,1.0,1.0,205.0
3437,Liikkuminen,2020-01-20 05:47:35.172413790,2020-01-20,2020-01-20,2020-01-20,4.0,-119.02,7539.01,0.0,106.0,OKOYFIHH   ,0.0,0.0,36.0
3438,Terveys,2020-01-20 09:06:12.413793100,2020-01-20,2020-01-20,2020-01-20,4.0,-151.06,7387.95,0.0,106.0,HANDFIHH   ,0.0,0.0,44.0
3439,Matkailu,2020-01-20 16:03:18.620689652,2020-01-20,2020-01-20,2020-01-20,4.0,-230.53,7157.42,0.0,106.0,ESSEFIHX   ,0.0,0.0,35.0
3440,Ruoka_paivittaistavarakauppa,2020-01-20 19:31:51.724137928,2020-01-20,2020-01-20,2020-01-20,4.0,-8.44,7148.98,0.0,162.0,           ,1.0,1.0,64.0
3441,Asuminen,2020-01-20 22:50:28.965517238,2020-01-20,2020-01-20,2020-01-20,4.0,-231.01,6917.97,0.0,106.0,OKOYFIHH   ,0.0,0.0,9.0
3442,Liikkuminen,2020-01-21 02:19:02.068965514,2020-01-21,2020-01-21,2020-01-21,4.0,-47.18,6870.79,0.0,106.0,NDEAFIHH   ,1.0,0.0,40.0
3443,Muut,2020-01-21 12:34:45.517241376,2020-01-21,2020-01-21,2020-01-21,4.0,-41.63,6829.16,0.0,106.0,OKOYFIHH   ,0.0,0.0,13.0
3444,Luokittelemattomat,2020-01-22 19:21:55.862068962,2020-01-22,2020-01-22,2020-01-22,4.0,-26.48,6802.68,0.0,106.0,OKOYFIHH   ,1.0,0.0,9.0
3445,Lemmikit,2020-01-23 02:09:06.206896548,2020-01-23,2020-01-23,2020-01-23,4.0,-5.71,6796.97,0.0,162.0,           ,1.0,1.0,152.0
3446,Asuminen,2020-01-23 05:37:39.310344824,2020-01-23,2020-01-23,2020-01-23,4.0,-23.45,6773.52,0.0,106.0,OKOYFIHH   ,0.0,0.0,35.0
3447,Ruoka_paivittaistavarakauppa,2020-01-23 12:24:49.655172410,2020-01-23,2020-01-23,2020-01-23,4.0,-110.28,6663.24,0.0,103.0,           ,0.0,1.0,3.0
3448,Luokittelemattomat,2020-01-23 15:53:22.758620686,2020-01-23,2020-01-23,2020-01-23,4.0,-22.78,6640.46,0.0,162.0,           ,1.0,1.0,120.0
3449,Luottojen_maksut,2020-01-23 22:40:33.103448272,2020-01-23,2020-01-23,2020-01-23,4.0,-53.8,6586.66,0.0,106.0,OKOYFIHH   ,0.0,0.0,26.0
3450,Muut,2020-01-24 19:11:59.999999996,2020-01-24,2020-01-24,2020-01-24,4.0,-78.51,6508.15,0.0,163.0,           ,1.0,1.0,190.0
3451,Ruoka_paivittaistavarakauppa,2020-01-27 01:59:10.344827582,2020-01-27,2020-01-27,2020-01-27,4.0,-1.97,6506.18,0.0,162.0,           ,1.0,1.0,54.0
3452,Ruoka_paivittaistavarakauppa,2020-01-27 05:27:43.448275858,2020-01-27,2020-01-27,2020-01-27,4.0,-21.31,6484.87,0.0,162.0,           ,1.0,1.0,91.0
3453,Liikkuminen,2020-01-27 08:56:16.551724134,2020-01-27,2020-01-27,2020-01-27,4.0,-7.24,6477.63,0.0,162.0,           ,1.0,1.0,139.0
3454,Ravintolat_kahvilat,2020-01-27 15:43:26.896551720,2020-01-27,2020-01-27,2020-01-27,4.0,-6.75,6470.88,0.0,162.0,           ,1.0,1.0,127.0
3455,Luokittelemattomat,2020-01-27 22:30:37.241379306,2020-01-27,2020-01-27,2020-01-27,4.0,-93.4,6377.48,0.0,162.0,           ,1.0,1.0,154.0
3456,Ruoka_paivittaistavarakauppa,2020-01-28 05:17:47.586206892,2020-01-28,2020-01-28,2020-01-28,4.0,-11.53,6365.95,0.0,162.0,           ,1.0,1.0,124.0
3457,Ruoka_paivittaistavarakauppa,2020-01-28 08:46:20.689655168,2020-01-28,2020-01-28,2020-01-28,4.0,-2.61,6363.34,0.0,162.0,           ,1.0,1.0,159.0
3458,Tulot,2020-01-28 12:14:53.793103444,2020-01-28,2020-01-28,2020-01-28,4.0,106.93,6470.27,0.0,506.0,           ,1.0,1.0,210.0
3459,Luottojen_maksut,2020-01-28 15:33:31.034482754,2020-01-28,2020-01-28,2020-01-28,4.0,-28.32,6441.95,0.0,129.0,NDEAFIHH   ,0.0,0.0,50.0
3460,Saastot_sijoitukset,2020-01-28 19:02:04.137931030,2020-01-28,2020-01-28,2020-01-28,4.0,-42.89,6399.06,0.0,162.0,           ,1.0,1.0,56.0
3461,Luottojen_maksut,2020-01-29 22:20:41.379310340,2020-01-29,2020-01-29,2020-01-29,4.0,-141.27,6257.79,0.0,106.0,DABAFIHH   ,1.0,0.0,11.0
3462,Lapset,2020-01-30 01:49:14.482758616,2020-01-30,2020-01-30,2020-01-30,4.0,-13.99,6243.8,0.0,106.0,OKOYFIHH   ,0.0,0.0,19.0
3463,Hyvinvointijakauneus,2020-01-30 08:36:24.827586202,2020-01-30,2020-01-30,2020-01-30,4.0,-28.13,6215.67,0.0,106.0,OKOYFIHH   ,0.0,0.0,48.0
3464,Matkailu,2020-01-30 12:04:57.931034478,2020-01-30,2020-01-30,2020-01-30,4.0,-45.31,6170.36,0.0,106.0,DABAFIHH   ,1.0,0.0,47.0
3465,Terveys,2020-01-31 18:52:08.275862064,2020-01-31,2020-01-31,2020-01-31,4.0,-71.54,6098.82,0.0,106.0,HANDFIHH   ,0.0,0.0,26.0
3466,Liikkuminen,2020-02-03 14:19:42.089552238,2020-02-03,2020-02-03,2020-02-03,4.0,-450.55,5648.27,0.0,106.0,DABAFIHH   ,1.0,0.0,48.0
3467,Shoppailu,2020-02-03 17:33:08.059701492,2020-02-03,2020-02-03,2020-02-03,4.0,-88.37,5559.9,0.0,162.0,           ,1.0,1.0,95.0
3468,Ruoka_paivittaistavarakauppa,2020-02-03 20:46:34.029850746,2020-02-03,2020-02-03,2020-02-03,4.0,-41.46,5518.44,0.0,162.0,           ,1.0,1.0,96.0
3469,Asuminen,2020-02-04 11:06:16.119402984,2020-02-04,2020-02-04,2020-02-04,4.0,-16.52,5501.92,0.0,106.0,OKOYFIHH   ,0.0,0.0,15.0
3470,Luokittelemattomat,2020-02-05 07:52:50.149253730,2020-02-05,2020-02-05,2020-02-05,4.0,-62.81,5439.11,0.0,106.0,OKOYFIHH   ,1.0,0.0,22.0
3471,Matkailu,2020-02-06 04:39:24.179104476,2020-02-06,2020-02-06,2020-02-06,4.0,-17.07,5422.04,0.0,170.0,           ,1.0,1.0,192.0
3472,Ravintolat_kahvilat,2020-02-07 01:25:58.208955222,2020-02-07,2020-02-07,2020-02-07,4.0,-33.73,5388.31,0.0,106.0,OKOYFIHH   ,0.0,0.0,43.0
3473,Muut,2020-02-07 18:59:06.268656714,2020-02-07,2020-02-07,2020-02-07,4.0,-11.23,5377.08,0.0,162.0,           ,1.0,1.0,149.0
3474,Muut,2020-02-07 22:12:32.238805968,2020-02-07,2020-02-07,2020-02-07,4.0,-20.36,5356.72,706.0,129.0,NDEAFIHH   ,0.0,0.0,227.0
3475,Tulot,2020-02-10 12:32:14.328358206,2020-02-10,2020-02-12,2020-02-10,4.0,-43.14,5313.58,0.0,162.0,           ,1.0,1.0,73.0
3476,Ruoka_paivittaistavarakauppa,2020-02-10 15:45:40.298507460,2020-02-10,2020-02-10,2020-02-10,4.0,-19.01,5294.57,0.0,162.0,           ,1.0,1.0,91.0
3477,Liikkuminen,2020-02-11 09:18:48.358208952,2020-02-11,2020-02-11,2020-02-11,4.0,-47.25,5247.32,0.0,162.0,           ,1.0,1.0,55.0
3478,Tulot,2020-02-12 06:05:22.388059698,2020-02-12,2020-02-12,2020-02-12,4.0,357.76,5605.08,701.0,521.0,           ,1.0,1.0,221.0
3479,Tulot,2020-02-13 02:51:56.417910444,2020-02-13,2020-02-13,2020-02-13,4.0,1576.75,7181.83,701.0,506.0,           ,1.0,1.0,215.0
3480,Liikkuminen,2020-02-14 23:38:30.447761190,2020-02-14,2020-02-14,2020-02-14,4.0,-42.42,7139.41,0.0,106.0,OKOYFIHH   ,0.0,0.0,44.0
3481,Luokittelemattomat,2020-02-15 13:58:12.537313428,2020-02-15,2020-02-15,2020-02-15,4.0,-18.83,7120.58,0.0,129.0,NDEAFIHH   ,0.0,0.0,51.0
3482,Lapset,2020-02-15 17:11:38.507462682,2020-02-15,2020-02-15,2020-02-15,4.0,-15.71,7104.87,0.0,106.0,OKOYFIHH   ,0.0,0.0,40.0
3483,Ruoka_paivittaistavarakauppa,2020-02-17 10:44:46.567164174,2020-02-17,2020-02-17,2020-02-17,4.0,-128.08,6976.79,0.0,106.0,OKOYFIHH   ,0.0,0.0,10.0
3484,Luottojen_maksut,2020-02-18 07:31:20.597014920,2020-02-18,2020-02-18,2020-02-18,4.0,-83.0,6893.79,0.0,106.0,NDEAFIHH   ,1.0,0.0,7.0
3485,Muut,2020-02-18 20:25:04.477611936,2020-02-18,2020-02-19,2020-02-18,4.0,-3.02,6890.77,0.0,103.0,           ,0.0,1.0,2.0
3486,Luokittelemattomat,2020-02-19 04:17:54.626865666,2020-02-19,2020-02-19,2020-02-19,4.0,-57.81,6832.96,0.0,106.0,NDEAFIHH   ,0.0,0.0,29.0
3487,Asuminen,2020-02-20 01:04:28.656716412,2020-02-20,2020-02-20,2020-02-20,4.0,-23.78,6809.18,0.0,106.0,OKOYFIHH   ,0.0,0.0,45.0
3488,Muut,2020-02-20 18:37:36.716417904,2020-02-20,2020-02-20,2020-02-20,4.0,-77.67,6731.51,0.0,162.0,           ,1.0,1.0,95.0
3489,Matkailu,2020-02-20 21:51:02.686567158,2020-02-20,2020-02-20,2020-02-20,4.0,-72.14,6659.37,0.0,162.0,           ,1.0,1.0,128.0
3490,Liikkuminen,2020-02-21 15:24:10.746268650,2020-02-21,2020-02-21,2020-02-21,4.0,-42.06,6617.31,0.0,162.0,           ,1.0,1.0,106.0
3491,Luottojen_maksut,2020-02-24 08:57:18.805970142,2020-02-24,2020-02-26,2020-02-24,4.0,-5.18,6612.13,0.0,162.0,           ,1.0,1.0,132.0
3492,Ruoka_paivittaistavarakauppa,2020-02-24 12:10:44.776119396,2020-02-24,2020-02-24,2020-02-24,4.0,-22.73,6589.4,0.0,162.0,           ,1.0,1.0,76.0
3493,Ravintolat_kahvilat,2020-02-25 23:17:00.895522380,2020-02-25,2020-02-25,2020-02-25,4.0,-9.11,6580.29,0.0,162.0,           ,1.0,1.0,144.0
3494,Harrastukset,2020-02-26 02:30:26.865671634,2020-02-26,2020-02-26,2020-02-26,4.0,-13.72,6566.57,0.0,162.0,           ,1.0,1.0,76.0
3495,Liikkuminen,2020-02-26 05:43:52.835820888,2020-02-26,2020-02-26,2020-02-26,4.0,-29.61,6536.96,0.0,162.0,           ,1.0,1.0,170.0
3496,Ravintolat_kahvilat,2020-02-27 13:36:42.985074618,2020-02-27,2020-02-27,2020-02-27,4.0,-17.92,6519.04,0.0,162.0,           ,1.0,1.0,184.0
3497,Matkailu,2020-02-27 20:03:34.925373126,2020-02-27,2020-02-27,2020-02-27,4.0,-126.01,6393.03,706.0,147.0,OKOYFIHH   ,0.0,0.0,235.0
3498,Tulot,2020-02-28 16:50:08.955223872,2020-02-28,2020-02-28,2020-02-28,4.0,2443.72,8836.75,701.0,506.0,           ,1.0,1.0,216.0
3499,Ruoka_paivittaistavarakauppa,2020-03-02 02:06:18.947368421,2020-03-02,2020-03-02,2020-03-02,4.0,-30.19,8806.56,0.0,162.0,           ,1.0,1.0,155.0
3500,Asuminen,2020-03-03 04:12:37.894736842,2020-03-03,2020-03-03,2020-03-03,4.0,-946.5,7860.06,0.0,106.0,OKOYFIHH   ,0.0,0.0,8.0
3501,Ruoka_paivittaistavarakauppa,2020-03-04 06:18:56.842105263,2020-03-04,2020-03-04,2020-03-04,4.0,-64.23,7795.83,0.0,162.0,           ,1.0,1.0,85.0
3502,Luokittelemattomat,2020-03-05 08:25:15.789473684,2020-03-05,2020-03-05,2020-03-05,4.0,-13.13,7782.7,0.0,162.0,           ,1.0,1.0,93.0
3503,Ruoka_paivittaistavarakauppa,2020-03-05 10:31:34.736842105,2020-03-05,2020-03-05,2020-03-05,4.0,-5.2,7777.5,0.0,162.0,           ,1.0,1.0,93.0
3504,Ravintolat_kahvilat,2020-03-09 12:37:53.684210526,2020-03-09,2020-03-09,2020-03-09,4.0,-58.7,7718.8,0.0,162.0,           ,1.0,1.0,127.0
3505,Ruoka_paivittaistavarakauppa,2020-03-09 14:44:12.631578947,2020-03-09,2020-03-09,2020-03-09,4.0,-47.46,7671.34,0.0,162.0,           ,1.0,1.0,54.0
3506,Ruoka_paivittaistavarakauppa,2020-03-09 16:50:31.578947368,2020-03-09,2020-03-09,2020-03-06,4.0,-60.04,7611.3,0.0,162.0,           ,1.0,1.0,103.0
3507,Tulot,2020-03-10 18:56:50.526315789,2020-03-10,2020-03-10,2020-03-10,4.0,2444.19,10055.49,701.0,521.0,           ,1.0,1.0,221.0
3508,Lapset,2020-03-12 01:15:47.368421052,2020-03-12,2020-03-12,2020-03-12,4.0,-17.98,10037.51,0.0,162.0,           ,1.0,1.0,139.0
3509,Matkailu,2020-03-12 21:03:09.473684210,2020-03-12,2020-03-12,2020-03-12,4.0,-424.85,9612.66,0.0,163.0,           ,1.0,1.0,189.0
3510,Ruoka_paivittaistavarakauppa,2020-03-12 23:09:28.421052631,2020-03-12,2020-03-12,2020-03-12,4.0,-17.24,9595.42,0.0,162.0,           ,1.0,1.0,170.0
3511,Ruoka_paivittaistavarakauppa,2020-03-13 03:22:06.315789473,2020-03-13,2020-03-13,2020-03-13,4.0,-1.28,9594.14,0.0,162.0,           ,1.0,1.0,119.0
3512,Hyvinvointijakauneus,2020-03-16 05:28:25.263157894,2020-03-16,2020-03-16,2020-03-16,4.0,-59.79,9534.35,0.0,162.0,           ,1.0,1.0,141.0
3513,Muut,2020-03-17 07:34:44.210526315,2020-03-17,2020-03-17,2020-03-17,4.0,-0.42,9533.93,0.0,103.0,           ,0.0,1.0,1.0
3514,Luokittelemattomat,2020-03-19 09:41:03.157894736,2020-03-19,2020-03-19,2020-03-19,4.0,-1384.49,8149.44,0.0,106.0,NDEAFIHH   ,0.0,0.0,25.0
3515,Luokittelemattomat,2020-03-19 11:47:22.105263157,2020-03-19,2020-03-19,2020-03-19,4.0,-852.12,7297.32,0.0,106.0,OKOYFIHH   ,1.0,0.0,19.0
3516,Ruoka_paivittaistavarakauppa,2020-03-20 13:53:41.052631578,2020-03-20,2020-03-20,2020-03-20,4.0,-42.41,7254.91,0.0,162.0,           ,1.0,1.0,140.0
3517,Ravintolat_kahvilat,2020-03-20 15:59:59.999999999,2020-03-20,2020-03-20,2020-03-20,4.0,-1.72,7253.19,0.0,162.0,           ,1.0,1.0,160.0
3518,Ruoka_paivittaistavarakauppa,2020-03-23 20:12:37.894736841,2020-03-23,2020-03-23,2020-03-23,4.0,-5.82,7247.37,0.0,162.0,           ,1.0,1.0,55.0
3519,Tulot,2020-03-25 18:06:18.947368420,2020-03-25,2020-03-25,2020-03-25,4.0,348.02,7595.39,710.0,506.0,           ,1.0,1.0,240.0
3520,Ruoka_paivittaistavarakauppa,2020-03-25 22:18:56.842105262,2020-03-25,2020-03-25,2020-03-25,4.0,-36.45,7558.94,0.0,162.0,           ,1.0,1.0,179.0
3521,Liikkuminen,2020-03-26 00:25:15.789473683,2020-03-26,2020-03-26,2020-03-26,4.0,-169.23,7389.71,0.0,162.0,           ,1.0,1.0,53.0
3522,Tulot,2020-03-27 02:31:34.736842104,2020-03-27,2020-03-27,2020-03-27,4.0,685.2,8074.91,710.0,506.0,           ,1.0,1.0,238.0
3523,Ruoka_paivittaistavarakauppa,2020-03-30 04:37:53.684210525,2020-03-30,2020-03-30,2020-03-30,4.0,-10.7,8064.21,0.0,162.0,           ,1.0,1.0,53.0
3524,Shoppailu,2020-03-30 06:44:12.631578946,2020-03-30,2020-03-30,2020-03-30,4.0,-21.04,8043.17,0.0,162.0,           ,1.0,1.0,99.0
3525,Hyvinvointi,2020-03-30 08:50:31.578947367,2020-03-30,2020-03-30,2020-03-30,4.0,-29.95,8013.22,0.0,162.0,           ,1.0,1.0,106.0
3526,Liikkuminen,2020-03-30 10:56:50.526315788,2020-03-30,2020-03-30,2020-03-30,4.0,-10.01,8003.21,0.0,162.0,           ,1.0,1.0,109.0
3527,Ruoka_paivittaistavarakauppa,2020-04-02 03:57:40.194174756,2020-04-02,2020-04-03,2020-04-02,4.0,-15.42,7987.79,0.0,162.0,           ,1.0,1.0,121.0
3528,Ravintolat_kahvilat,2020-04-02 13:58:50.097087378,2020-04-02,2020-04-02,2020-04-02,4.0,-2.38,7985.41,0.0,162.0,           ,1.0,1.0,110.0
3529,Luottojen_maksut,2020-04-02 17:56:30.291262134,2020-04-02,2020-04-02,2020-04-02,4.0,-26.82,7958.59,0.0,162.0,           ,1.0,1.0,54.0
3530,Tulot,2020-04-03 07:55:20.388349512,2020-04-03,2020-04-03,2020-04-03,4.0,266.0,8224.59,701.0,520.0,           ,1.0,1.0,219.0
3531,Luottojen_maksut,2020-04-03 11:53:00.582524268,2020-04-03,2020-04-03,2020-04-03,4.0,-321.7,7902.89,0.0,172.0,           ,1.0,1.0,195.0
3532,Luottojen_maksut,2020-04-03 21:54:10.485436890,2020-04-03,2020-04-03,2020-04-03,4.0,-19.94,7882.95,0.0,170.0,           ,1.0,1.0,191.0
3533,Luottojen_maksut,2020-04-06 01:51:50.679611646,2020-04-06,2020-04-06,2020-04-06,4.0,-488.03,7394.92,0.0,172.0,           ,1.0,1.0,196.0
3534,Ruoka_paivittaistavarakauppa,2020-04-06 05:49:30.873786402,2020-04-06,2020-04-06,2020-04-06,4.0,-13.59,7381.33,0.0,162.0,           ,1.0,1.0,149.0
3535,Ruoka_paivittaistavarakauppa,2020-04-06 15:50:40.776699024,2020-04-06,2020-04-06,2020-04-06,4.0,-14.0,7367.33,0.0,162.0,           ,1.0,1.0,91.0
3536,Muut,2020-04-06 19:48:20.970873780,2020-04-06,2020-04-06,2020-04-06,4.0,-12.55,7354.78,0.0,162.0,           ,1.0,1.0,175.0
3537,Ruoka_paivittaistavarakauppa,2020-04-07 09:47:11.067961158,2020-04-07,2020-04-07,2020-04-07,4.0,-185.92,7168.86,0.0,162.0,           ,1.0,1.0,168.0
3538,Liikkuminen,2020-04-07 13:44:51.262135914,2020-04-07,2020-04-07,2020-04-07,4.0,-95.97,7072.89,0.0,162.0,           ,1.0,1.0,180.0
3539,Ruoka_paivittaistavarakauppa,2020-04-07 23:46:01.165048536,2020-04-07,2020-04-07,2020-04-07,4.0,-5.72,7067.17,0.0,162.0,           ,1.0,1.0,181.0
3540,Ravintolat_kahvilat,2020-04-09 03:43:41.359223292,2020-04-09,2020-04-09,2020-04-09,4.0,-40.54,7026.63,0.0,162.0,           ,1.0,1.0,109.0
3541,Asuminen,2020-04-09 11:39:01.747572804,2020-04-09,2020-04-09,2020-04-09,4.0,-19.14,7007.49,706.0,129.0,OKOYFIHH   ,0.0,0.0,229.0
3542,Ruoka_paivittaistavarakauppa,2020-04-09 17:42:31.456310670,2020-04-09,2020-04-09,2020-04-09,4.0,-11.18,6996.31,0.0,162.0,           ,1.0,1.0,157.0
3543,Muut,2020-04-10 07:41:21.553398048,2020-04-10,2020-04-10,2020-04-10,4.0,-459.86,6536.45,0.0,162.0,           ,1.0,1.0,185.0
3544,Luottojen_maksut,2020-04-10 21:40:11.650485426,2020-04-10,2020-04-10,2020-04-10,4.0,-273.09,6263.36,0.0,172.0,           ,1.0,1.0,195.0
3545,Muut,2020-04-12 01:37:51.844660182,2020-04-12,2020-04-12,2020-04-12,4.0,-213.29,6050.07,0.0,106.0,OKOYFIHH   ,0.0,0.0,28.0
3546,Liikkuminen,2020-04-13 05:35:32.038834938,2020-04-13,2020-04-15,2020-04-13,4.0,-75.67,5974.4,0.0,162.0,           ,1.0,1.0,142.0
3547,Asuminen,2020-04-13 15:36:41.941747560,2020-04-13,2020-04-13,2020-04-13,4.0,-143.5,5830.9,0.0,106.0,NDEAFIHH   ,0.0,0.0,8.0
3548,Muut,2020-04-13 19:34:22.135922316,2020-04-13,2020-04-15,2020-04-13,4.0,-39.02,5791.88,0.0,162.0,           ,1.0,1.0,121.0
3549,Luottojen_maksut,2020-04-15 09:33:12.233009694,2020-04-15,2020-04-15,2020-04-15,4.0,-23.87,5768.01,0.0,162.0,           ,1.0,1.0,160.0
3550,Liikkuminen,2020-04-15 23:32:02.330097072,2020-04-15,2020-04-17,2020-04-15,4.0,-11.91,5756.1,0.0,162.0,           ,1.0,1.0,132.0
3551,Harrastukset,2020-04-16 13:30:52.427184450,2020-04-16,2020-04-16,2020-04-16,4.0,-30.19,5725.91,0.0,162.0,           ,1.0,1.0,76.0
3552,Muut,2020-04-16 17:28:32.621359206,2020-04-16,2020-04-16,2020-04-16,4.0,-7.22,5718.69,0.0,103.0,           ,0.0,1.0,1.0
3553,Luokittelemattomat,2020-04-17 03:29:42.524271828,2020-04-17,2020-04-17,2020-04-17,4.0,-3.8,5714.89,0.0,162.0,           ,1.0,1.0,64.0
3554,Ravintolat_kahvilat,2020-04-17 07:27:22.718446584,2020-04-17,2020-04-17,2020-04-17,4.0,-55.64,5659.25,0.0,162.0,           ,1.0,1.0,102.0
3555,Ruoka_paivittaistavarakauppa,2020-04-17 21:26:12.815533962,2020-04-17,2020-04-17,2020-04-17,4.0,-21.48,5637.77,0.0,162.0,           ,1.0,1.0,112.0
3556,Harrastukset,2020-04-18 15:22:43.106796096,2020-04-18,2020-04-18,2020-04-18,4.0,-19.25,5618.52,0.0,106.0,OKOYFIHH   ,0.0,0.0,10.0
3557,Ruoka_paivittaistavarakauppa,2020-04-20 05:21:33.203883474,2020-04-20,2020-04-20,2020-04-20,4.0,-24.35,5594.17,0.0,162.0,           ,1.0,1.0,128.0
3558,Shoppailu,2020-04-20 11:25:02.912621340,2020-04-20,2020-04-20,2020-04-20,4.0,-12.56,5581.61,0.0,162.0,           ,1.0,1.0,90.0
3559,Muut,2020-04-20 13:16:53.592232986,2020-04-20,2020-04-20,2020-04-20,4.0,-37.26,5544.35,0.0,162.0,           ,1.0,1.0,118.0
3560,Lapset,2020-04-20 19:20:23.300970852,2020-04-20,2020-04-20,2020-04-20,4.0,-56.22,5488.13,0.0,162.0,           ,1.0,1.0,53.0
3561,Tulot,2020-04-20 23:18:03.495145608,2020-04-20,2020-04-20,2020-04-20,4.0,1409.85,6897.98,0.0,505.0,           ,1.0,1.0,204.0
3562,Terveys,2020-04-21 01:23:53.009708718,2020-04-21,2020-04-21,2020-04-21,4.0,467.21,7365.19,0.0,500.0,OKOYFIHH   ,1.0,0.0,202.0
3563,Liikkuminen,2020-04-21 09:19:13.398058230,2020-04-21,2020-04-21,2020-04-21,4.0,-8.47,7356.72,0.0,162.0,           ,1.0,1.0,125.0
3564,Ruoka_paivittaistavarakauppa,2020-04-23 03:15:43.689320364,2020-04-23,2020-04-23,2020-04-23,4.0,-83.61,7273.11,0.0,162.0,           ,1.0,1.0,110.0
3565,Ravintolat_kahvilat,2020-04-23 07:13:23.883495120,2020-04-23,2020-04-23,2020-04-23,4.0,-11.31,7261.8,0.0,162.0,           ,1.0,1.0,120.0
3566,Matkailu,2020-04-23 21:12:13.980582498,2020-04-23,2020-04-23,2020-04-23,4.0,-9.34,7252.46,0.0,106.0,OKOYFIHH   ,0.0,0.0,12.0
3567,Ruoka_paivittaistavarakauppa,2020-04-24 17:14:33.786407742,2020-04-24,2020-04-24,2020-04-24,4.0,-32.65,7219.81,0.0,162.0,           ,1.0,1.0,171.0
3568,Matkailu,2020-04-26 11:11:04.077669876,2020-04-26,2020-04-26,2020-04-26,4.0,-200.25,7019.56,0.0,106.0,OKOYFIHH   ,1.0,0.0,40.0
3569,Matkailu,2020-04-27 01:09:54.174757254,2020-04-27,2020-04-27,2020-04-27,4.0,-52.67,6966.89,706.0,129.0,NDEAFIHH   ,0.0,0.0,227.0
3570,Liikkuminen,2020-04-27 05:07:34.368932010,2020-04-27,2020-04-27,2020-04-27,4.0,-37.46,6929.43,706.0,129.0,OKOYFIHH   ,0.0,0.0,233.0
3571,Asuminen,2020-04-27 15:08:44.271844632,2020-04-27,2020-04-27,2020-04-27,4.0,-14.75,6914.68,706.0,129.0,OKOYFIHH   ,0.0,0.0,230.0
3572,Tulot,2020-04-27 19:06:24.466019388,2020-04-27,2020-04-27,2020-04-27,4.0,331.93,7246.61,0.0,505.0,           ,1.0,1.0,203.0
3573,Tulot,2020-04-28 23:04:04.660194144,2020-04-28,2020-04-28,2020-04-28,4.0,37.83,7284.44,710.0,506.0,           ,1.0,1.0,241.0
3574,Ruoka_paivittaistavarakauppa,2020-04-29 03:01:44.854368900,2020-04-29,2020-04-29,2020-04-29,4.0,-4.5,7279.94,0.0,162.0,           ,1.0,1.0,80.0
3575,Matkailu,2020-04-29 09:05:14.563106766,2020-04-29,2020-04-29,2020-04-29,4.0,-66.43,7213.51,0.0,106.0,OKOYFIHH   ,1.0,0.0,28.0
3576,Tulot,2020-04-30 13:02:54.757281522,2020-04-30,2020-04-30,2020-04-30,4.0,387.15,7600.66,0.0,505.0,           ,1.0,1.0,203.0
3577,Tulot,2020-04-30 17:00:34.951456278,2020-04-30,2020-04-30,2020-04-30,4.0,254.87,7855.53,0.0,588.0,           ,0.0,1.0,214.0
3578,Liikkuminen,2020-05-01 02:06:18.947368421,2020-05-01,2020-05-01,2020-05-01,4.0,-29.34,7826.19,0.0,162.0,           ,1.0,1.0,117.0
3579,Liikkuminen,2020-05-04 04:12:37.894736842,2020-05-04,2020-05-04,2020-05-04,4.0,-9.49,7816.7,0.0,162.0,           ,1.0,1.0,146.0
3580,Muut,2020-05-05 06:18:56.842105263,2020-05-05,2020-05-05,2020-05-05,4.0,-8.05,7808.65,0.0,103.0,           ,0.0,1.0,1.0
3581,Luottojen_maksut,2020-05-05 08:25:15.789473684,2020-05-05,2020-05-05,2020-05-05,4.0,-16.82,7791.83,0.0,170.0,           ,1.0,1.0,193.0
3582,Matkailu,2020-05-07 12:37:53.684210526,2020-05-07,2020-05-07,2020-05-07,4.0,-11.47,7780.36,0.0,162.0,           ,1.0,1.0,99.0
3583,Tulot,2020-05-07 16:50:31.578947368,2020-05-07,2020-05-07,2020-05-07,4.0,322.87,8103.23,0.0,588.0,           ,0.0,1.0,213.0
3584,Ruoka_paivittaistavarakauppa,2020-05-08 10:31:34.736842105,2020-05-08,2020-05-08,2020-05-08,4.0,-5.96,8097.27,0.0,162.0,           ,1.0,1.0,85.0
3585,Terveys,2020-05-08 14:44:12.631578947,2020-05-08,2020-05-08,2020-05-08,4.0,-2.88,8094.39,0.0,162.0,           ,1.0,1.0,116.0
3586,Ravintolat_kahvilat,2020-05-11 18:56:50.526315789,2020-05-11,2020-05-11,2020-05-11,4.0,-22.76,8071.63,0.0,162.0,           ,1.0,1.0,117.0
3587,Asuminen,2020-05-11 21:03:09.473684210,2020-05-11,2020-05-11,2020-05-11,4.0,-48.82,8022.81,0.0,162.0,           ,1.0,1.0,117.0
3588,Ravintolat_kahvilat,2020-05-12 23:09:28.421052631,2020-05-12,2020-05-12,2020-05-12,4.0,-8.83,8013.98,0.0,162.0,           ,1.0,1.0,127.0
3589,Luokittelemattomat,2020-05-15 01:15:47.368421052,2020-05-15,2020-05-15,2020-05-15,4.0,-8.45,8005.53,0.0,106.0,OKOYFIHH   ,1.0,0.0,8.0
3590,Liikkuminen,2020-05-15 03:22:06.315789473,2020-05-15,2020-05-15,2020-05-15,4.0,-105.34,7900.19,0.0,106.0,NDEAFIHH   ,0.0,0.0,20.0
3591,Luokittelemattomat,2020-05-15 05:28:25.263157894,2020-05-15,2020-05-15,2020-05-15,4.0,-1589.9,6310.29,0.0,106.0,OKOYFIHH   ,1.0,0.0,7.0
3592,Asuminen,2020-05-18 07:34:44.210526315,2020-05-18,2020-05-18,2020-05-18,4.0,-161.28,6149.01,0.0,106.0,NDEAFIHH   ,0.0,0.0,20.0
3593,Hyvinvointi,2020-05-18 09:41:03.157894736,2020-05-18,2020-05-18,2020-05-18,4.0,-57.64,6091.37,0.0,106.0,OKOYFIHH   ,0.0,0.0,17.0
3594,Luokittelemattomat,2020-05-20 11:47:22.105263157,2020-05-20,2020-05-20,2020-05-20,4.0,-97.03,5994.34,0.0,106.0,NDEAFIHH   ,1.0,0.0,7.0
3595,Ruoka_paivittaistavarakauppa,2020-05-20 13:53:41.052631578,2020-05-20,2020-05-20,2020-05-20,4.0,-132.36,5861.98,0.0,162.0,           ,1.0,1.0,70.0
3596,Ravintolat_kahvilat,2020-05-21 15:59:59.999999999,2020-05-21,2020-05-21,2020-05-21,4.0,-16.93,5845.05,0.0,162.0,           ,1.0,1.0,102.0
3597,Tulot,2020-05-22 18:06:18.947368420,2020-05-22,2020-05-22,2020-05-22,4.0,571.59,6416.64,0.0,505.0,           ,1.0,1.0,204.0
3598,Ruoka_paivittaistavarakauppa,2020-05-25 20:12:37.894736841,2020-05-25,2020-05-25,2020-05-25,4.0,-20.6,6396.04,0.0,162.0,           ,1.0,1.0,89.0
3599,Matkailu,2020-05-26 00:25:15.789473683,2020-05-26,2020-05-26,2020-05-28,4.0,-42.5,6353.54,0.0,162.0,           ,1.0,1.0,149.0
3600,Ruoka_paivittaistavarakauppa,2020-05-26 22:18:56.842105262,2020-05-26,2020-05-26,2020-05-26,4.0,-13.67,6339.87,0.0,162.0,           ,1.0,1.0,119.0
3601,Ravintolat_kahvilat,2020-05-27 02:31:34.736842104,2020-05-27,2020-05-27,2020-05-27,4.0,-33.81,6306.06,0.0,162.0,           ,1.0,1.0,121.0
3602,Ruoka_paivittaistavarakauppa,2020-05-27 04:37:53.684210525,2020-05-27,2020-05-29,2020-05-27,4.0,-8.81,6297.25,0.0,162.0,           ,1.0,1.0,170.0
3603,Ruoka_paivittaistavarakauppa,2020-05-29 06:44:12.631578946,2020-05-29,2020-05-29,2020-05-29,4.0,-0.69,6296.56,0.0,162.0,           ,1.0,1.0,132.0
3604,Ruoka_paivittaistavarakauppa,2020-05-29 08:50:31.578947367,2020-05-29,2020-05-29,2020-05-29,4.0,-5.08,6291.48,0.0,162.0,           ,1.0,1.0,112.0
3605,Ravintolat_kahvilat,2020-05-29 10:56:50.526315788,2020-05-29,2020-05-29,2020-05-29,4.0,-2.57,6288.91,0.0,162.0,           ,1.0,1.0,136.0
3606,Lapset,2020-06-01 07:01:27.804878048,2020-06-01,2020-06-01,2020-06-01,4.0,-27.82,6261.09,0.0,162.0,           ,1.0,1.0,163.0
3607,Lapset,2020-06-01 14:02:55.609756096,2020-06-01,2020-06-01,2020-06-01,4.0,-14.98,6246.11,0.0,162.0,           ,1.0,1.0,125.0
3608,Luokittelemattomat,2020-06-01 21:04:23.414634144,2020-06-01,2020-06-01,2020-06-01,4.0,-39.02,6207.09,0.0,106.0,OKOYFIHH   ,1.0,0.0,14.0
3609,Ruoka_paivittaistavarakauppa,2020-06-02 04:05:51.219512192,2020-06-02,2020-06-02,2020-06-02,4.0,-77.75,6129.34,0.0,162.0,           ,1.0,1.0,55.0
3610,Shoppailu,2020-06-02 11:07:19.024390240,2020-06-02,2020-06-02,2020-06-02,4.0,-84.77,6044.57,0.0,162.0,           ,1.0,1.0,64.0
3611,Saastot_sijoitukset,2020-06-02 18:08:46.829268288,2020-06-02,2020-06-02,2020-06-02,4.0,-9.01,6035.56,0.0,162.0,           ,1.0,1.0,181.0
3612,Liikkuminen,2020-06-03 01:10:14.634146336,2020-06-03,2020-06-03,2020-06-03,4.0,-2.41,6033.15,0.0,162.0,           ,1.0,1.0,93.0
3613,Ruoka_paivittaistavarakauppa,2020-06-03 08:11:42.439024384,2020-06-03,2020-06-03,2020-06-03,4.0,-5.03,6028.12,0.0,162.0,           ,1.0,1.0,143.0
3614,Shoppailu,2020-06-03 15:13:10.243902432,2020-06-03,2020-06-03,2020-06-03,4.0,-63.11,5965.01,0.0,162.0,           ,1.0,1.0,119.0
3615,Luottojen_maksut,2020-06-03 19:19:01.463414624,2020-06-03,2020-06-03,2020-06-03,4.0,-18.02,5946.99,0.0,172.0,           ,1.0,1.0,196.0
3616,Luokittelemattomat,2020-06-03 22:14:38.048780480,2020-06-03,2020-06-03,2020-06-03,4.0,-12.28,5934.71,0.0,162.0,           ,1.0,1.0,160.0
3617,Ruoka_paivittaistavarakauppa,2020-06-04 05:16:05.853658528,2020-06-04,2020-06-04,2020-06-04,4.0,-6.13,5928.58,0.0,162.0,           ,1.0,1.0,146.0
3618,Tulot,2020-06-04 13:27:48.292682912,2020-06-04,2020-06-04,2020-06-04,4.0,2421.3,8349.88,710.0,506.0,           ,1.0,1.0,239.0
3619,Ruoka_paivittaistavarakauppa,2020-06-05 02:20:29.268292672,2020-06-05,2020-06-05,2020-06-05,4.0,-57.44,8292.44,0.0,162.0,           ,1.0,1.0,185.0
3620,Saastot_sijoitukset,2020-06-05 06:26:20.487804864,2020-06-05,2020-06-05,2020-06-05,4.0,-25.7,8266.74,0.0,162.0,           ,1.0,1.0,117.0
3621,Ravintolat_kahvilat,2020-06-05 09:21:57.073170720,2020-06-05,2020-06-05,2020-06-05,4.0,-1.14,8265.6,0.0,162.0,           ,1.0,1.0,127.0
3622,Shoppailu,2020-06-05 16:23:24.878048768,2020-06-05,2020-06-05,2020-06-05,4.0,-7.81,8257.79,0.0,162.0,           ,1.0,1.0,133.0
3623,Ruoka_paivittaistavarakauppa,2020-06-05 20:29:16.097560960,2020-06-05,2020-06-05,2020-06-05,4.0,-2.64,8255.15,0.0,162.0,           ,1.0,1.0,92.0
3624,Liikkuminen,2020-06-05 23:24:52.682926816,2020-06-05,2020-06-05,2020-06-05,4.0,-23.02,8232.13,0.0,162.0,           ,1.0,1.0,148.0
3625,Tulot,2020-06-06 12:17:33.658536576,2020-06-06,2020-06-06,2020-06-06,4.0,4105.64,12337.77,0.0,505.0,           ,1.0,1.0,203.0
3626,Ravintolat_kahvilat,2020-06-08 00:35:07.317073152,2020-06-08,2020-06-08,2020-06-08,4.0,-0.67,12337.1,0.0,162.0,           ,1.0,1.0,93.0
3627,Ruoka_paivittaistavarakauppa,2020-06-08 01:45:21.951219488,2020-06-08,2020-06-08,2020-06-08,4.0,-6.18,12330.92,0.0,162.0,           ,1.0,1.0,143.0
3628,Liikkuminen,2020-06-08 03:30:43.902439008,2020-06-08,2020-06-08,2020-06-08,4.0,-9.63,12321.29,0.0,162.0,           ,1.0,1.0,144.0
3629,Luokittelemattomat,2020-06-08 07:36:35.121951200,2020-06-08,2020-06-08,2020-06-08,4.0,-1.83,12319.46,0.0,162.0,           ,1.0,1.0,54.0
3630,Tulot,2020-06-08 10:32:11.707317056,2020-06-08,2020-06-08,2020-06-08,4.0,-295.01,12024.45,0.0,162.0,           ,1.0,1.0,65.0
3631,Ruoka_paivittaistavarakauppa,2020-06-08 14:38:02.926829248,2020-06-08,2020-06-08,2020-06-08,4.0,-4.94,12019.51,0.0,162.0,           ,1.0,1.0,124.0
3632,Ruoka_paivittaistavarakauppa,2020-06-08 17:33:39.512195104,2020-06-08,2020-06-08,2020-06-08,4.0,-18.61,12000.9,0.0,162.0,           ,1.0,1.0,119.0
3633,Ruoka_paivittaistavarakauppa,2020-06-08 21:39:30.731707296,2020-06-08,2020-06-08,2020-06-08,4.0,-27.14,11973.76,0.0,162.0,           ,1.0,1.0,130.0
3634,Ruoka_paivittaistavarakauppa,2020-06-09 18:43:54.146341440,2020-06-09,2020-06-09,2020-06-09,4.0,-46.39,11927.37,0.0,162.0,           ,1.0,1.0,54.0
3635,Muut,2020-06-10 04:40:58.536585344,2020-06-10,2020-06-10,2020-06-10,4.0,-234.83,11692.54,0.0,105.0,OKOYFIHH   ,1.0,0.0,6.0
3636,Ruoka_paivittaistavarakauppa,2020-06-10 15:48:17.560975584,2020-06-10,2020-06-12,2020-06-09,4.0,-9.68,11682.86,0.0,162.0,           ,1.0,1.0,128.0
3637,Liikkuminen,2020-06-11 05:51:13.170731680,2020-06-11,2020-06-11,2020-06-11,4.0,-12.24,11670.62,0.0,162.0,           ,1.0,1.0,118.0
3638,Ravintolat_kahvilat,2020-06-11 08:46:49.756097536,2020-06-11,2020-06-11,2020-06-11,4.0,-2.17,11668.45,0.0,162.0,           ,1.0,1.0,133.0
3639,Matkailu,2020-06-11 11:42:26.341463392,2020-06-11,2020-06-12,2020-06-11,4.0,-105.83,11562.62,0.0,106.0,OKOYFIHH   ,0.0,0.0,42.0
3640,Ruoka_paivittaistavarakauppa,2020-06-11 12:52:40.975609728,2020-06-11,2020-06-11,2020-06-11,4.0,-1.68,11560.94,0.0,162.0,           ,1.0,1.0,188.0
3641,Ravintolat_kahvilat,2020-06-11 19:54:08.780487776,2020-06-11,2020-06-11,2020-06-11,4.0,-28.93,11532.01,0.0,162.0,           ,1.0,1.0,109.0
3642,Luokittelemattomat,2020-06-12 02:55:36.585365824,2020-06-12,2020-06-12,2020-06-12,4.0,-10.2,11521.81,0.0,162.0,           ,1.0,1.0,171.0
3643,Asuminen,2020-06-12 04:05:51.219512160,2020-06-12,2020-06-12,2020-06-12,4.0,-19.64,11502.17,0.0,162.0,           ,1.0,1.0,131.0
3644,Liikkuminen,2020-06-12 07:01:27.804878016,2020-06-12,2020-06-12,2020-06-12,4.0,-7.47,11494.7,0.0,162.0,           ,1.0,1.0,149.0
3645,Tulot,2020-06-12 09:57:04.390243872,2020-06-12,2020-06-12,2020-06-12,4.0,-34.67,11460.03,0.0,162.0,           ,1.0,1.0,137.0
3646,Ruoka_paivittaistavarakauppa,2020-06-12 14:02:55.609756064,2020-06-12,2020-06-12,2020-06-12,4.0,-4.33,11455.7,0.0,162.0,           ,1.0,1.0,173.0
3647,Ruoka_paivittaistavarakauppa,2020-06-12 16:58:32.195121920,2020-06-12,2020-06-12,2020-06-12,4.0,-15.28,11440.42,0.0,162.0,           ,1.0,1.0,144.0
3648,Terveys,2020-06-12 21:04:23.414634112,2020-06-12,2020-06-12,2020-06-12,4.0,-110.24,11330.18,0.0,162.0,           ,1.0,1.0,183.0
3649,Ruoka_paivittaistavarakauppa,2020-06-12 22:49:45.365853632,2020-06-12,2020-06-12,2020-06-12,4.0,-20.27,11309.91,0.0,162.0,           ,1.0,1.0,111.0
3650,Kulttuuri_viihde,2020-06-12 23:59:59.999999968,2020-06-12,2020-06-12,2020-06-12,4.0,-11.22,11298.69,0.0,162.0,           ,1.0,1.0,121.0
3651,Muut,2020-06-15 01:10:14.634146304,2020-06-15,2020-06-15,2020-06-15,4.0,-5.16,11293.53,0.0,106.0,OKOYFIHH   ,0.0,0.0,8.0
3652,Matkailu,2020-06-15 08:11:42.439024352,2020-06-15,2020-06-15,2020-06-15,4.0,-451.25,10842.28,0.0,106.0,OKOYFIHH   ,0.0,0.0,28.0
3653,Terveys,2020-06-15 15:13:10.243902400,2020-06-15,2020-06-15,2020-06-15,4.0,-76.29,10765.99,0.0,106.0,OKOYFIHH   ,0.0,0.0,8.0
3654,Ruoka_paivittaistavarakauppa,2020-06-15 18:08:46.829268256,2020-06-15,2020-06-15,2020-06-15,4.0,-0.62,10765.37,0.0,162.0,           ,1.0,1.0,70.0
3655,Luottojen_maksut,2020-06-15 22:14:38.048780448,2020-06-15,2020-06-15,2020-06-15,4.0,-878.38,9886.99,0.0,106.0,OKOYFIHH   ,0.0,0.0,7.0
3656,Ruoka_paivittaistavarakauppa,2020-06-16 02:20:29.268292640,2020-06-16,2020-06-16,2020-06-16,4.0,-200.36,9686.63,0.0,106.0,NDEAFIHH   ,0.0,0.0,13.0
3657,Luottojen_maksut,2020-06-16 05:16:05.853658496,2020-06-16,2020-06-16,2020-06-16,4.0,-451.59,9235.04,0.0,106.0,OKOYFIHH   ,0.0,0.0,9.0
3658,Saastot_sijoitukset,2020-06-16 11:07:19.024390208,2020-06-16,2020-06-16,2020-06-16,4.0,-89.15,9145.89,0.0,162.0,           ,1.0,1.0,158.0
3659,Luottojen_maksut,2020-06-16 12:17:33.658536544,2020-06-16,2020-06-16,2020-06-16,4.0,-756.53,8389.36,0.0,106.0,OKOYFIHH   ,0.0,0.0,48.0
3660,Luokittelemattomat,2020-06-16 19:19:01.463414592,2020-06-16,2020-06-16,2020-06-16,4.0,-1443.87,6945.49,0.0,106.0,HANDFIHH   ,0.0,0.0,21.0
3661,Lemmikit,2020-06-17 09:21:57.073170688,2020-06-17,2020-06-17,2020-06-17,4.0,-37.85,6907.64,0.0,162.0,           ,1.0,1.0,76.0
3662,Luokittelemattomat,2020-06-17 16:23:24.878048736,2020-06-17,2020-06-17,2020-06-17,4.0,-27.7,6879.94,0.0,162.0,           ,1.0,1.0,143.0
3663,Tulot,2020-06-17 23:24:52.682926784,2020-06-17,2020-06-17,2020-06-17,4.0,68.08,6948.02,710.0,506.0,           ,1.0,1.0,241.0
3664,Lapset,2020-06-18 00:35:07.317073120,2020-06-18,2020-06-18,2020-06-18,4.0,-18.01,6930.01,0.0,106.0,OKOYFIHH   ,0.0,0.0,12.0
3665,Liikkuminen,2020-06-18 06:26:20.487804832,2020-06-18,2020-06-18,2020-06-18,4.0,-18.81,6911.2,0.0,162.0,           ,1.0,1.0,154.0
3666,Asuminen,2020-06-18 10:32:11.707317024,2020-06-18,2020-06-18,2020-06-18,4.0,-70.89,6840.31,0.0,106.0,NDEAFIHH   ,0.0,0.0,20.0
3667,Ruoka_paivittaistavarakauppa,2020-06-18 13:27:48.292682880,2020-06-18,2020-06-18,2020-06-18,4.0,-18.24,6822.07,0.0,162.0,           ,1.0,1.0,61.0
3668,Ravintolat_kahvilat,2020-06-18 14:38:02.926829216,2020-06-18,2020-06-18,2020-06-18,4.0,-1.56,6820.51,0.0,162.0,           ,1.0,1.0,64.0
3669,Shoppailu,2020-06-18 17:33:39.512195072,2020-06-18,2020-06-18,2020-06-18,4.0,-86.88,6733.63,0.0,106.0,OKOYFIHH   ,0.0,0.0,24.0
3670,Ruoka_paivittaistavarakauppa,2020-06-18 20:29:16.097560928,2020-06-18,2020-06-18,2020-06-17,4.0,-4.43,6729.2,0.0,162.0,           ,1.0,1.0,53.0
3671,Luokittelemattomat,2020-06-19 03:30:43.902438976,2020-06-19,2020-06-19,2020-06-19,4.0,-29.43,6699.77,0.0,106.0,NDEAFIHH   ,0.0,0.0,40.0
3672,Asuminen,2020-06-19 07:36:35.121951168,2020-06-19,2020-06-19,2020-06-19,4.0,-45.7,6654.07,0.0,106.0,NDEAFIHH   ,0.0,0.0,7.0
3673,Ravintolat_kahvilat,2020-06-19 21:39:30.731707264,2020-06-19,2020-06-19,2020-06-19,4.0,-16.15,6637.92,0.0,162.0,           ,1.0,1.0,143.0
3674,Ruoka_paivittaistavarakauppa,2020-06-22 01:45:21.951219456,2020-06-22,2020-06-22,2020-06-22,4.0,-12.78,6625.14,0.0,162.0,           ,1.0,1.0,99.0
3675,Asuminen,2020-06-22 02:55:36.585365792,2020-06-22,2020-06-22,2020-06-22,4.0,-48.14,6577.0,0.0,162.0,           ,1.0,1.0,120.0
3676,Asuminen,2020-06-22 04:40:58.536585312,2020-06-22,2020-06-22,2020-06-22,4.0,-21.26,6555.74,0.0,162.0,           ,1.0,1.0,93.0
3677,Ruoka_paivittaistavarakauppa,2020-06-22 08:46:49.756097504,2020-06-22,2020-06-22,2020-06-22,4.0,-9.5,6546.24,0.0,162.0,           ,1.0,1.0,170.0
3678,Ruoka_paivittaistavarakauppa,2020-06-22 11:42:26.341463360,2020-06-22,2020-06-22,2020-06-22,4.0,-2.59,6543.65,0.0,162.0,           ,1.0,1.0,53.0
3679,Liikkuminen,2020-06-22 15:48:17.560975552,2020-06-22,2020-06-22,2020-06-22,4.0,-7.05,6536.6,0.0,162.0,           ,1.0,1.0,102.0
3680,Saastot_sijoitukset,2020-06-22 18:43:54.146341408,2020-06-22,2020-06-22,2020-06-22,4.0,-18.03,6518.57,0.0,162.0,           ,1.0,1.0,165.0
3681,Ruoka_paivittaistavarakauppa,2020-06-22 22:49:45.365853600,2020-06-22,2020-06-22,2020-06-22,4.0,-10.59,6507.98,0.0,162.0,           ,1.0,1.0,54.0
3682,Ravintolat_kahvilat,2020-06-23 05:51:13.170731648,2020-06-23,2020-06-23,2020-06-23,4.0,-483.73,6024.25,0.0,162.0,           ,1.0,1.0,181.0
3683,Ravintolat_kahvilat,2020-06-23 12:52:40.975609696,2020-06-23,2020-06-23,2020-06-23,4.0,-15.62,6008.63,0.0,162.0,           ,1.0,1.0,125.0
3684,Shoppailu,2020-06-23 19:54:08.780487744,2020-06-23,2020-06-23,2020-06-23,4.0,-22.78,5985.85,0.0,162.0,           ,1.0,1.0,70.0
3685,Tulot,2020-06-24 09:57:04.390243840,2020-06-24,2020-06-24,2020-06-24,4.0,964.02,6949.87,0.0,505.0,           ,1.0,1.0,207.0
3686,Luokittelemattomat,2020-06-24 14:02:55.609756032,2020-06-24,2020-06-24,2020-06-24,4.0,-24.65,6925.22,0.0,162.0,           ,1.0,1.0,70.0
3687,Asuminen,2020-06-24 16:58:32.195121888,2020-06-24,2020-06-24,2020-06-24,4.0,-46.95,6878.27,706.0,129.0,OKOYFIHH   ,0.0,0.0,228.0
3688,Harrastukset,2020-06-24 21:04:23.414634080,2020-06-24,2020-06-24,2020-06-24,4.0,-63.5,6814.77,0.0,162.0,           ,1.0,1.0,112.0
3689,Liikkuminen,2020-06-24 23:59:59.999999936,2020-06-24,2020-06-24,2020-06-24,4.0,-55.23,6759.54,0.0,162.0,           ,1.0,1.0,53.0
3690,Ruoka_paivittaistavarakauppa,2020-06-26 01:10:14.634146272,2020-06-26,2020-06-26,2020-06-26,4.0,-17.81,6741.73,0.0,162.0,           ,1.0,1.0,95.0
3691,Asuminen,2020-06-26 04:05:51.219512128,2020-06-26,2020-06-26,2020-06-26,4.0,-33.65,6708.08,0.0,106.0,NDEAFIHH   ,0.0,0.0,28.0
3692,Ruoka_paivittaistavarakauppa,2020-06-26 07:01:27.804877984,2020-06-26,2020-06-26,2020-06-26,4.0,-12.04,6696.04,0.0,162.0,           ,1.0,1.0,78.0
3693,Ravintolat_kahvilat,2020-06-26 18:08:46.829268224,2020-06-26,2020-06-26,2020-06-26,4.0,-4.82,6691.22,0.0,162.0,           ,1.0,1.0,85.0
3694,Harrastukset,2020-06-27 22:14:38.048780416,2020-06-27,2020-06-27,2020-06-27,4.0,-20.33,6670.89,0.0,106.0,NDEAFIHH   ,0.0,0.0,9.0
3695,Liikkuminen,2020-06-29 02:20:29.268292608,2020-06-29,2020-06-29,2020-06-29,4.0,-103.46,6567.43,0.0,162.0,           ,1.0,1.0,58.0
3696,Saastot_sijoitukset,2020-06-29 05:16:05.853658464,2020-06-29,2020-06-29,2020-06-29,4.0,-109.89,6457.54,0.0,162.0,           ,1.0,1.0,54.0
3697,Ruoka_paivittaistavarakauppa,2020-06-29 06:26:20.487804800,2020-06-29,2020-06-29,2020-06-29,4.0,-48.34,6409.2,0.0,162.0,           ,1.0,1.0,170.0
3698,Ruoka_paivittaistavarakauppa,2020-06-29 08:11:42.439024320,2020-06-29,2020-06-29,2020-06-29,4.0,-28.62,6380.58,0.0,162.0,           ,1.0,1.0,175.0
3699,Tulot,2020-06-29 11:07:19.024390176,2020-06-29,2020-06-29,2020-06-29,4.0,1745.01,8125.59,701.0,520.0,           ,1.0,1.0,220.0
3700,Tulot,2020-06-29 12:17:33.658536512,2020-06-29,2020-06-29,2020-06-29,4.0,773.98,8899.57,710.0,506.0,           ,1.0,1.0,243.0
3701,Ruoka_paivittaistavarakauppa,2020-06-29 13:27:48.292682848,2020-06-29,2020-06-29,2020-06-29,4.0,-27.72,8871.85,0.0,162.0,           ,1.0,1.0,133.0
3702,Ruoka_paivittaistavarakauppa,2020-06-29 15:13:10.243902368,2020-06-29,2020-06-30,2020-06-29,4.0,-97.24,8774.61,0.0,162.0,           ,1.0,1.0,91.0
3703,Muut,2020-06-29 16:23:24.878048704,2020-06-29,2020-06-29,2020-06-29,4.0,-4.27,8770.34,0.0,162.0,           ,1.0,1.0,181.0
3704,Ruoka_paivittaistavarakauppa,2020-06-29 19:19:01.463414560,2020-06-29,2020-06-29,2020-06-29,4.0,-6.1,8764.24,0.0,162.0,           ,1.0,1.0,164.0
3705,Ruoka_paivittaistavarakauppa,2020-06-29 23:24:52.682926752,2020-06-29,2020-06-29,2020-06-29,4.0,-100.98,8663.26,0.0,162.0,           ,1.0,1.0,139.0
3706,Luokittelemattomat,2020-06-30 09:21:57.073170656,2020-06-30,2020-06-30,2020-06-30,4.0,-44.78,8618.48,0.0,106.0,OKOYFIHH   ,1.0,0.0,16.0
3707,Ruoka_paivittaistavarakauppa,2020-06-30 20:29:16.097560896,2020-06-30,2020-06-30,2020-06-30,4.0,-16.06,8602.42,0.0,162.0,           ,1.0,1.0,107.0
3708,Ruoka_paivittaistavarakauppa,2020-07-01 20:23:00.821917808,2020-07-01,2020-07-01,2020-07-01,4.0,-8.36,8594.06,0.0,162.0,           ,1.0,1.0,99.0
3709,Matkailu,2020-07-02 16:46:01.643835616,2020-07-02,2020-07-02,2020-07-02,4.0,-32.99,8561.07,0.0,162.0,           ,1.0,1.0,107.0
3710,Luottojen_maksut,2020-07-03 09:32:03.287671232,2020-07-03,2020-07-03,2020-07-03,4.0,-162.71,8398.36,0.0,106.0,NDEAFIHH   ,0.0,0.0,28.0
3711,Tulot,2020-07-03 13:09:02.465753424,2020-07-03,2020-07-03,2020-07-03,4.0,367.35,8765.71,0.0,505.0,           ,1.0,1.0,203.0
3712,Lemmikit,2020-07-04 05:55:04.109589040,2020-07-04,2020-07-04,2020-07-04,4.0,-319.71,8446.0,0.0,106.0,OKOYFIHH   ,0.0,0.0,31.0
3713,Tulot,2020-07-06 02:18:04.931506848,2020-07-06,2020-07-06,2020-07-06,4.0,44.86,8490.86,0.0,505.0,           ,1.0,1.0,203.0
3714,Luottojen_maksut,2020-07-06 19:04:06.575342464,2020-07-06,2020-07-06,2020-07-06,4.0,-362.38,8128.48,0.0,172.0,           ,1.0,1.0,197.0
3715,Luottojen_maksut,2020-07-06 22:41:05.753424656,2020-07-06,2020-07-06,2020-07-06,4.0,-7.01,8121.47,0.0,106.0,OKOYFIHH   ,0.0,0.0,14.0
3716,Vakuutukset,2020-07-08 15:27:07.397260272,2020-07-08,2020-07-08,2020-07-08,4.0,-61.6,8059.87,0.0,106.0,OKOYFIHH   ,0.0,0.0,8.0
3717,Matkailu,2020-07-09 08:13:09.041095888,2020-07-09,2020-07-09,2020-07-08,4.0,-200.36,7859.51,0.0,106.0,DABAFIHH   ,0.0,0.0,48.0
3718,Ruoka_paivittaistavarakauppa,2020-07-09 11:50:08.219178080,2020-07-09,2020-07-09,2020-07-09,4.0,-6.63,7852.88,0.0,162.0,           ,1.0,1.0,98.0
3719,Lemmikit,2020-07-10 04:36:09.863013696,2020-07-10,2020-07-10,2020-07-10,4.0,-69.04,7783.84,0.0,106.0,OKOYFIHH   ,0.0,0.0,47.0
3720,Matkailu,2020-07-12 21:22:11.506849312,2020-07-12,2020-07-14,2020-07-12,4.0,-50.55,7733.29,0.0,106.0,OKOYFIHH   ,0.0,0.0,39.0
3721,Liikkuminen,2020-07-13 00:59:10.684931504,2020-07-13,2020-07-13,2020-07-13,4.0,-312.15,7421.14,0.0,106.0,SBANFIHH   ,1.0,0.0,40.0
3722,Ruoka_paivittaistavarakauppa,2020-07-13 14:08:13.150684928,2020-07-13,2020-07-13,2020-07-13,4.0,-0.83,7420.31,0.0,162.0,           ,1.0,1.0,54.0
3723,Ruoka_paivittaistavarakauppa,2020-07-13 17:45:12.328767120,2020-07-13,2020-07-13,2020-07-13,4.0,-8.98,7411.33,0.0,162.0,           ,1.0,1.0,150.0
3724,Liikkuminen,2020-07-16 10:31:13.972602736,2020-07-16,2020-07-16,2020-07-16,4.0,-88.19,7323.14,0.0,162.0,           ,1.0,1.0,109.0
3725,Kulttuuri_viihde,2020-07-17 03:17:15.616438352,2020-07-17,2020-07-17,2020-07-17,4.0,-5.81,7317.33,0.0,162.0,           ,1.0,1.0,130.0
3726,Ruoka_paivittaistavarakauppa,2020-07-17 06:54:14.794520544,2020-07-17,2020-07-17,2020-07-17,4.0,-12.83,7304.5,0.0,162.0,           ,1.0,1.0,138.0
3727,Ruoka_paivittaistavarakauppa,2020-07-17 20:03:17.260273968,2020-07-17,2020-07-17,2020-07-17,4.0,-16.41,7288.09,0.0,162.0,           ,1.0,1.0,122.0
3728,Liikkuminen,2020-07-17 23:40:16.438356160,2020-07-17,2020-07-17,2020-07-17,4.0,-61.21,7226.88,0.0,162.0,           ,1.0,1.0,80.0
3729,Asuminen,2020-07-20 12:49:18.904109584,2020-07-20,2020-07-20,2020-07-20,4.0,-110.93,7115.95,0.0,162.0,           ,1.0,1.0,186.0
3730,Harrastukset,2020-07-20 16:26:18.082191776,2020-07-20,2020-07-20,2020-07-20,4.0,-9.12,7106.83,0.0,162.0,           ,1.0,1.0,107.0
3731,Ruoka_paivittaistavarakauppa,2020-07-21 09:12:19.726027392,2020-07-21,2020-07-21,2020-07-21,4.0,-7.08,7099.75,0.0,162.0,           ,1.0,1.0,181.0
3732,Luottojen_maksut,2020-07-22 01:58:21.369863008,2020-07-22,2020-07-22,2020-07-22,4.0,-224.07,6875.68,0.0,106.0,OKOYFIHH   ,1.0,0.0,48.0
3733,Ravintolat_kahvilat,2020-07-22 05:35:20.547945200,2020-07-22,2020-07-22,2020-07-22,4.0,-2.01,6873.67,0.0,162.0,           ,1.0,1.0,159.0
3734,Ruoka_paivittaistavarakauppa,2020-07-22 22:21:22.191780816,2020-07-22,2020-07-22,2020-07-22,4.0,-7.92,6865.75,0.0,162.0,           ,1.0,1.0,85.0
3735,Ravintolat_kahvilat,2020-07-24 18:44:23.013698624,2020-07-24,2020-07-24,2020-07-24,4.0,-2.01,6863.74,0.0,162.0,           ,1.0,1.0,167.0
3736,Ravintolat_kahvilat,2020-07-27 07:53:25.479452048,2020-07-27,2020-07-27,2020-07-27,4.0,-4.49,6859.25,0.0,162.0,           ,1.0,1.0,55.0
3737,Ruoka_paivittaistavarakauppa,2020-07-27 11:30:24.657534240,2020-07-27,2020-07-27,2020-07-27,4.0,-56.4,6802.85,0.0,162.0,           ,1.0,1.0,88.0
3738,Ruoka_paivittaistavarakauppa,2020-07-27 15:07:23.835616432,2020-07-27,2020-07-27,2020-07-27,4.0,-8.87,6793.98,0.0,162.0,           ,1.0,1.0,102.0
3739,Luokittelemattomat,2020-07-28 04:16:26.301369856,2020-07-28,2020-07-28,2020-07-28,4.0,-51.5,6742.48,0.0,106.0,OKOYFIHH   ,1.0,0.0,47.0
3740,Luokittelemattomat,2020-07-28 21:02:27.945205472,2020-07-28,2020-07-28,2020-07-28,4.0,-16.88,6725.6,0.0,162.0,           ,1.0,1.0,54.0
3741,Matkailu,2020-07-30 00:39:27.123287664,2020-07-30,2020-07-30,2020-07-30,4.0,-173.38,6552.22,0.0,106.0,OKOYFIHH   ,0.0,0.0,38.0
3742,Ravintolat_kahvilat,2020-07-30 17:25:28.767123280,2020-07-30,2020-07-30,2020-07-30,4.0,-9.88,6542.34,0.0,162.0,           ,1.0,1.0,146.0
3743,Asuminen,2020-07-31 13:48:29.589041088,2020-07-31,2020-07-31,2020-07-30,4.0,-11.06,6531.28,0.0,162.0,           ,1.0,1.0,181.0
3744,Tulot,2020-08-02 11:51:19.518072288,2020-08-02,2020-08-02,2020-08-02,4.0,820.77,7352.05,0.0,505.0,           ,1.0,1.0,203.0
3745,Kulttuuri_viihde,2020-08-03 05:46:59.277108432,2020-08-03,2020-08-03,2020-08-03,4.0,-15.61,7336.44,0.0,106.0,OKOYFIHH   ,0.0,0.0,30.0
3746,Ruoka_paivittaistavarakauppa,2020-08-03 17:55:39.759036144,2020-08-03,2020-08-03,2020-08-03,4.0,-14.16,7322.28,0.0,162.0,           ,1.0,1.0,54.0
3747,Luottojen_maksut,2020-08-03 23:42:39.036144576,2020-08-03,2020-08-03,2020-08-03,4.0,-90.24,7232.04,0.0,106.0,DABAFIHH   ,1.0,0.0,45.0
3748,Luottojen_maksut,2020-08-04 17:38:18.795180720,2020-08-04,2020-08-06,2020-08-04,4.0,-92.37,7139.67,0.0,106.0,OKOYFIHH   ,1.0,0.0,17.0
3749,Muut,2020-08-05 11:33:58.554216864,2020-08-05,2020-08-05,2020-08-05,4.0,-18.2,7121.47,0.0,106.0,OKOYFIHH   ,0.0,0.0,9.0
3750,Hyvinvointijakauneus,2020-08-05 23:25:18.072289152,2020-08-05,2020-08-06,2020-08-05,4.0,-62.55,7058.92,0.0,106.0,OKOYFIHH   ,0.0,0.0,28.0
3751,Matkailu,2020-08-06 05:29:38.313253008,2020-08-06,2020-08-06,2020-08-06,4.0,-43.31,7015.61,0.0,106.0,OKOYFIHH   ,0.0,0.0,19.0
3752,Luottojen_maksut,2020-08-07 11:16:37.590361440,2020-08-07,2020-08-07,2020-08-07,4.0,-193.6,6822.01,0.0,106.0,OKOYFIHH   ,0.0,0.0,17.0
3753,Lemmikit,2020-08-07 17:20:57.831325296,2020-08-07,2020-08-07,2020-08-07,4.0,-45.2,6776.81,0.0,106.0,OKOYFIHH   ,0.0,0.0,45.0
3754,Liikkuminen,2020-08-10 05:12:17.349397584,2020-08-10,2020-08-10,2020-08-10,4.0,-61.2,6715.61,0.0,162.0,           ,1.0,1.0,144.0
3755,Ruoka_paivittaistavarakauppa,2020-08-10 17:03:36.867469872,2020-08-10,2020-08-10,2020-08-10,4.0,-6.89,6708.72,0.0,162.0,           ,1.0,1.0,76.0
3756,Ruoka_paivittaistavarakauppa,2020-08-10 23:07:57.108433728,2020-08-10,2020-08-10,2020-08-10,4.0,-5.47,6703.25,0.0,162.0,           ,1.0,1.0,70.0
3757,Asuminen,2020-08-11 04:54:56.385542160,2020-08-11,2020-08-11,2020-08-11,4.0,-33.59,6669.66,706.0,106.0,OKOYFIHH   ,0.0,0.0,224.0
3758,Liikkuminen,2020-08-11 10:59:16.626506016,2020-08-11,2020-08-11,2020-08-11,4.0,-48.55,6621.11,0.0,162.0,           ,1.0,1.0,106.0
3759,Ruoka_paivittaistavarakauppa,2020-08-11 22:50:36.144578304,2020-08-11,2020-08-11,2020-08-11,4.0,-46.83,6574.28,0.0,162.0,           ,1.0,1.0,128.0
3760,Ruoka_paivittaistavarakauppa,2020-08-14 10:41:55.662650592,2020-08-14,2020-08-14,2020-08-14,4.0,-14.33,6559.95,0.0,162.0,           ,1.0,1.0,128.0
3761,Ruoka_paivittaistavarakauppa,2020-08-14 16:46:15.903614448,2020-08-14,2020-08-14,2020-08-13,4.0,-2.96,6556.99,0.0,162.0,           ,1.0,1.0,116.0
3762,Saastot_sijoitukset,2020-08-15 04:37:35.421686736,2020-08-15,2020-08-15,2020-08-15,4.0,107.79,6664.78,0.0,505.0,           ,1.0,1.0,203.0
3763,Luokittelemattomat,2020-08-17 10:24:34.698795168,2020-08-17,2020-08-21,2020-08-17,4.0,-8.24,6656.54,0.0,162.0,           ,1.0,1.0,95.0
3764,Muut,2020-08-17 16:28:54.939759024,2020-08-17,2020-08-17,2020-08-17,4.0,-7.97,6648.57,0.0,162.0,           ,1.0,1.0,149.0
3765,Luokittelemattomat,2020-08-17 22:33:15.180722880,2020-08-17,2020-08-17,2020-08-17,4.0,-28.16,6620.41,0.0,162.0,           ,1.0,1.0,115.0
3766,Tulot,2020-08-18 04:20:14.457831312,2020-08-18,2020-08-18,2020-08-18,4.0,14.95,6635.36,0.0,505.0,           ,1.0,1.0,208.0
3767,Lemmikit,2020-08-19 16:11:33.975903600,2020-08-19,2020-08-19,2020-08-19,4.0,-17.65,6617.71,0.0,162.0,           ,1.0,1.0,181.0
3768,Harrastukset,2020-08-19 22:15:54.216867456,2020-08-19,2020-08-19,2020-08-19,4.0,-5.45,6612.26,0.0,106.0,NDEAFIHH   ,0.0,0.0,45.0
3769,Muut,2020-08-20 10:07:13.734939744,2020-08-20,2020-08-20,2020-08-20,4.0,-3.54,6608.72,0.0,162.0,           ,1.0,1.0,158.0
3770,Ruoka_paivittaistavarakauppa,2020-08-21 04:02:53.493975888,2020-08-21,2020-08-21,2020-08-21,4.0,-2.28,6606.44,0.0,162.0,           ,1.0,1.0,156.0
3771,Luokittelemattomat,2020-08-21 15:54:13.012048176,2020-08-21,2020-08-24,2020-08-21,4.0,-16.33,6590.11,0.0,162.0,           ,1.0,1.0,123.0
3772,Vakuutukset,2020-08-21 21:58:33.253012032,2020-08-21,2020-08-21,2020-08-21,4.0,-28.56,6561.55,0.0,106.0,OKOYFIHH   ,0.0,0.0,9.0
3773,Ravintolat_kahvilat,2020-08-24 03:45:32.530120464,2020-08-24,2020-08-24,2020-08-24,4.0,-14.52,6547.03,0.0,162.0,           ,1.0,1.0,138.0
3774,Ravintolat_kahvilat,2020-08-24 09:49:52.771084320,2020-08-24,2020-08-24,2020-08-24,4.0,-2.62,6544.41,0.0,162.0,           ,1.0,1.0,131.0
3775,Hyvinvointijakauneus,2020-08-24 21:41:12.289156608,2020-08-24,2020-08-24,2020-08-24,4.0,-70.48,6473.93,0.0,162.0,           ,1.0,1.0,55.0
3776,Luokittelemattomat,2020-08-25 15:36:52.048192752,2020-08-25,2020-08-25,2020-08-25,4.0,-12.89,6461.04,0.0,106.0,OKOYFIHH   ,0.0,0.0,40.0
3777,Ruoka_paivittaistavarakauppa,2020-08-26 09:32:31.807228896,2020-08-26,2020-08-26,2020-08-26,4.0,-9.95,6451.09,0.0,162.0,           ,1.0,1.0,149.0
3778,Liikkuminen,2020-08-27 03:28:11.566265040,2020-08-27,2020-08-27,2020-08-27,4.0,-36.19,6414.9,0.0,106.0,OKOYFIHH   ,1.0,0.0,21.0
3779,Ruoka_paivittaistavarakauppa,2020-08-28 09:15:10.843373472,2020-08-28,2020-08-28,2020-08-28,4.0,-7.52,6407.38,0.0,162.0,           ,1.0,1.0,111.0
3780,Liikkuminen,2020-08-28 15:19:31.084337328,2020-08-28,2020-08-28,2020-08-28,4.0,-27.42,6379.96,0.0,162.0,           ,1.0,1.0,91.0
3781,Tulot,2020-08-28 21:23:51.325301184,2020-08-28,2020-08-28,2020-08-28,4.0,1530.56,7910.52,0.0,505.0,           ,1.0,1.0,203.0
3782,Ruoka_paivittaistavarakauppa,2020-08-31 03:10:50.602409616,2020-08-31,2020-08-31,2020-08-31,4.0,-19.81,7890.71,0.0,162.0,           ,1.0,1.0,164.0
3783,Ruoka_paivittaistavarakauppa,2020-08-31 15:02:10.120481904,2020-08-31,2020-08-31,2020-08-31,4.0,-0.88,7889.83,0.0,162.0,           ,1.0,1.0,103.0
3784,Ruoka_paivittaistavarakauppa,2020-08-31 21:06:30.361445760,2020-08-31,2020-08-31,2020-08-31,4.0,-24.65,7865.18,0.0,162.0,           ,1.0,1.0,143.0
3785,Asuminen,2020-09-02 09:29:18.139534883,2020-09-02,2020-09-02,2020-09-02,4.0,-6.07,7859.11,0.0,162.0,           ,1.0,1.0,126.0
3786,Ruoka_paivittaistavarakauppa,2020-09-03 18:58:36.279069766,2020-09-03,2020-09-03,2020-09-03,4.0,-37.6,7821.51,0.0,162.0,           ,1.0,1.0,145.0
3787,Tulot,2020-09-06 04:27:54.418604649,2020-09-06,2020-09-06,2020-09-06,4.0,1064.9,8886.41,0.0,505.0,           ,1.0,1.0,205.0
3788,Asuminen,2020-09-07 13:57:12.558139532,2020-09-07,2020-09-07,2020-09-07,4.0,-10.1,8876.31,0.0,162.0,           ,1.0,1.0,142.0
3789,Ruoka_paivittaistavarakauppa,2020-09-07 23:26:30.697674415,2020-09-07,2020-09-07,2020-09-07,4.0,-12.06,8864.25,0.0,162.0,           ,1.0,1.0,102.0
3790,Ravintolat_kahvilat,2020-09-08 08:55:48.837209298,2020-09-08,2020-09-08,2020-09-08,4.0,-75.59,8788.66,0.0,162.0,           ,1.0,1.0,68.0
3791,Ravintolat_kahvilat,2020-09-09 18:25:06.976744181,2020-09-09,2020-09-09,2020-09-09,4.0,-4.45,8784.21,0.0,162.0,           ,1.0,1.0,167.0
3792,Ruoka_paivittaistavarakauppa,2020-09-11 03:54:25.116279064,2020-09-11,2020-09-11,2020-09-11,4.0,-41.67,8742.54,0.0,162.0,           ,1.0,1.0,54.0
3793,Ruoka_paivittaistavarakauppa,2020-09-14 13:23:43.255813947,2020-09-14,2020-09-14,2020-09-14,4.0,-6.36,8736.18,0.0,162.0,           ,1.0,1.0,150.0
3794,Tulot,2020-09-14 22:53:01.395348830,2020-09-14,2020-09-14,2020-09-14,4.0,202.32,8938.5,0.0,505.0,           ,1.0,1.0,203.0
3795,Luokittelemattomat,2020-09-16 08:22:19.534883713,2020-09-16,2020-09-16,2020-09-16,4.0,-40.82,8897.68,0.0,106.0,NDEAFIHH   ,1.0,0.0,44.0
3796,Luokittelemattomat,2020-09-18 03:20:55.813953479,2020-09-18,2020-09-18,2020-09-18,4.0,-4.88,8892.8,0.0,162.0,           ,1.0,1.0,168.0
3797,Tulot,2020-09-18 17:51:37.674418596,2020-09-18,2020-09-18,2020-09-18,4.0,116.4,9009.2,0.0,505.0,           ,1.0,1.0,203.0
3798,Tulot,2020-09-20 22:19:32.093023245,2020-09-20,2020-09-20,2020-09-20,4.0,379.11,9388.31,0.0,505.0,           ,1.0,1.0,206.0
3799,Ruoka_paivittaistavarakauppa,2020-09-21 12:50:13.953488362,2020-09-21,2020-09-21,2020-09-18,4.0,-21.39,9366.92,0.0,162.0,           ,1.0,1.0,93.0
3800,Tulot,2020-09-23 07:48:50.232558128,2020-09-23,2020-09-23,2020-09-23,4.0,1384.19,10751.11,0.0,505.0,           ,1.0,1.0,203.0
3801,Ruoka_paivittaistavarakauppa,2020-09-24 17:18:08.372093011,2020-09-24,2020-09-24,2020-09-24,4.0,-21.4,10729.71,0.0,162.0,           ,1.0,1.0,156.0
3802,Ruoka_paivittaistavarakauppa,2020-09-28 02:47:26.511627894,2020-09-28,2020-09-28,2020-09-28,4.0,-29.41,10700.3,0.0,162.0,           ,1.0,1.0,56.0
3803,Ruoka_paivittaistavarakauppa,2020-09-28 12:16:44.651162777,2020-09-28,2020-09-28,2020-09-28,4.0,-2.97,10697.33,0.0,162.0,           ,1.0,1.0,181.0
3804,Tulot,2020-09-28 21:46:02.790697660,2020-09-28,2020-09-29,2020-09-28,4.0,1611.12,12308.45,0.0,505.0,           ,1.0,1.0,204.0
3805,Luokittelemattomat,2020-09-29 07:15:20.930232543,2020-09-29,2020-09-29,2020-09-29,4.0,-98.94,12209.51,0.0,106.0,OKOYFIHH   ,1.0,0.0,40.0
3806,Tulot,2020-10-02 21:05:27.272727272,2020-10-02,2020-10-02,2020-10-02,4.0,374.67,12584.18,0.0,505.0,           ,1.0,1.0,204.0
3807,Luottojen_maksut,2020-10-05 18:10:54.545454544,2020-10-05,2020-10-05,2020-10-05,4.0,-288.37,12295.81,0.0,106.0,OKOYFIHH   ,1.0,0.0,17.0
3808,Tulot,2020-10-06 15:16:21.818181816,2020-10-06,2020-10-06,2020-10-06,4.0,441.17,12736.98,0.0,505.0,           ,1.0,1.0,203.0
3809,Ravintolat_kahvilat,2020-10-08 09:27:16.363636360,2020-10-08,2020-10-08,2020-10-08,4.0,-4.25,12732.73,0.0,162.0,           ,1.0,1.0,167.0
3810,Hyvinvointijakauneus,2020-10-08 12:21:49.090909088,2020-10-08,2020-10-08,2020-10-08,4.0,-22.86,12709.87,0.0,162.0,           ,1.0,1.0,86.0
3811,Liikkuminen,2020-10-12 06:32:43.636363632,2020-10-12,2020-10-12,2020-10-12,4.0,-92.49,12617.38,0.0,162.0,           ,1.0,1.0,54.0
3812,Liikkuminen,2020-10-14 03:38:10.909090904,2020-10-14,2020-10-14,2020-10-14,4.0,-4.16,12613.22,0.0,106.0,OKOYFIHH   ,0.0,0.0,44.0
3813,Ravintolat_kahvilat,2020-10-16 00:43:38.181818176,2020-10-16,2020-10-16,2020-10-16,4.0,-54.42,12558.8,0.0,162.0,           ,1.0,1.0,76.0
3814,Tulot,2020-10-17 21:49:05.454545448,2020-10-17,2020-10-17,2020-10-17,4.0,119.71,12678.51,0.0,505.0,           ,1.0,1.0,203.0
3815,Luokittelemattomat,2020-10-19 18:54:32.727272720,2020-10-19,2020-10-19,2020-10-19,4.0,-12.44,12666.07,0.0,106.0,OKOYFIHH   ,1.0,0.0,18.0
3816,Asuminen,2020-10-21 15:59:59.999999992,2020-10-21,2020-10-21,2020-10-21,4.0,-56.96,12609.11,0.0,106.0,OKOYFIHH   ,0.0,0.0,16.0
3817,Tulot,2020-10-23 13:05:27.272727264,2020-10-23,2020-10-23,2020-10-23,4.0,65.37,12674.48,0.0,505.0,           ,1.0,1.0,203.0
3818,Muut,2020-10-24 07:16:21.818181808,2020-10-24,2020-10-24,2020-10-24,4.0,-36.46,12638.02,0.0,106.0,OKOYFIHH   ,0.0,0.0,23.0
3819,Tulot,2020-10-26 10:10:54.545454536,2020-10-26,2020-10-26,2020-10-26,4.0,4.64,12642.66,0.0,505.0,           ,1.0,1.0,203.0
3820,Luottojen_maksut,2020-10-29 04:21:49.090909080,2020-10-29,2020-10-29,2020-10-29,4.0,-121.45,12521.21,0.0,106.0,           ,1.0,1.0,40.0
3821,Lemmikit,2020-10-31 01:27:16.363636352,2020-10-31,2020-10-31,2020-10-31,4.0,-27.29,12493.92,0.0,106.0,OKOYFIHH   ,0.0,0.0,28.0
3822,Tulot,2020-11-02 12:27:20.506329112,2020-11-02,2020-11-02,2020-11-02,4.0,295.46,12789.38,0.0,505.0,           ,1.0,1.0,203.0
3823,Ruoka_paivittaistavarakauppa,2020-11-02 18:13:40.253164556,2020-11-02,2020-11-02,2020-11-02,4.0,-35.0,12754.38,0.0,162.0,           ,1.0,1.0,148.0
3824,Luokittelemattomat,2020-11-03 06:41:00.759493668,2020-11-03,2020-11-03,2020-11-03,4.0,-879.7,11874.68,0.0,106.0,OKOYFIHH   ,1.0,0.0,46.0
3825,Matkailu,2020-11-04 00:54:41.012658224,2020-11-04,2020-11-04,2020-11-04,4.0,-264.78,11609.9,0.0,106.0,NDEAFIHH   ,0.0,0.0,12.0
3826,Asuminen,2020-11-04 19:08:21.265822780,2020-11-04,2020-11-04,2020-11-04,4.0,-161.88,11448.02,0.0,106.0,OKOYFIHH   ,0.0,0.0,11.0
3827,Liikkuminen,2020-11-05 13:22:01.518987336,2020-11-05,2020-11-05,2020-11-05,4.0,-367.87,11080.15,0.0,106.0,OKOYFIHH   ,0.0,0.0,28.0
3828,Tulot,2020-11-06 01:49:22.025316448,2020-11-06,2020-11-06,2020-11-06,4.0,34.04,11114.19,710.0,506.0,           ,1.0,1.0,240.0
3829,Tulot,2020-11-06 07:35:41.772151892,2020-11-06,2020-11-06,2020-11-06,4.0,16.36,11130.55,710.0,506.0,           ,1.0,1.0,244.0
3830,Tulot,2020-11-07 14:16:42.531645560,2020-11-07,2020-11-07,2020-11-07,4.0,685.67,11816.22,0.0,505.0,           ,1.0,1.0,203.0
3831,Luokittelemattomat,2020-11-09 08:30:22.784810116,2020-11-09,2020-11-09,2020-11-09,4.0,-931.09,10885.13,0.0,106.0,NDEAFIHH   ,0.0,0.0,7.0
3832,Matkailu,2020-11-09 09:25:03.797468340,2020-11-09,2020-11-10,2020-11-09,4.0,-1027.82,9857.31,0.0,172.0,           ,1.0,1.0,197.0
3833,Liikkuminen,2020-11-09 20:03:02.278481004,2020-11-09,2020-11-09,2020-11-09,4.0,-32.27,9825.04,0.0,162.0,           ,1.0,1.0,138.0
3834,Ruoka_paivittaistavarakauppa,2020-11-10 02:44:03.037974672,2020-11-10,2020-11-10,2020-11-10,4.0,-39.67,9785.37,0.0,162.0,           ,1.0,1.0,135.0
3835,Tulot,2020-11-11 20:57:43.291139228,2020-11-11,2020-11-12,2020-11-11,4.0,146.36,9931.73,0.0,505.0,           ,1.0,1.0,203.0
3836,Luottojen_maksut,2020-11-13 03:38:44.050632896,2020-11-13,2020-11-13,2020-11-13,4.0,-86.76,9844.97,0.0,172.0,           ,1.0,1.0,196.0
3837,Asuminen,2020-11-13 10:19:44.810126564,2020-11-13,2020-11-13,2020-11-13,4.0,-73.42,9771.55,706.0,106.0,NDEAFIHH   ,0.0,0.0,224.0
3838,Luottojen_maksut,2020-11-13 15:11:23.544303784,2020-11-13,2020-11-13,2020-11-13,4.0,-25.9,9745.65,0.0,106.0,OKOYFIHH   ,0.0,0.0,11.0
3839,Luokittelemattomat,2020-11-13 21:52:24.303797452,2020-11-13,2020-11-13,2020-11-13,4.0,-1332.99,8412.66,706.0,106.0,OKOYFIHH   ,1.0,0.0,225.0
3840,Tulot,2020-11-15 17:00:45.569620232,2020-11-15,2020-11-15,2020-11-15,4.0,-141.06,8271.6,0.0,106.0,OKOYFIHH   ,0.0,0.0,45.0
3841,Asuminen,2020-11-16 04:33:25.063291120,2020-11-16,2020-11-16,2020-11-16,4.0,-219.06,8052.54,706.0,106.0,OKOYFIHH   ,0.0,0.0,226.0
3842,Asuminen,2020-11-16 16:06:04.556962008,2020-11-16,2020-11-16,2020-11-16,4.0,-99.68,7952.86,706.0,106.0,DABAFIHH   ,0.0,0.0,224.0
3843,Luottojen_maksut,2020-11-16 22:47:05.316455676,2020-11-16,2020-11-16,2020-11-16,4.0,-327.21,7625.65,0.0,106.0,OKOYFIHH   ,0.0,0.0,10.0
3844,Luokittelemattomat,2020-11-18 05:28:06.075949344,2020-11-18,2020-11-18,2020-11-18,4.0,-118.92,7506.73,0.0,106.0,HANDFIHH   ,0.0,0.0,8.0
3845,Vakuutukset,2020-11-18 11:14:25.822784788,2020-11-18,2020-11-18,2020-11-18,4.0,-38.74,7467.99,0.0,106.0,DABAFIHH   ,0.0,0.0,8.0
3846,Matkailu,2020-11-19 23:41:46.329113900,2020-11-19,2020-11-19,2020-11-19,4.0,-55.63,7412.36,0.0,106.0,OKOYFIHH   ,0.0,0.0,35.0
3847,Luokittelemattomat,2020-11-20 17:55:26.582278456,2020-11-20,2020-11-20,2020-11-20,4.0,-12.61,7399.75,0.0,106.0,NDEAFIHH   ,1.0,0.0,15.0
3848,Luottojen_maksut,2020-11-22 18:50:07.594936680,2020-11-22,2020-11-22,2020-11-22,4.0,-169.06,7230.69,0.0,106.0,POPFFI22   ,1.0,0.0,17.0
3849,Liikkuminen,2020-11-23 06:22:47.088607568,2020-11-23,2020-11-23,2020-11-23,4.0,-307.52,6923.17,0.0,106.0,NDEAFIHH   ,0.0,0.0,7.0
3850,Asuminen,2020-11-23 12:09:06.835443012,2020-11-23,2020-11-24,2020-11-23,4.0,-205.8,6717.37,0.0,106.0,OKOYFIHH   ,0.0,0.0,20.0
3851,Luokittelemattomat,2020-11-23 13:03:47.848101236,2020-11-23,2020-11-24,2020-11-23,4.0,-182.1,6535.27,0.0,106.0,OKOYFIHH   ,1.0,0.0,47.0
3852,Muut,2020-11-24 00:36:27.341772124,2020-11-24,2020-11-24,2020-11-24,4.0,-10.03,6525.24,0.0,106.0,OKOYFIHH   ,0.0,0.0,45.0
3853,Luokittelemattomat,2020-11-25 07:17:28.101265792,2020-11-25,2020-11-26,2020-11-25,4.0,-24.43,6500.81,0.0,106.0,NDEAFIHH   ,0.0,0.0,9.0
3854,Tulot,2020-11-25 19:44:48.607594904,2020-11-25,2020-11-25,2020-11-25,4.0,881.76,7382.57,0.0,588.0,           ,0.0,1.0,212.0
3855,Asuminen,2020-11-26 13:58:28.860759460,2020-11-26,2020-11-26,2020-11-26,4.0,-175.36,7207.21,0.0,106.0,OKOYFIHH   ,0.0,0.0,12.0
3856,Liikkuminen,2020-11-27 08:12:09.113924016,2020-11-27,2020-11-27,2020-11-27,4.0,-86.07,7121.14,0.0,106.0,OKOYFIHH   ,1.0,0.0,40.0
3857,Muut,2020-11-28 01:31:08.354430348,2020-11-28,2020-11-28,2020-11-28,4.0,-21.23,7099.91,0.0,163.0,           ,1.0,1.0,189.0
3858,Luokittelemattomat,2020-11-29 20:39:29.620253128,2020-11-29,2020-11-29,2020-11-29,4.0,-57.95,7041.96,0.0,106.0,OKOYFIHH   ,1.0,0.0,19.0
3859,Lemmikit,2020-11-30 02:25:49.367088572,2020-11-30,2020-11-30,2020-11-30,4.0,-17.55,7024.41,0.0,106.0,OKOYFIHH   ,1.0,0.0,13.0
3860,Luokittelemattomat,2020-11-30 14:53:09.873417684,2020-11-30,2020-11-30,2020-11-30,4.0,-27.79,6996.62,0.0,106.0,OKOYFIHH   ,0.0,0.0,7.0
3861,Hyvinvointi,2020-12-01 11:54:14.400000000,2020-12-01,2020-12-01,2020-12-01,4.0,-19.47,6977.15,0.0,106.0,OKOYFIHH   ,0.0,0.0,32.0
3862,Tulot,2020-12-01 23:48:28.800000000,2020-12-01,2020-12-01,2020-12-01,4.0,-40.34,6936.81,0.0,106.0,OKOYFIHH   ,0.0,0.0,16.0
3863,Asuminen,2020-12-02 11:42:43.200000000,2020-12-02,2020-12-02,2020-12-02,4.0,-19.4,6917.41,0.0,106.0,OKOYFIHH   ,0.0,0.0,8.0
3864,Ruoka_paivittaistavarakauppa,2020-12-02 23:02:24.000000000,2020-12-02,2020-12-02,2020-12-02,4.0,-12.56,6904.85,0.0,162.0,           ,1.0,1.0,160.0
3865,Terveys,2020-12-03 11:08:09.600000000,2020-12-03,2020-12-03,2020-12-03,4.0,-22.2,6882.65,0.0,162.0,           ,1.0,1.0,118.0
3866,Asuminen,2020-12-03 11:31:12.000000000,2020-12-03,2020-12-03,2020-12-03,4.0,-87.18,6795.47,0.0,106.0,OKOYFIHH   ,0.0,0.0,14.0
3867,Luokittelemattomat,2020-12-03 23:25:26.400000000,2020-12-03,2020-12-03,2020-12-03,4.0,-98.39,6697.08,0.0,106.0,OKOYFIHH   ,1.0,0.0,47.0
3868,Muut,2020-12-04 11:19:40.800000000,2020-12-04,2020-12-04,2020-12-04,4.0,-282.76,6414.32,0.0,105.0,OKOYFIHH   ,1.0,0.0,4.0
3869,Liikkuminen,2020-12-04 23:13:55.200000000,2020-12-04,2020-12-04,2020-12-04,4.0,-55.53,6358.79,0.0,162.0,           ,1.0,1.0,130.0
3870,Muut,2020-12-04 23:36:57.600000000,2020-12-04,2020-12-04,2020-12-04,4.0,-20.1,6338.69,0.0,103.0,           ,0.0,1.0,2.0
3871,Vakuutukset,2020-12-06 10:22:04.800000000,2020-12-06,2020-12-06,2020-12-06,4.0,-157.46,6181.23,0.0,106.0,SBANFIHH   ,0.0,0.0,44.0
3872,Lapset,2020-12-06 22:27:50.400000000,2020-12-06,2020-12-06,2020-12-06,4.0,-52.12,6129.11,0.0,106.0,OKOYFIHH   ,0.0,0.0,17.0
3873,Luottojen_maksut,2020-12-07 10:45:07.200000000,2020-12-07,2020-12-07,2020-12-07,4.0,-78.03,6051.08,0.0,106.0,OKOYFIHH   ,1.0,0.0,47.0
3874,Ruoka_paivittaistavarakauppa,2020-12-07 10:56:38.400000000,2020-12-07,2020-12-07,2020-12-10,4.0,-15.21,6035.87,0.0,162.0,           ,1.0,1.0,130.0
3875,Kulttuuri_viihde,2020-12-07 22:39:21.600000000,2020-12-07,2020-12-07,2020-12-07,4.0,-3.24,6032.63,0.0,162.0,           ,1.0,1.0,70.0
3876,Hyvinvointi,2020-12-07 22:50:52.800000000,2020-12-07,2020-12-07,2020-12-07,4.0,-23.42,6009.21,0.0,162.0,           ,1.0,1.0,72.0
3877,Lapset,2020-12-08 10:33:36.000000000,2020-12-08,2020-12-08,2020-12-08,4.0,-3.98,6005.23,0.0,106.0,OKOYFIHH   ,0.0,0.0,45.0
3878,Vakuutukset,2020-12-09 22:16:19.200000000,2020-12-09,2020-12-09,2020-12-09,4.0,-238.79,5766.44,0.0,106.0,OKOYFIHH   ,0.0,0.0,17.0
3879,Asuminen,2020-12-10 09:47:31.200000000,2020-12-10,2020-12-10,2020-12-10,4.0,-20.24,5746.2,0.0,106.0,OKOYFIHH   ,0.0,0.0,27.0
3880,Ruoka_paivittaistavarakauppa,2020-12-11 10:10:33.600000000,2020-12-11,2020-12-11,2020-12-11,4.0,-57.69,5688.51,0.0,162.0,           ,1.0,1.0,160.0
3881,Luokittelemattomat,2020-12-11 21:53:16.800000000,2020-12-11,2020-12-11,2020-12-11,4.0,-34.64,5653.87,0.0,106.0,OKOYFIHH   ,1.0,0.0,9.0
3882,Lapset,2020-12-11 22:04:48.000000000,2020-12-11,2020-12-11,2020-12-11,4.0,-41.26,5612.61,0.0,106.0,OKOYFIHH   ,0.0,0.0,7.0
3883,Matkailu,2020-12-12 09:59:02.400000000,2020-12-12,2020-12-12,2020-12-12,4.0,-17.78,5594.83,0.0,106.0,OKOYFIHH   ,0.0,0.0,15.0
3884,Luokittelemattomat,2020-12-13 21:41:45.600000000,2020-12-13,2020-12-13,2020-12-13,4.0,-80.67,5514.16,0.0,106.0,OKOYFIHH   ,1.0,0.0,44.0
3885,Asuminen,2020-12-14 09:24:28.800000000,2020-12-14,2020-12-16,2020-12-14,4.0,-100.4,5413.76,0.0,106.0,NDEAFIHH   ,0.0,0.0,14.0
3886,Asuminen,2020-12-14 09:36:00.000000000,2020-12-14,2020-12-14,2020-12-14,4.0,-37.37,5376.39,0.0,106.0,OKOYFIHH   ,0.0,0.0,44.0
3887,Luokittelemattomat,2020-12-14 21:18:43.200000000,2020-12-14,2020-12-14,2020-12-14,4.0,-18.21,5358.18,0.0,106.0,DABAFIHH   ,1.0,0.0,16.0
3888,Vakuutukset,2020-12-14 21:30:14.400000000,2020-12-14,2020-12-16,2020-12-14,4.0,-64.6,5293.58,0.0,106.0,SBANFIHH   ,0.0,0.0,44.0
3889,Tulot,2020-12-15 09:12:57.600000000,2020-12-15,2020-12-15,2020-12-15,4.0,1867.74,7161.32,710.0,588.0,           ,0.0,1.0,245.0
3890,Luokittelemattomat,2020-12-15 21:07:12.000000000,2020-12-15,2020-12-15,2020-12-15,4.0,-50.29,7111.03,0.0,106.0,OKOYFIHH   ,1.0,0.0,48.0
3891,Asuminen,2020-12-16 08:49:55.200000000,2020-12-16,2020-12-16,2020-12-15,4.0,-72.65,7038.38,0.0,106.0,OKOYFIHH   ,0.0,0.0,35.0
3892,Luottojen_maksut,2020-12-16 09:01:26.400000000,2020-12-16,2020-12-16,2020-12-16,4.0,-18.97,7019.41,0.0,106.0,SBANFIHH   ,0.0,0.0,17.0
3893,Luottojen_maksut,2020-12-16 20:55:40.800000000,2020-12-16,2020-12-16,2020-12-16,4.0,-86.16,6933.25,0.0,106.0,POPFFI22   ,1.0,0.0,8.0
3894,Tulot,2020-12-17 20:44:09.600000000,2020-12-17,2020-12-17,2020-12-17,4.0,-58.71,6874.54,0.0,106.0,DABAFIHH   ,0.0,0.0,47.0
3895,Luottojen_maksut,2020-12-18 08:38:24.000000000,2020-12-14,2020-12-18,2020-12-18,4.0,-166.41,6708.13,0.0,106.0,OKOYFIHH   ,0.0,0.0,34.0
3896,Luokittelemattomat,2020-12-18 20:32:38.400000000,2020-12-18,2020-12-18,2020-12-18,4.0,-9.92,6698.21,0.0,106.0,OKOYFIHH   ,0.0,0.0,47.0
3897,Luottojen_maksut,2020-12-20 08:03:50.400000000,2020-12-20,2020-12-20,2020-12-20,4.0,-84.87,6613.34,0.0,106.0,DABAFIHH   ,0.0,0.0,44.0
3898,Matkailu,2020-12-20 08:26:52.800000000,2020-12-20,2020-12-20,2020-12-20,4.0,-58.69,6554.65,0.0,106.0,DABAFIHH   ,0.0,0.0,45.0
3899,Asuminen,2020-12-21 08:15:21.600000000,2020-12-21,2020-12-21,2020-12-21,4.0,-140.23,6414.42,0.0,106.0,OKOYFIHH   ,0.0,0.0,35.0
3900,Hyvinvointijakauneus,2020-12-21 20:09:36.000000000,2020-12-21,2020-12-21,2020-12-21,4.0,-20.3,6394.12,0.0,162.0,           ,1.0,1.0,99.0
3901,Asuminen,2020-12-21 20:21:07.200000000,2020-12-21,2020-12-21,2020-12-21,4.0,-75.98,6318.14,0.0,106.0,OKOYFIHH   ,0.0,0.0,45.0
3902,Luokittelemattomat,2020-12-22 07:52:19.200000000,2020-12-22,2020-12-22,2020-12-22,4.0,-167.91,6150.23,0.0,106.0,OKOYFIHH   ,1.0,0.0,15.0
3903,Tulot,2020-12-23 19:35:02.400000000,2020-12-23,2020-12-23,2020-12-23,4.0,2188.17,8338.4,701.0,510.0,           ,1.0,1.0,218.0
3904,Matkailu,2020-12-23 19:46:33.600000000,2020-12-23,2020-12-23,2020-12-23,4.0,-31.72,8306.68,0.0,106.0,OKOYFIHH   ,0.0,0.0,22.0
3905,Vakuutukset,2020-12-23 19:58:04.800000000,2020-12-23,2020-12-23,2020-12-23,4.0,-468.45,7838.23,0.0,106.0,OKOYFIHH   ,0.0,0.0,44.0
3906,Tulot,2020-12-24 07:40:48.000000000,2020-12-24,2020-12-24,2020-12-24,4.0,50.85,7889.08,710.0,506.0,           ,1.0,1.0,238.0
3907,Terveys,2020-12-24 19:12:00.000000000,2020-12-24,2020-12-24,2020-12-24,4.0,-36.68,7852.4,0.0,106.0,NDEAFIHH   ,0.0,0.0,47.0
3908,Muut,2020-12-24 19:23:31.200000000,2020-12-24,2020-12-24,2020-12-24,4.0,-25.21,7827.19,0.0,106.0,OKOYFIHH   ,0.0,0.0,30.0
3909,Tulot,2020-12-25 07:29:16.800000000,2020-12-25,2020-12-25,2020-12-25,4.0,11.74,7838.93,701.0,521.0,           ,1.0,1.0,222.0
3910,Asuminen,2020-12-26 07:17:45.600000000,2020-12-26,2020-12-26,2020-12-26,4.0,-49.27,7789.66,0.0,106.0,DABAFIHH   ,0.0,0.0,23.0
3911,Tulot,2020-12-27 07:06:14.400000000,2020-12-27,2020-12-29,2020-12-27,4.0,-1418.39,6371.27,0.0,106.0,OKOYFIHH   ,0.0,0.0,9.0
3912,Matkailu,2020-12-27 19:00:28.800000000,2020-12-27,2020-12-27,2020-12-27,4.0,-16.34,6354.93,0.0,106.0,           ,1.0,1.0,9.0
3913,Asuminen,2020-12-28 06:43:12.000000000,2020-12-28,2020-12-28,2020-12-28,4.0,-97.76,6257.17,0.0,106.0,OKOYFIHH   ,0.0,0.0,8.0
3914,Liikkuminen,2020-12-28 06:54:43.200000000,2020-12-28,2020-12-28,2020-12-28,4.0,-23.94,6233.23,0.0,106.0,OKOYFIHH   ,1.0,0.0,7.0
3915,Luottojen_maksut,2020-12-28 18:37:26.400000000,2020-12-28,2020-12-28,2020-12-28,4.0,-49.31,6183.92,0.0,106.0,OKOYFIHH   ,1.0,0.0,18.0
3916,Terveys,2020-12-28 18:48:57.600000000,2020-12-28,2020-12-28,2020-12-28,4.0,-9.95,6173.97,0.0,106.0,NDEAFIHH   ,0.0,0.0,45.0
3917,Shoppailu,2020-12-29 06:20:09.600000000,2020-12-29,2020-12-29,2020-12-28,4.0,-13.12,6160.85,0.0,106.0,OKOYFIHH   ,0.0,0.0,9.0
3918,Lemmikit,2020-12-29 18:25:55.200000000,2020-12-29,2020-12-29,2020-12-29,4.0,-343.36,5817.49,0.0,106.0,OKOYFIHH   ,0.0,0.0,48.0
3919,Harrastukset,2020-12-30 06:31:40.800000000,2020-12-30,2020-12-30,2020-12-30,4.0,-3.07,5814.42,0.0,106.0,NDEAFIHH   ,0.0,0.0,13.0
3920,Luokittelemattomat,2020-12-30 18:02:52.800000000,2020-12-30,2020-12-31,2020-12-30,4.0,-37.1,5777.32,0.0,106.0,NDEAFIHH   ,0.0,0.0,17.0
3921,Luottojen_maksut,2020-12-30 18:14:24.000000000,2020-12-30,2020-12-30,2020-12-30,4.0,-18.29,5759.03,0.0,106.0,OKOYFIHH   ,1.0,0.0,45.0
3922,Matkailu,2020-12-31 06:08:38.400000000,2020-12-31,2021-01-01,2020-12-31,4.0,-58.22,5700.81,0.0,106.0,NDEAFIHH   ,1.0,0.0,7.0
3923,Tulot,2019-01-01 00:00:00.000000000,2019-01-01,2019-01-01,2019-01-01,5.0,910.64,1358.06,0.0,506.0,           ,1.0,1.0,222.0
3924,Tulot,2019-01-02 00:23:36.393442622,2019-01-02,2019-01-02,2019-01-01,5.0,473.59,1831.65,0.0,506.0,           ,1.0,1.0,216.0
3925,Tulot,2019-01-03 00:47:12.786885244,2019-01-03,2019-01-03,2019-01-03,5.0,764.53,2596.18,0.0,506.0,           ,1.0,1.0,223.0
3926,Tulot,2019-01-03 01:34:25.573770488,2019-01-03,2019-01-04,2019-01-03,5.0,807.23,3403.41,701.0,520.0,           ,1.0,1.0,236.0
3927,Tulot,2019-01-04 01:10:49.180327866,2019-01-04,2019-01-04,2019-01-04,5.0,357.73,3761.14,0.0,506.0,           ,1.0,1.0,216.0
3928,Matkailu,2019-01-07 01:58:01.967213110,2019-01-07,2019-01-07,2019-01-07,5.0,-35.23,3725.91,0.0,106.0,OKOYFIHH   ,0.0,0.0,23.0
3929,Muut,2019-01-07 02:21:38.360655732,2019-01-03,2019-01-07,2019-01-07,5.0,-48.47,3677.44,0.0,105.0,OKOYFIHH   ,1.0,0.0,4.0
3930,Ruoka_paivittaistavarakauppa,2019-01-08 02:45:14.754098354,2019-01-08,2019-01-08,2019-01-08,5.0,-4.31,3673.13,0.0,162.0,           ,1.0,1.0,123.0
3931,Terveys,2019-01-09 03:08:51.147540976,2019-01-09,2019-01-09,2019-01-09,5.0,-232.41,3440.72,0.0,162.0,           ,1.0,1.0,82.0
3932,Liikkuminen,2019-01-09 03:32:27.540983598,2019-01-09,2019-01-09,2019-01-09,5.0,-18.52,3422.2,0.0,162.0,           ,1.0,1.0,101.0
3933,Shoppailu,2019-01-11 03:56:03.934426220,2019-01-11,2019-01-11,2019-01-11,5.0,-39.7,3382.5,0.0,162.0,           ,1.0,1.0,66.0
3934,Tulot,2019-01-12 04:19:40.327868842,2019-01-12,2019-01-12,2019-01-12,5.0,281.78,3664.28,0.0,506.0,           ,1.0,1.0,217.0
3935,Tulot,2019-01-14 04:43:16.721311464,2019-01-14,2019-01-14,2019-01-14,5.0,54.38,3718.66,710.0,506.0,           ,1.0,1.0,265.0
3936,Muut,2019-01-14 05:06:53.114754086,2019-01-14,2019-01-14,2019-01-14,5.0,-88.26,3630.4,0.0,105.0,OKOYFIHH   ,1.0,0.0,3.0
3937,Muut,2019-01-15 05:30:29.508196708,2019-01-15,2019-01-15,2019-01-15,5.0,-115.11,3515.29,0.0,105.0,OKOYFIHH   ,1.0,0.0,3.0
3938,Saastot_sijoitukset,2019-01-15 05:54:05.901639330,2019-01-15,2019-01-15,2019-01-15,5.0,-18.4,3496.89,0.0,162.0,           ,1.0,1.0,84.0
3939,Liikkuminen,2019-01-16 06:17:42.295081952,2019-01-16,2019-01-16,2019-01-16,5.0,-125.24,3371.65,0.0,162.0,           ,1.0,1.0,108.0
3940,Tulot,2019-01-18 06:41:18.688524574,2019-01-18,2019-01-18,2019-01-18,5.0,246.05,3617.7,0.0,506.0,           ,1.0,1.0,216.0
3941,Luokittelemattomat,2019-01-21 07:04:55.081967196,2019-01-21,2019-01-21,2019-01-21,5.0,-12.36,3605.34,0.0,162.0,           ,1.0,1.0,125.0
3942,Luokittelemattomat,2019-01-21 07:28:31.475409818,2019-01-21,2019-01-21,2019-01-21,5.0,-11.86,3593.48,0.0,162.0,           ,1.0,1.0,132.0
3943,Liikkuminen,2019-01-21 07:52:07.868852440,2019-01-21,2019-01-23,2019-01-21,5.0,-14.07,3579.41,0.0,162.0,           ,1.0,1.0,184.0
3944,Saastot_sijoitukset,2019-01-22 08:39:20.655737684,2019-01-22,2019-01-22,2019-01-22,5.0,-14.17,3565.24,0.0,162.0,           ,1.0,1.0,114.0
3945,Ruoka_paivittaistavarakauppa,2019-01-23 08:15:44.262295062,2019-01-23,2019-01-23,2019-01-23,5.0,-60.37,3504.87,0.0,106.0,HANDFIHH   ,0.0,0.0,12.0
3946,Saastot_sijoitukset,2019-01-24 09:26:33.442622928,2019-01-24,2019-01-24,2019-01-24,5.0,-32.74,3472.13,0.0,162.0,           ,1.0,1.0,142.0
3947,Luottojen_maksut,2019-01-26 09:02:57.049180306,2019-01-26,2019-01-26,2019-01-26,5.0,-18.62,3453.51,0.0,106.0,HANDFIHH   ,1.0,0.0,43.0
3948,Luottojen_maksut,2019-01-28 09:50:09.836065550,2019-01-28,2019-01-28,2019-01-28,5.0,-34.43,3419.08,0.0,162.0,           ,1.0,1.0,174.0
3949,Harrastukset,2019-01-28 10:13:46.229508172,2019-01-28,2019-01-28,2019-01-28,5.0,-35.62,3383.46,0.0,162.0,           ,1.0,1.0,138.0
3950,Tulot,2019-01-28 10:37:22.622950794,2019-01-28,2019-01-28,2019-01-28,5.0,81.87,3465.33,0.0,588.0,           ,0.0,1.0,229.0
3951,Tulot,2019-01-30 11:00:59.016393416,2019-01-30,2019-01-30,2019-01-29,5.0,16.65,3481.98,0.0,506.0,           ,1.0,1.0,221.0
3952,Luottojen_maksut,2019-01-30 11:24:35.409836038,2019-01-30,2019-01-30,2019-01-30,5.0,-10.23,3471.75,0.0,106.0,ITELFIHH   ,0.0,0.0,35.0
3953,Ruoka_paivittaistavarakauppa,2019-01-31 11:48:11.803278660,2019-01-31,2019-01-31,2019-01-31,5.0,-3.56,3468.19,0.0,162.0,           ,1.0,1.0,120.0
3954,Ravintolat_kahvilat,2019-02-01 22:20:41.379310344,2019-02-01,2019-02-01,2019-02-01,5.0,-18.53,3449.66,706.0,105.0,OKOYFIHH   ,1.0,0.0,244.0
3955,Saastot_sijoitukset,2019-02-04 20:41:22.758620688,2019-02-04,2019-02-04,2019-02-04,5.0,-4.28,3445.38,0.0,162.0,           ,1.0,1.0,162.0
3956,Ruoka_paivittaistavarakauppa,2019-02-05 19:02:04.137931032,2019-02-05,2019-02-05,2019-02-05,5.0,-132.0,3313.38,0.0,162.0,           ,1.0,1.0,73.0
3957,Tulot,2019-02-08 17:22:45.517241376,2019-02-08,2019-02-08,2019-02-08,5.0,154.95,3468.33,0.0,506.0,           ,1.0,1.0,216.0
3958,Asuminen,2019-02-10 15:43:26.896551720,2019-02-10,2019-02-10,2019-02-10,5.0,-95.92,3372.41,0.0,106.0,OKOYFIHH   ,0.0,0.0,30.0
3959,Luottojen_maksut,2019-02-12 14:04:08.275862064,2019-02-12,2019-02-12,2019-02-12,5.0,-41.49,3330.92,0.0,106.0,OKOYFIHH   ,1.0,0.0,38.0
3960,Tulot,2019-02-15 12:24:49.655172408,2019-02-15,2019-02-15,2019-02-15,5.0,1057.62,4388.54,0.0,506.0,           ,1.0,1.0,216.0
3961,Tulot,2019-02-16 10:45:31.034482752,2019-02-16,2019-02-16,2019-02-16,5.0,52.58,4441.12,0.0,506.0,           ,1.0,1.0,216.0
3962,Muut,2019-02-20 09:06:12.413793096,2019-02-20,2019-02-20,2019-02-20,5.0,-4.02,4437.1,0.0,105.0,OKOYFIHH   ,1.0,0.0,4.0
3963,Luokittelemattomat,2019-02-21 05:47:35.172413784,2019-02-21,2019-02-22,2019-02-21,5.0,-10.87,4426.23,0.0,162.0,           ,1.0,1.0,120.0
3964,Matkailu,2019-02-21 07:26:53.793103440,2019-02-21,2019-02-21,2019-02-21,5.0,-12.53,4413.7,0.0,106.0,OKOYFIHH   ,1.0,0.0,11.0
3965,Tulot,2019-02-24 04:08:16.551724128,2019-02-24,2019-02-24,2019-02-24,5.0,800.68,5214.38,0.0,506.0,           ,1.0,1.0,225.0
3966,Ruoka_paivittaistavarakauppa,2019-02-26 02:28:57.931034472,2019-02-26,2019-02-26,2019-02-26,5.0,-51.8,5162.58,0.0,162.0,           ,1.0,1.0,70.0
3967,Tulot,2019-02-27 00:49:39.310344816,2019-02-27,2019-02-27,2019-02-27,5.0,86.51,5249.09,0.0,506.0,           ,1.0,1.0,223.0
3968,Tulot,2019-03-01 03:10:41.095890408,2019-03-01,2019-03-01,2019-03-01,5.0,64.26,5313.35,0.0,506.0,           ,1.0,1.0,216.0
3969,Ravintolat_kahvilat,2019-03-01 06:47:40.273972602,2019-03-01,2019-03-01,2019-03-01,5.0,-9.32,5304.03,0.0,162.0,           ,1.0,1.0,102.0
3970,Ruoka_paivittaistavarakauppa,2019-03-01 13:35:20.547945204,2019-03-01,2019-03-01,2019-03-01,5.0,-80.85,5223.18,0.0,162.0,           ,1.0,1.0,125.0
3971,Tulot,2019-03-01 20:23:00.821917806,2019-03-01,2019-03-01,2019-03-01,5.0,61.73,5284.91,0.0,506.0,           ,1.0,1.0,221.0
3972,Luokittelemattomat,2019-03-03 09:58:21.369863010,2019-03-03,2019-03-03,2019-03-03,5.0,-3065.3,2219.61,0.0,106.0,OKOYFIHH   ,1.0,0.0,40.0
3973,Tulot,2019-03-03 13:09:02.465753418,2019-03-03,2019-03-03,2019-03-03,5.0,157.58,2377.19,0.0,506.0,           ,1.0,1.0,216.0
3974,Terveys,2019-03-04 02:44:23.013698622,2019-03-04,2019-03-04,2019-03-04,5.0,-19.79,2357.4,0.0,162.0,           ,1.0,1.0,115.0
3975,Ruoka_paivittaistavarakauppa,2019-03-04 06:21:22.191780816,2019-03-04,2019-03-06,2019-03-04,5.0,-11.54,2345.86,0.0,162.0,           ,1.0,1.0,126.0
3976,Ravintolat_kahvilat,2019-03-04 09:32:03.287671224,2019-03-04,2019-03-04,2019-03-04,5.0,-22.66,2323.2,0.0,162.0,           ,1.0,1.0,66.0
3977,Ruoka_paivittaistavarakauppa,2019-03-04 16:19:43.561643826,2019-03-04,2019-03-04,2019-03-04,5.0,-36.42,2286.78,0.0,162.0,           ,1.0,1.0,48.0
3978,Ravintolat_kahvilat,2019-03-04 16:46:01.643835612,2019-03-04,2019-03-04,2019-03-04,5.0,-19.21,2267.57,0.0,162.0,           ,1.0,1.0,153.0
3979,Ruoka_paivittaistavarakauppa,2019-03-04 19:56:42.739726020,2019-03-04,2019-03-04,2019-03-04,5.0,-20.6,2246.97,0.0,162.0,           ,1.0,1.0,185.0
3980,Tulot,2019-03-04 23:07:23.835616428,2019-03-04,2019-03-04,2019-03-04,5.0,473.59,2720.56,0.0,506.0,           ,1.0,1.0,217.0
3981,Ruoka_paivittaistavarakauppa,2019-03-04 23:33:41.917808214,2019-03-04,2019-03-04,2019-03-04,5.0,-18.93,2701.63,0.0,162.0,           ,1.0,1.0,49.0
3982,Tulot,2019-03-05 02:18:04.931506836,2019-03-05,2019-03-05,2019-03-05,5.0,314.08,3015.71,0.0,506.0,           ,1.0,1.0,226.0
3983,Terveys,2019-03-05 05:55:04.109589030,2019-03-05,2019-03-05,2019-03-05,5.0,-55.74,2959.97,0.0,106.0,SBANFIHH   ,0.0,0.0,22.0
3984,Ruoka_paivittaistavarakauppa,2019-03-05 12:42:44.383561632,2019-03-05,2019-03-05,2019-03-05,5.0,-158.64,2801.33,0.0,162.0,           ,1.0,1.0,122.0
3985,Ravintolat_kahvilat,2019-03-05 15:53:25.479452040,2019-03-05,2019-03-05,2019-03-05,5.0,-3.0,2798.33,0.0,162.0,           ,1.0,1.0,164.0
3986,Ravintolat_kahvilat,2019-03-05 19:30:24.657534234,2019-03-05,2019-03-05,2019-03-05,5.0,-10.01,2788.32,0.0,162.0,           ,1.0,1.0,153.0
3987,Kulttuuri_viihde,2019-03-06 09:05:45.205479438,2019-03-06,2019-03-06,2019-03-06,5.0,-12.98,2775.34,0.0,106.0,OKOYFIHH   ,0.0,0.0,21.0
3988,Ruoka_paivittaistavarakauppa,2019-03-06 22:41:05.753424642,2019-03-06,2019-03-08,2019-03-06,5.0,-1.32,2774.02,0.0,162.0,           ,1.0,1.0,123.0
3989,Liikkuminen,2019-03-07 05:28:46.027397244,2019-03-07,2019-03-07,2019-03-07,5.0,-4.98,2769.04,0.0,162.0,           ,1.0,1.0,174.0
3990,Muut,2019-03-07 12:16:26.301369846,2019-03-07,2019-03-07,2019-03-07,5.0,-39.38,2729.66,0.0,162.0,           ,1.0,1.0,47.0
3991,Ravintolat_kahvilat,2019-03-07 19:04:06.575342448,2019-03-07,2019-03-07,2019-03-07,5.0,-92.11,2637.55,0.0,162.0,           ,1.0,1.0,47.0
3992,Ruoka_paivittaistavarakauppa,2019-03-08 01:51:46.849315050,2019-03-08,2019-03-08,2019-03-08,5.0,-14.79,2622.76,0.0,162.0,           ,1.0,1.0,142.0
3993,Tulot,2019-03-08 08:39:27.123287652,2019-03-08,2019-03-08,2019-03-08,5.0,60.23,2682.99,0.0,506.0,           ,1.0,1.0,217.0
3994,Ruoka_paivittaistavarakauppa,2019-03-08 15:27:07.397260254,2019-03-08,2019-03-08,2019-03-08,5.0,-26.97,2656.02,0.0,162.0,           ,1.0,1.0,186.0
3995,Muut,2019-03-08 22:14:47.671232856,2019-03-08,2019-03-08,2019-03-08,5.0,-1138.56,1517.46,0.0,105.0,OKOYFIHH   ,1.0,0.0,3.0
3996,Kulttuuri_viihde,2019-03-10 05:02:27.945205458,2019-03-10,2019-03-10,2019-03-10,5.0,-144.64,1372.82,0.0,106.0,OKOYFIHH   ,0.0,0.0,33.0
3997,Tulot,2019-03-10 08:13:09.041095866,2019-03-10,2019-03-10,2019-03-10,5.0,136.65,1509.47,0.0,506.0,           ,1.0,1.0,216.0
3998,Tulot,2019-03-10 15:00:49.315068468,2019-03-10,2019-03-10,2019-03-10,5.0,39.61,1549.08,0.0,506.0,           ,1.0,1.0,217.0
3999,Tulot,2019-03-10 18:37:48.493150662,2019-03-10,2019-03-11,2019-03-10,5.0,52.48,1601.56,0.0,506.0,           ,1.0,1.0,217.0
4000,Ruoka_paivittaistavarakauppa,2019-03-11 01:25:28.767123264,2019-03-11,2019-03-11,2019-03-11,5.0,-10.2,1591.36,0.0,162.0,           ,1.0,1.0,178.0
4001,Asuminen,2019-03-11 04:09:51.780821886,2019-03-11,2019-03-11,2019-03-11,5.0,-21.34,1570.02,0.0,162.0,           ,1.0,1.0,84.0
4002,Tulot,2019-03-11 04:36:09.863013672,2019-03-11,2019-03-11,2019-03-11,5.0,44.86,1614.88,0.0,506.0,           ,1.0,1.0,216.0
4003,Ruoka_paivittaistavarakauppa,2019-03-11 11:23:50.136986274,2019-03-11,2019-03-11,2019-03-11,5.0,-8.71,1606.17,0.0,162.0,           ,1.0,1.0,111.0
4004,Tulot,2019-03-11 11:50:08.219178060,2019-03-11,2019-03-11,2019-03-11,5.0,471.5,2077.67,0.0,506.0,           ,1.0,1.0,216.0
4005,Ruoka_paivittaistavarakauppa,2019-03-11 18:11:30.410958876,2019-03-11,2019-03-11,2019-03-11,5.0,-65.51,2012.16,0.0,162.0,           ,1.0,1.0,104.0
4006,Liikkuminen,2019-03-12 00:59:10.684931478,2019-03-12,2019-03-12,2019-03-12,5.0,-25.55,1986.61,0.0,162.0,           ,1.0,1.0,115.0
4007,Hyvinvointijakauneus,2019-03-12 07:46:50.958904080,2019-03-12,2019-03-12,2019-03-12,5.0,-21.67,1964.94,0.0,162.0,           ,1.0,1.0,131.0
4008,Asuminen,2019-03-12 21:48:29.589041070,2019-03-12,2019-03-12,2019-03-12,5.0,-564.17,1400.77,0.0,106.0,OKOYFIHH   ,0.0,0.0,27.0
4009,Ruoka_paivittaistavarakauppa,2019-03-13 06:54:14.794520508,2019-03-13,2019-03-13,2019-03-13,5.0,-9.08,1391.69,0.0,162.0,           ,1.0,1.0,127.0
4010,Muut,2019-03-13 17:45:12.328767090,2019-03-13,2019-03-13,2019-03-13,5.0,-198.56,1193.13,0.0,105.0,OKOYFIHH   ,1.0,0.0,4.0
4011,Muut,2019-03-13 21:22:11.506849284,2019-03-13,2019-03-13,2019-03-13,5.0,-5.51,1187.62,0.0,105.0,OKOYFIHH   ,1.0,0.0,5.0
4012,Muut,2019-03-14 00:32:52.602739692,2019-03-14,2019-03-14,2019-03-14,5.0,-67.4,1120.22,0.0,105.0,OKOYFIHH   ,1.0,0.0,4.0
4013,Muut,2019-03-14 07:20:32.876712294,2019-03-14,2019-03-14,2019-03-14,5.0,-235.77,884.45,0.0,105.0,OKOYFIHH   ,1.0,0.0,3.0
4014,Tulot,2019-03-14 10:57:32.054794488,2019-03-14,2019-03-14,2019-03-14,5.0,27.69,912.14,0.0,506.0,           ,1.0,1.0,216.0
4015,Muut,2019-03-14 14:08:13.150684896,2019-03-14,2019-03-14,2019-03-14,5.0,-61.35,850.79,0.0,105.0,OKOYFIHH   ,1.0,0.0,6.0
4016,Tulot,2019-03-14 20:55:53.424657498,2019-03-14,2019-03-14,2019-03-14,5.0,671.01,1521.8,701.0,510.0,           ,1.0,1.0,235.0
4017,Muut,2019-03-15 03:43:33.698630100,2019-03-15,2019-03-15,2019-03-15,5.0,-221.85,1299.95,0.0,105.0,OKOYFIHH   ,1.0,0.0,3.0
4018,Tulot,2019-03-15 10:31:13.972602702,2019-03-15,2019-03-15,2019-03-15,5.0,159.0,1458.95,701.0,521.0,           ,1.0,1.0,240.0
4019,Luokittelemattomat,2019-03-15 13:41:55.068493110,2019-03-15,2019-03-15,2019-03-15,5.0,-36.07,1422.88,0.0,106.0,OKOYFIHH   ,0.0,0.0,22.0
4020,Muut,2019-03-15 14:34:31.232876682,2019-03-15,2019-03-15,2019-03-15,5.0,-105.14,1317.74,0.0,105.0,OKOYFIHH   ,1.0,0.0,7.0
4021,Ruoka_paivittaistavarakauppa,2019-03-15 17:18:54.246575304,2019-03-15,2019-03-15,2019-03-15,5.0,-48.94,1268.8,0.0,162.0,           ,1.0,1.0,185.0
4022,Luottojen_maksut,2019-03-15 20:29:35.342465712,2019-03-15,2019-03-15,2019-03-15,5.0,-10.1,1258.7,0.0,106.0,OKOYFIHH   ,0.0,0.0,17.0
4023,Muut,2019-03-16 23:40:16.438356120,2019-03-16,2019-03-16,2019-03-16,5.0,-29.35,1229.35,0.0,163.0,           ,1.0,1.0,193.0
4024,Ruoka_paivittaistavarakauppa,2019-03-18 00:06:34.520547906,2019-03-18,2019-03-18,2019-03-18,5.0,-54.1,1175.25,0.0,162.0,           ,1.0,1.0,56.0
4025,Ruoka_paivittaistavarakauppa,2019-03-18 03:17:15.616438314,2019-03-18,2019-03-18,2019-03-18,5.0,-7.32,1167.93,0.0,162.0,           ,1.0,1.0,127.0
4026,Ruoka_paivittaistavarakauppa,2019-03-18 06:27:56.712328722,2019-03-18,2019-03-18,2019-03-18,5.0,-5.88,1162.05,0.0,162.0,           ,1.0,1.0,116.0
4027,Liikkuminen,2019-03-18 10:04:55.890410916,2019-03-18,2019-03-18,2019-03-18,5.0,-128.88,1033.17,0.0,162.0,           ,1.0,1.0,79.0
4028,Liikkuminen,2019-03-18 16:52:36.164383518,2019-03-18,2019-03-18,2019-03-18,5.0,-30.72,1002.45,0.0,162.0,           ,1.0,1.0,134.0
4029,Tulot,2019-03-18 20:03:17.260273926,2019-03-18,2019-03-18,2019-03-18,5.0,16.24,1018.69,0.0,506.0,           ,1.0,1.0,226.0
4030,Muut,2019-03-19 02:50:57.534246528,2019-03-19,2019-03-19,2019-03-19,5.0,-4.89,1013.8,0.0,162.0,           ,1.0,1.0,157.0
4031,Asuminen,2019-03-19 09:38:37.808219130,2019-03-19,2019-03-19,2019-03-19,5.0,-139.69,874.11,0.0,162.0,           ,1.0,1.0,53.0
4032,Ravintolat_kahvilat,2019-03-19 12:49:18.904109538,2019-03-19,2019-03-19,2019-03-19,5.0,-3.29,870.82,0.0,162.0,           ,1.0,1.0,164.0
4033,Muut,2019-03-19 13:15:36.986301324,2019-03-19,2019-03-19,2019-03-19,5.0,-356.37,514.45,0.0,105.0,OKOYFIHH   ,1.0,0.0,4.0
4034,Ruoka_paivittaistavarakauppa,2019-03-19 16:26:18.082191732,2019-03-19,2019-03-19,2019-03-19,5.0,-13.39,501.06,0.0,162.0,           ,1.0,1.0,151.0
4035,Liikkuminen,2019-03-19 23:13:58.356164334,2019-03-19,2019-03-19,2019-03-19,5.0,-13.35,487.71,0.0,162.0,           ,1.0,1.0,124.0
4036,Muut,2019-03-20 19:36:59.178082140,2019-03-20,2019-03-22,2019-03-20,5.0,-2.42,485.29,0.0,105.0,OKOYFIHH   ,1.0,0.0,3.0
4037,Muut,2019-03-21 02:24:39.452054742,2019-03-21,2019-03-21,2019-03-21,5.0,-90.26,395.03,0.0,105.0,OKOYFIHH   ,1.0,0.0,6.0
4038,Ruoka_paivittaistavarakauppa,2019-03-21 06:01:38.630136936,2019-03-21,2019-03-21,2019-03-21,5.0,-15.69,379.34,0.0,162.0,           ,1.0,1.0,46.0
4039,Matkailu,2019-03-21 22:21:22.191780762,2019-03-21,2019-03-21,2019-03-21,5.0,-188.45,190.89,0.0,106.0,OKOYFIHH   ,0.0,0.0,10.0
4040,Muut,2019-03-22 05:35:20.547945150,2019-03-22,2019-03-22,2019-03-22,5.0,-8.21,182.68,0.0,105.0,OKOYFIHH   ,1.0,0.0,3.0
4041,Tulot,2019-03-22 09:12:19.726027344,2019-03-22,2019-03-22,2019-03-22,5.0,61.64,244.32,710.0,506.0,           ,1.0,1.0,259.0
4042,Muut,2019-03-22 12:23:00.821917752,2019-03-22,2019-03-22,2019-03-22,5.0,-21.07,223.25,0.0,105.0,OKOYFIHH   ,1.0,0.0,3.0
4043,Ravintolat_kahvilat,2019-03-22 15:59:59.999999946,2019-03-22,2019-03-22,2019-03-22,5.0,-33.37,189.88,0.0,162.0,           ,1.0,1.0,105.0
4044,Ruoka_paivittaistavarakauppa,2019-03-22 19:10:41.095890354,2019-03-22,2019-03-22,2019-03-22,5.0,-8.34,181.54,0.0,162.0,           ,1.0,1.0,115.0
4045,Tulot,2019-03-22 22:47:40.273972548,2019-03-22,2019-03-22,2019-03-22,5.0,65.17,246.71,0.0,506.0,           ,1.0,1.0,216.0
4046,Muut,2019-03-23 08:46:01.643835558,2019-03-23,2019-03-23,2019-03-23,5.0,-74.07,172.64,0.0,105.0,OKOYFIHH   ,1.0,0.0,4.0
4047,Liikkuminen,2019-03-24 11:56:42.739725966,2019-03-24,2019-03-24,2019-03-24,5.0,-80.29,92.35,0.0,106.0,OKOYFIHH   ,0.0,0.0,13.0
4048,Muut,2019-03-24 15:33:41.917808160,2019-03-24,2019-03-24,2019-03-24,5.0,-4.23,88.12,0.0,105.0,OKOYFIHH   ,1.0,0.0,3.0
4049,Muut,2019-03-24 18:44:23.013698568,2019-03-24,2019-03-24,2019-03-24,5.0,-36.55,51.57,0.0,105.0,OKOYFIHH   ,1.0,0.0,3.0
4050,Liikkuminen,2019-03-25 01:58:21.369862956,2019-03-25,2019-03-25,2019-03-25,5.0,-4.11,47.46,0.0,162.0,           ,1.0,1.0,111.0
4051,Luokittelemattomat,2019-03-25 05:09:02.465753364,2019-03-25,2019-03-25,2019-03-25,5.0,-39.46,8.0,0.0,106.0,OKOYFIHH   ,1.0,0.0,33.0
4052,Ruoka_paivittaistavarakauppa,2019-03-25 08:19:43.561643772,2019-03-25,2019-03-25,2019-03-25,5.0,-5.49,2.51,0.0,162.0,           ,1.0,1.0,79.0
4053,Ruoka_paivittaistavarakauppa,2019-03-25 15:07:23.835616374,2019-03-25,2019-03-25,2019-03-25,5.0,-17.19,-14.68,0.0,162.0,           ,1.0,1.0,128.0
4054,Ruoka_paivittaistavarakauppa,2019-03-25 21:55:04.109588976,2019-03-25,2019-03-25,2019-03-25,5.0,-1.84,-16.52,0.0,162.0,           ,1.0,1.0,131.0
4055,Muut,2019-03-26 01:32:03.287671170,2019-03-26,2019-03-26,2019-03-26,5.0,-17.51,-34.03,0.0,105.0,OKOYFIHH   ,1.0,0.0,5.0
4056,Matkailu,2019-03-26 04:42:44.383561578,2019-03-26,2019-03-26,2019-03-26,5.0,-4.39,-38.42,0.0,162.0,           ,1.0,1.0,106.0
4057,Kulttuuri_viihde,2019-03-26 11:30:24.657534180,2019-03-26,2019-03-26,2019-03-26,5.0,-1.84,-40.26,0.0,162.0,           ,1.0,1.0,153.0
4058,Ruoka_paivittaistavarakauppa,2019-03-26 18:18:04.931506782,2019-03-26,2019-03-27,2019-03-25,5.0,-15.33,-55.59,0.0,162.0,           ,1.0,1.0,66.0
4059,Hyvinvointijakauneus,2019-03-27 04:16:26.301369792,2019-03-27,2019-03-27,2019-03-27,5.0,-6.33,-61.92,0.0,106.0,OKOYFIHH   ,0.0,0.0,20.0
4060,Liikkuminen,2019-03-27 21:28:46.027397190,2019-03-27,2019-03-27,2019-03-27,5.0,-26.24,-88.16,0.0,106.0,OKOYFIHH   ,1.0,0.0,34.0
4061,Muut,2019-03-28 01:05:45.205479384,2019-03-28,2019-03-29,2019-03-28,5.0,-4.47,-92.63,0.0,105.0,OKOYFIHH   ,1.0,0.0,8.0
4062,Luokittelemattomat,2019-03-28 07:53:25.479451986,2019-03-28,2019-03-28,2019-03-28,5.0,-1.97,-94.6,0.0,106.0,NDEAFIHH   ,0.0,0.0,11.0
4063,Muut,2019-03-28 11:04:06.575342394,2019-03-28,2019-03-28,2019-03-28,5.0,-4.37,-98.97,0.0,105.0,OKOYFIHH   ,1.0,0.0,8.0
4064,Terveys,2019-03-28 17:25:28.767123210,2019-03-28,2019-03-28,2019-03-28,5.0,47.12,-51.85,0.0,574.0,           ,1.0,1.0,228.0
4065,Ruoka_paivittaistavarakauppa,2019-03-28 21:02:27.945205404,2019-03-28,2019-03-28,2019-03-28,5.0,-0.56,-52.41,0.0,162.0,           ,1.0,1.0,174.0
4066,Luokittelemattomat,2019-03-29 00:39:27.123287598,2019-03-29,2019-03-29,2019-03-29,5.0,-1.08,-53.49,0.0,162.0,           ,1.0,1.0,131.0
4067,Ruoka_paivittaistavarakauppa,2019-03-29 03:50:08.219178006,2019-03-29,2019-03-29,2019-03-29,5.0,-0.96,-54.45,0.0,162.0,           ,1.0,1.0,82.0
4068,Muut,2019-03-29 07:00:49.315068414,2019-03-29,2019-03-29,2019-03-29,5.0,-3.77,-58.22,0.0,162.0,           ,1.0,1.0,108.0
4069,Saastot_sijoitukset,2019-03-29 07:27:07.397260200,2019-03-29,2019-03-29,2019-03-29,5.0,-27.39,-85.61,0.0,162.0,           ,1.0,1.0,128.0
4070,Ruoka_paivittaistavarakauppa,2019-03-29 10:37:48.493150608,2019-03-29,2019-03-29,2019-03-29,5.0,-2.25,-87.86,0.0,162.0,           ,1.0,1.0,144.0
4071,Asuminen,2019-03-29 13:48:29.589041016,2019-03-29,2019-03-29,2019-03-29,5.0,-3.25,-91.11,0.0,162.0,           ,1.0,1.0,47.0
4072,Lemmikit,2019-03-29 14:14:47.671232802,2019-03-29,2019-03-29,2019-03-29,5.0,-6.25,-97.36,0.0,162.0,           ,1.0,1.0,168.0
4073,Shoppailu,2019-03-29 14:41:05.753424588,2019-03-29,2019-03-29,2019-03-29,5.0,-29.66,-127.02,0.0,106.0,OKOYFIHH   ,0.0,0.0,42.0
4074,Lemmikit,2019-03-29 17:51:46.849314996,2019-03-29,2019-03-29,2019-03-29,5.0,-14.14,-141.16,0.0,162.0,           ,1.0,1.0,109.0
4075,Tulot,2019-03-31 00:13:09.041095812,2019-03-31,2019-03-31,2019-03-31,5.0,26.74,-114.42,0.0,505.0,           ,1.0,1.0,209.0
4076,Tulot,2019-03-31 20:36:09.863013618,2019-03-31,2019-04-01,2019-03-31,5.0,62.48,-51.94,0.0,506.0,           ,1.0,1.0,220.0
4077,Tulot,2019-04-01 12:44:36.106194690,2019-04-01,2019-04-01,2019-04-01,5.0,14.67,-37.27,0.0,551.0,           ,1.0,1.0,227.0
4078,Tulot,2019-04-02 01:29:12.212389380,2019-04-02,2019-04-02,2019-04-02,5.0,235.78,198.51,0.0,505.0,           ,1.0,1.0,208.0
4079,Muut,2019-04-02 14:13:48.318584070,2019-04-02,2019-04-02,2019-04-02,5.0,-76.98,121.53,0.0,105.0,OKOYFIHH   ,1.0,0.0,3.0
4080,Muut,2019-04-03 02:58:24.424778760,2019-04-03,2019-04-03,2019-04-03,5.0,-96.85,24.68,0.0,105.0,OKOYFIHH   ,1.0,0.0,3.0
4081,Ruoka_paivittaistavarakauppa,2019-04-03 15:43:00.530973450,2019-04-03,2019-04-03,2019-04-03,5.0,-15.72,8.96,0.0,162.0,           ,1.0,1.0,84.0
4082,Tulot,2019-04-03 17:12:12.743362830,2019-04-03,2019-04-03,2019-04-03,5.0,125.91,134.87,0.0,505.0,           ,1.0,1.0,209.0
4083,Liikkuminen,2019-04-04 04:27:36.637168140,2019-04-04,2019-04-04,2019-04-04,5.0,-128.54,6.33,0.0,106.0,OKOYFIHH   ,1.0,0.0,27.0
4084,Muut,2019-04-05 05:56:48.849557520,2019-04-05,2019-04-05,2019-04-05,5.0,-5.69,0.64,0.0,105.0,OKOYFIHH   ,1.0,0.0,3.0
4085,Asuminen,2019-04-05 18:41:24.955752210,2019-04-05,2019-04-05,2019-04-05,5.0,-38.92,-38.28,0.0,106.0,OKOYFIHH   ,0.0,0.0,12.0
4086,Ravintolat_kahvilat,2019-04-07 07:26:01.061946900,2019-04-07,2019-04-07,2019-04-07,5.0,-6.68,-44.96,0.0,106.0,NDEAFIHH   ,0.0,0.0,28.0
4087,Muut,2019-04-07 20:10:37.168141590,2019-04-07,2019-04-09,2019-04-07,5.0,-5.66,-50.62,0.0,106.0,OKOYFIHH   ,0.0,0.0,31.0
4088,Luokittelemattomat,2019-04-07 21:39:49.380530970,2019-04-07,2019-04-07,2019-04-07,5.0,-0.81,-51.43,0.0,106.0,NDEAFIHH   ,0.0,0.0,38.0
4089,Luokittelemattomat,2019-04-08 08:55:13.274336280,2019-04-08,2019-04-08,2019-04-08,5.0,-14.3,-65.73,0.0,106.0,OKOYFIHH   ,1.0,0.0,37.0
4090,Lemmikit,2019-04-08 10:24:25.486725660,2019-04-08,2019-04-08,2019-04-08,5.0,-15.66,-81.39,0.0,162.0,           ,1.0,1.0,97.0
4091,Ruoka_paivittaistavarakauppa,2019-04-08 23:09:01.592920350,2019-04-08,2019-04-08,2019-04-08,5.0,-1.66,-83.05,0.0,162.0,           ,1.0,1.0,158.0
4092,Ruoka_paivittaistavarakauppa,2019-04-09 11:53:37.699115040,2019-04-09,2019-04-09,2019-04-09,5.0,-2.95,-86.0,0.0,162.0,           ,1.0,1.0,115.0
4093,Ruoka_paivittaistavarakauppa,2019-04-10 00:38:13.805309730,2019-04-10,2019-04-10,2019-04-10,5.0,-1.56,-87.56,0.0,162.0,           ,1.0,1.0,97.0
4094,Saastot_sijoitukset,2019-04-10 13:22:49.911504420,2019-04-10,2019-04-10,2019-04-10,5.0,-12.23,-99.79,0.0,162.0,           ,1.0,1.0,141.0
4095,Ruoka_paivittaistavarakauppa,2019-04-11 02:07:26.017699110,2019-04-11,2019-04-11,2019-04-11,5.0,-3.61,-103.4,0.0,162.0,           ,1.0,1.0,84.0
4096,Ruoka_paivittaistavarakauppa,2019-04-11 14:52:02.123893800,2019-04-11,2019-04-11,2019-04-11,5.0,-7.92,-111.32,0.0,162.0,           ,1.0,1.0,47.0
4097,Ruoka_paivittaistavarakauppa,2019-04-12 03:36:38.230088490,2019-04-12,2019-04-12,2019-04-12,5.0,-20.15,-131.47,0.0,162.0,           ,1.0,1.0,155.0
4098,Muut,2019-04-12 05:05:50.442477870,2019-04-12,2019-04-12,2019-04-12,5.0,-41.88,-173.35,0.0,163.0,           ,1.0,1.0,193.0
4099,Tulot,2019-04-12 16:21:14.336283180,2019-04-12,2019-04-12,2019-04-12,5.0,112.74,-60.61,0.0,506.0,           ,1.0,1.0,216.0
4100,Ruoka_paivittaistavarakauppa,2019-04-12 17:50:26.548672560,2019-04-12,2019-04-12,2019-04-12,5.0,-9.97,-70.58,0.0,162.0,           ,1.0,1.0,74.0
4101,Ruoka_paivittaistavarakauppa,2019-04-15 06:35:02.654867250,2019-04-15,2019-04-15,2019-04-15,5.0,-20.49,-91.07,0.0,162.0,           ,1.0,1.0,191.0
4102,Ruoka_paivittaistavarakauppa,2019-04-15 08:04:14.867256630,2019-04-15,2019-04-15,2019-04-15,5.0,-10.0,-101.07,0.0,162.0,           ,1.0,1.0,46.0
4103,Ruoka_paivittaistavarakauppa,2019-04-15 19:19:38.761061940,2019-04-15,2019-04-15,2019-04-15,5.0,-9.16,-110.23,0.0,162.0,           ,1.0,1.0,97.0
4104,Ruoka_paivittaistavarakauppa,2019-04-15 20:48:50.973451320,2019-04-15,2019-04-15,2019-04-15,5.0,-3.17,-113.4,0.0,162.0,           ,1.0,1.0,74.0
4105,Ruoka_paivittaistavarakauppa,2019-04-16 09:33:27.079646010,2019-04-16,2019-04-16,2019-04-16,5.0,-4.55,-117.95,0.0,162.0,           ,1.0,1.0,174.0
4106,Luottojen_maksut,2019-04-16 22:18:03.185840700,2019-04-16,2019-04-17,2019-04-16,5.0,-5.07,-123.02,0.0,162.0,           ,1.0,1.0,121.0
4107,Ruoka_paivittaistavarakauppa,2019-04-16 23:47:15.398230080,2019-04-16,2019-04-16,2019-04-16,5.0,-8.15,-131.17,0.0,162.0,           ,1.0,1.0,162.0
4108,Lemmikit,2019-04-17 11:02:39.292035390,2019-04-17,2019-04-17,2019-04-17,5.0,-12.4,-143.57,0.0,162.0,           ,1.0,1.0,179.0
4109,Ruoka_paivittaistavarakauppa,2019-04-18 12:31:51.504424770,2019-04-18,2019-04-18,2019-04-18,5.0,-11.26,-154.83,0.0,162.0,           ,1.0,1.0,188.0
4110,Ruoka_paivittaistavarakauppa,2019-04-19 01:16:27.610619460,2019-04-19,2019-04-19,2019-04-19,5.0,-3.16,-157.99,0.0,162.0,           ,1.0,1.0,174.0
4111,Ruoka_paivittaistavarakauppa,2019-04-19 02:45:39.823008840,2019-04-19,2019-04-19,2019-04-19,5.0,-1.99,-159.98,0.0,162.0,           ,1.0,1.0,176.0
4112,Ruoka_paivittaistavarakauppa,2019-04-19 14:01:03.716814150,2019-04-19,2019-04-19,2019-04-19,5.0,-11.43,-171.41,0.0,162.0,           ,1.0,1.0,131.0
4113,Tulot,2019-04-20 15:30:15.929203530,2019-04-20,2019-04-20,2019-04-20,5.0,23.91,-147.5,0.0,506.0,           ,1.0,1.0,216.0
4114,Ravintolat_kahvilat,2019-04-20 16:59:28.141592910,2019-04-20,2019-04-20,2019-04-20,5.0,-15.47,-162.97,0.0,106.0,DABAFIHH   ,0.0,0.0,10.0
4115,Muut,2019-04-22 04:14:52.035398220,2019-04-22,2019-04-22,2019-04-23,5.0,-10.96,-173.93,0.0,105.0,OKOYFIHH   ,1.0,0.0,4.0
4116,Luokittelemattomat,2019-04-22 05:44:04.247787600,2019-04-22,2019-04-25,2019-04-22,5.0,-36.96,-210.89,0.0,106.0,OKOYFIHH   ,1.0,0.0,33.0
4117,Tulot,2019-04-22 18:28:40.353982290,2019-04-22,2019-04-22,2019-04-22,5.0,168.28,-42.61,0.0,505.0,           ,1.0,1.0,208.0
4118,Luottojen_maksut,2019-04-23 07:13:16.460176980,2019-04-23,2019-04-23,2019-04-23,5.0,-14.56,-57.17,0.0,106.0,OKOYFIHH   ,1.0,0.0,15.0
4119,Lemmikit,2019-04-23 19:57:52.566371670,2019-04-23,2019-04-23,2019-04-23,5.0,-12.25,-69.42,0.0,106.0,OKOYFIHH   ,0.0,0.0,33.0
4120,Muut,2019-04-24 21:27:04.778761050,2019-04-24,2019-04-24,2019-04-24,5.0,-12.11,-81.53,0.0,105.0,OKOYFIHH   ,1.0,0.0,3.0
4121,Ruoka_paivittaistavarakauppa,2019-04-25 11:40:53.097345120,2019-04-25,2019-04-25,2019-04-25,5.0,-12.36,-93.89,0.0,162.0,           ,1.0,1.0,122.0
4122,Saastot_sijoitukset,2019-04-26 08:42:28.672566360,2019-04-26,2019-04-26,2019-04-26,5.0,-38.3,-132.19,0.0,106.0,NDEAFIHH   ,0.0,0.0,15.0
4123,Ruoka_paivittaistavarakauppa,2019-04-26 10:11:40.884955740,2019-04-26,2019-04-26,2019-04-26,5.0,-3.62,-135.81,0.0,162.0,           ,1.0,1.0,68.0
4124,Ruoka_paivittaistavarakauppa,2019-04-26 22:56:16.991150430,2019-04-26,2019-04-26,2019-04-26,5.0,-0.98,-136.79,0.0,162.0,           ,1.0,1.0,117.0
4125,Luottojen_maksut,2019-04-28 16:08:29.734513260,2019-04-28,2019-04-28,2019-04-28,5.0,-88.78,-225.57,0.0,106.0,NDEAFIHH   ,0.0,0.0,38.0
4126,Liikkuminen,2019-04-29 00:25:29.203539810,2019-04-29,2019-04-29,2019-04-29,5.0,-5.6,-231.17,0.0,162.0,           ,1.0,1.0,174.0
4127,Lemmikit,2019-04-29 01:54:41.415929190,2019-04-29,2019-04-29,2019-05-03,5.0,-3.07,-234.24,0.0,162.0,           ,1.0,1.0,93.0
4128,Kulttuuri_viihde,2019-04-29 03:23:53.628318570,2019-04-29,2019-04-29,2019-04-29,5.0,-9.65,-243.89,0.0,162.0,           ,1.0,1.0,150.0
4129,Ruoka_paivittaistavarakauppa,2019-04-29 13:10:05.309734500,2019-04-29,2019-04-29,2019-04-29,5.0,-2.7,-246.59,0.0,162.0,           ,1.0,1.0,162.0
4130,Ruoka_paivittaistavarakauppa,2019-04-29 14:39:17.522123880,2019-04-29,2019-04-29,2019-04-29,5.0,-1.66,-248.25,0.0,162.0,           ,1.0,1.0,52.0
4131,Matkailu,2019-04-30 04:53:05.840707950,2019-04-30,2019-05-02,2019-04-30,5.0,-10.2,-258.45,0.0,106.0,OKOYFIHH   ,0.0,0.0,27.0
4132,Muut,2019-04-30 17:37:41.946902640,2019-04-30,2019-04-30,2019-04-30,5.0,-5.01,-263.46,0.0,105.0,OKOYFIHH   ,1.0,0.0,4.0
4133,Ruoka_paivittaistavarakauppa,2019-05-01 14:26:47.766990291,2019-05-01,2019-05-01,2019-05-01,5.0,-3.04,-266.5,0.0,162.0,           ,1.0,1.0,189.0
4134,Muut,2019-05-02 04:53:35.533980582,2019-05-02,2019-05-02,2019-05-02,5.0,-18.99,-285.49,0.0,163.0,           ,1.0,1.0,193.0
4135,Matkailu,2019-05-02 19:20:23.300970873,2019-05-02,2019-05-02,2019-05-02,5.0,-8.18,-293.67,706.0,105.0,OKOYFIHH   ,1.0,0.0,243.0
4136,Tulot,2019-05-03 00:13:58.834951455,2019-05-03,2019-05-03,2019-05-03,5.0,925.6,631.93,701.0,524.0,           ,1.0,1.0,241.0
4137,Muut,2019-05-03 09:47:11.067961164,2019-05-03,2019-05-03,2019-05-03,5.0,-326.33,305.6,0.0,105.0,OKOYFIHH   ,1.0,0.0,6.0
4138,Muut,2019-05-04 14:40:46.601941746,2019-05-04,2019-05-04,2019-05-04,5.0,-60.16,245.44,0.0,163.0,           ,1.0,1.0,197.0
4139,Ruoka_paivittaistavarakauppa,2019-05-06 05:07:34.368932037,2019-05-06,2019-05-06,2019-05-03,5.0,-23.55,221.89,0.0,162.0,           ,1.0,1.0,190.0
4140,Matkailu,2019-05-06 10:01:09.902912619,2019-05-06,2019-05-06,2019-05-06,5.0,-15.81,206.08,0.0,162.0,           ,1.0,1.0,162.0
4141,Ruoka_paivittaistavarakauppa,2019-05-07 00:27:57.669902910,2019-05-07,2019-05-07,2019-05-07,5.0,-5.94,200.14,0.0,162.0,           ,1.0,1.0,48.0
4142,Ruoka_paivittaistavarakauppa,2019-05-07 14:54:45.436893201,2019-05-07,2019-05-07,2019-05-07,5.0,-57.42,142.72,0.0,162.0,           ,1.0,1.0,144.0
4143,Ruoka_paivittaistavarakauppa,2019-05-07 19:34:22.135922328,2019-05-07,2019-05-09,2019-05-07,5.0,-9.8,132.92,0.0,162.0,           ,1.0,1.0,174.0
4144,Luokittelemattomat,2019-05-09 00:41:56.504854365,2019-05-09,2019-05-09,2019-05-09,5.0,-5.96,126.96,0.0,106.0,ITELFIHH   ,0.0,0.0,24.0
4145,Ruoka_paivittaistavarakauppa,2019-05-09 05:21:33.203883492,2019-05-09,2019-05-09,2019-05-09,5.0,-11.29,115.67,0.0,162.0,           ,1.0,1.0,111.0
4146,Terveys,2019-05-09 10:15:08.737864074,2019-05-09,2019-05-09,2019-05-09,5.0,-46.64,69.03,0.0,162.0,           ,1.0,1.0,107.0
4147,Ravintolat_kahvilat,2019-05-09 19:48:20.970873783,2019-05-09,2019-05-09,2019-05-09,5.0,-1.33,67.7,0.0,162.0,           ,1.0,1.0,168.0
4148,Hyvinvointijakauneus,2019-05-10 05:35:32.038834947,2019-05-10,2019-05-10,2019-05-10,5.0,-1.7,66.0,0.0,162.0,           ,1.0,1.0,116.0
4149,Ravintolat_kahvilat,2019-05-10 15:08:44.271844656,2019-05-10,2019-05-10,2019-05-10,5.0,-12.7,53.3,0.0,162.0,           ,1.0,1.0,117.0
4150,Ravintolat_kahvilat,2019-05-13 00:55:55.339805820,2019-05-13,2019-05-13,2019-05-13,5.0,-5.12,48.18,0.0,162.0,           ,1.0,1.0,46.0
4151,Ruoka_paivittaistavarakauppa,2019-05-13 05:49:30.873786402,2019-05-13,2019-05-13,2019-05-13,5.0,-14.44,33.74,0.0,162.0,           ,1.0,1.0,167.0
4152,Ruoka_paivittaistavarakauppa,2019-05-13 10:29:07.572815529,2019-05-13,2019-05-13,2019-05-13,5.0,-16.68,17.06,0.0,162.0,           ,1.0,1.0,79.0
4153,Ruoka_paivittaistavarakauppa,2019-05-13 15:22:43.106796111,2019-05-13,2019-05-13,2019-05-13,5.0,-6.3,10.76,0.0,162.0,           ,1.0,1.0,169.0
4154,Hyvinvointijakauneus,2019-05-13 20:02:19.805825238,2019-05-13,2019-05-13,2019-05-13,5.0,-2.46,8.3,0.0,162.0,           ,1.0,1.0,65.0
4155,Muut,2019-05-13 20:16:18.640776693,2019-05-13,2019-05-13,2019-05-13,5.0,-21.28,-12.98,0.0,163.0,           ,1.0,1.0,193.0
4156,Muut,2019-05-15 10:43:06.407766984,2019-05-15,2019-05-15,2019-05-15,5.0,-12.05,-25.03,0.0,163.0,           ,1.0,1.0,193.0
4157,Muut,2019-05-16 01:09:54.174757275,2019-05-16,2019-05-16,2019-05-16,5.0,-13.07,-38.1,0.0,106.0,DABAFIHH   ,0.0,0.0,9.0
4158,Ravintolat_kahvilat,2019-05-16 15:36:41.941747566,2019-05-16,2019-05-16,2019-05-16,5.0,-0.21,-38.31,0.0,162.0,           ,1.0,1.0,120.0
4159,Muut,2019-05-17 01:23:53.009708730,2019-05-17,2019-05-17,2019-05-17,5.0,-11.49,-49.8,0.0,106.0,OKOYFIHH   ,0.0,0.0,23.0
4160,Ruoka_paivittaistavarakauppa,2019-05-17 06:03:29.708737857,2019-05-17,2019-05-17,2019-05-17,5.0,-4.97,-54.77,0.0,162.0,           ,1.0,1.0,97.0
4161,Ruoka_paivittaistavarakauppa,2019-05-17 10:57:05.242718439,2019-05-17,2019-05-17,2019-05-17,5.0,-19.47,-74.24,0.0,162.0,           ,1.0,1.0,97.0
4162,Ruoka_paivittaistavarakauppa,2019-05-17 20:30:17.475728148,2019-05-17,2019-05-17,2019-05-17,5.0,-4.3,-78.54,0.0,162.0,           ,1.0,1.0,145.0
4163,Lemmikit,2019-05-18 15:50:40.776699021,2019-05-18,2019-05-18,2019-05-18,5.0,-10.43,-88.97,0.0,106.0,OKOYFIHH   ,1.0,0.0,25.0
4164,Hyvinvointijakauneus,2019-05-20 06:17:28.543689312,2019-05-20,2019-05-21,2019-05-20,5.0,-0.65,-89.62,0.0,162.0,           ,1.0,1.0,135.0
4165,Luottojen_maksut,2019-05-20 11:11:04.077669894,2019-05-20,2019-05-20,2019-05-20,5.0,-9.43,-99.05,0.0,162.0,           ,1.0,1.0,74.0
4166,Lapset,2019-05-20 20:44:16.310679603,2019-05-20,2019-05-20,2019-05-20,5.0,-4.09,-103.14,0.0,162.0,           ,1.0,1.0,176.0
4167,Ravintolat_kahvilat,2019-05-22 16:04:39.611650476,2019-05-22,2019-05-22,2019-05-22,5.0,-5.12,-108.26,0.0,162.0,           ,1.0,1.0,191.0
4168,Ruoka_paivittaistavarakauppa,2019-05-23 01:37:51.844660185,2019-05-23,2019-05-23,2019-05-23,5.0,-4.84,-113.1,0.0,162.0,           ,1.0,1.0,104.0
4169,Ruoka_paivittaistavarakauppa,2019-05-23 06:31:27.378640767,2019-05-23,2019-05-23,2019-05-23,5.0,-7.09,-120.19,0.0,162.0,           ,1.0,1.0,191.0
4170,Matkailu,2019-05-23 20:58:15.145631058,2019-05-23,2019-05-23,2019-05-23,5.0,-14.77,-134.96,0.0,106.0,NDEAFIHH   ,0.0,0.0,20.0
4171,Luottojen_maksut,2019-05-24 01:51:50.679611640,2019-05-24,2019-05-24,2019-05-24,5.0,-2.99,-137.95,0.0,106.0,NDEAFIHH   ,0.0,0.0,10.0
4172,Muut,2019-05-24 11:25:02.912621349,2019-05-24,2019-05-24,2019-05-24,5.0,-25.31,-163.26,0.0,106.0,OKOYFIHH   ,0.0,0.0,43.0
4173,Luottojen_maksut,2019-05-24 16:18:38.446601931,2019-05-24,2019-05-24,2019-05-24,5.0,-5.83,-169.09,0.0,106.0,OKOYFIHH   ,0.0,0.0,36.0
4174,Hyvinvointijakauneus,2019-05-26 06:45:26.213592222,2019-05-26,2019-05-26,2019-05-26,5.0,-7.31,-176.4,0.0,106.0,OKOYFIHH   ,0.0,0.0,11.0
4175,Ruoka_paivittaistavarakauppa,2019-05-27 02:05:49.514563095,2019-05-27,2019-05-28,2019-05-27,5.0,-0.82,-177.22,0.0,162.0,           ,1.0,1.0,156.0
4176,Ravintolat_kahvilat,2019-05-27 06:59:25.048543677,2019-05-27,2019-05-27,2019-05-27,5.0,-1.98,-179.2,0.0,162.0,           ,1.0,1.0,169.0
4177,Ruoka_paivittaistavarakauppa,2019-05-27 11:39:01.747572804,2019-05-27,2019-05-27,2019-05-27,5.0,-14.35,-193.55,0.0,162.0,           ,1.0,1.0,148.0
4178,Ruoka_paivittaistavarakauppa,2019-05-27 16:32:37.281553386,2019-05-27,2019-05-27,2019-05-27,5.0,-3.55,-197.1,0.0,162.0,           ,1.0,1.0,105.0
4179,Tulot,2019-05-27 21:12:13.980582513,2019-05-27,2019-05-27,2019-05-27,5.0,109.95,-87.15,710.0,588.0,           ,0.0,1.0,267.0
4180,Ruoka_paivittaistavarakauppa,2019-05-29 21:26:12.815533968,2019-05-29,2019-05-29,2019-05-29,5.0,-9.04,-96.19,0.0,162.0,           ,1.0,1.0,132.0
4181,Ravintolat_kahvilat,2019-05-30 11:53:00.582524259,2019-05-30,2019-05-30,2019-05-30,5.0,-7.32,-103.51,0.0,162.0,           ,1.0,1.0,131.0
4182,Ruoka_paivittaistavarakauppa,2019-05-31 02:19:48.349514550,2019-05-31,2019-05-31,2019-05-31,5.0,-4.23,-107.74,0.0,162.0,           ,1.0,1.0,161.0
4183,Lapset,2019-05-31 16:46:36.116504841,2019-05-31,2019-05-31,2019-05-31,5.0,-19.67,-127.41,0.0,106.0,OKOYFIHH   ,0.0,0.0,17.0
4184,Vakuutukset,2019-06-02 13:27:28.598130841,2019-06-02,2019-06-02,2019-06-02,5.0,-2.01,-129.42,0.0,106.0,OKOYFIHH   ,0.0,0.0,18.0
4185,Liikkuminen,2019-06-03 02:54:57.196261682,2019-06-03,2019-06-05,2019-06-03,5.0,-6.09,-135.51,0.0,162.0,           ,1.0,1.0,142.0
4186,Ruoka_paivittaistavarakauppa,2019-06-03 05:49:54.392523364,2019-06-03,2019-06-03,2019-06-03,5.0,-6.94,-142.45,0.0,162.0,           ,1.0,1.0,131.0
4187,Muut,2019-06-03 16:22:25.794392523,2019-06-03,2019-06-03,2019-06-03,5.0,-0.42,-142.87,0.0,162.0,           ,1.0,1.0,185.0
4188,Vakuutukset,2019-06-03 19:17:22.990654205,2019-06-03,2019-06-03,2019-06-03,5.0,-8.71,-151.58,0.0,106.0,OKOYFIHH   ,0.0,0.0,32.0
4189,Matkailu,2019-06-04 08:44:51.588785046,2019-06-04,2019-06-04,2019-06-04,5.0,-7.9,-159.48,0.0,170.0,           ,1.0,1.0,201.0
4190,Ruoka_paivittaistavarakauppa,2019-06-04 14:34:45.981308410,2019-06-04,2019-06-05,2019-06-04,5.0,-40.86,-200.34,0.0,162.0,           ,1.0,1.0,120.0
4191,Ruoka_paivittaistavarakauppa,2019-06-04 22:12:20.186915887,2019-06-04,2019-06-04,2019-06-04,5.0,-21.55,-221.89,0.0,162.0,           ,1.0,1.0,79.0
4192,Ruoka_paivittaistavarakauppa,2019-06-05 01:07:17.383177569,2019-06-05,2019-06-05,2019-06-05,5.0,-4.23,-226.12,0.0,162.0,           ,1.0,1.0,65.0
4193,Ruoka_paivittaistavarakauppa,2019-06-06 11:39:48.785046728,2019-06-06,2019-06-06,2019-06-06,5.0,-21.19,-247.31,0.0,162.0,           ,1.0,1.0,81.0
4194,Ruoka_paivittaistavarakauppa,2019-06-07 04:02:14.579439251,2019-06-07,2019-06-07,2019-06-07,5.0,-8.85,-256.16,0.0,162.0,           ,1.0,1.0,174.0
4195,Liikkuminen,2019-06-07 06:57:11.775700933,2019-06-07,2019-06-07,2019-06-07,5.0,-2.99,-259.15,0.0,162.0,           ,1.0,1.0,48.0
4196,Ruoka_paivittaistavarakauppa,2019-06-07 17:29:43.177570092,2019-06-07,2019-06-07,2019-06-07,5.0,-2.73,-261.88,0.0,162.0,           ,1.0,1.0,119.0
4197,Asuminen,2019-06-08 09:52:08.971962615,2019-06-08,2019-06-08,2019-06-08,5.0,-25.76,-287.64,0.0,106.0,OKOYFIHH   ,0.0,0.0,16.0
4198,Asuminen,2019-06-10 02:14:34.766355138,2019-06-10,2019-06-11,2019-06-10,5.0,-25.7,-313.34,0.0,106.0,OKOYFIHH   ,0.0,0.0,23.0
4199,Ravintolat_kahvilat,2019-06-10 05:09:31.962616820,2019-06-10,2019-06-10,2019-06-10,5.0,-12.31,-325.65,0.0,162.0,           ,1.0,1.0,107.0
4200,Liikkuminen,2019-06-10 12:47:06.168224297,2019-06-10,2019-06-10,2019-06-10,5.0,-3.93,-329.58,0.0,106.0,NDEAFIHH   ,0.0,0.0,20.0
4201,Tulot,2019-06-10 20:24:40.373831774,2019-06-10,2019-06-10,2019-06-10,5.0,1105.8,776.22,710.0,588.0,           ,0.0,1.0,267.0
4202,Muut,2019-06-10 23:19:37.570093456,2019-06-10,2019-06-10,2019-06-10,5.0,-7.55,768.67,0.0,162.0,           ,1.0,1.0,162.0
4203,Ravintolat_kahvilat,2019-06-11 15:42:03.364485979,2019-06-11,2019-06-11,2019-06-11,5.0,-2.55,766.12,0.0,162.0,           ,1.0,1.0,46.0
4204,Ravintolat_kahvilat,2019-06-11 18:37:00.560747661,2019-06-11,2019-06-11,2019-06-11,5.0,-71.53,694.59,0.0,162.0,           ,1.0,1.0,164.0
4205,Ruoka_paivittaistavarakauppa,2019-06-12 08:04:29.158878502,2019-06-12,2019-06-12,2019-06-12,5.0,-10.27,684.32,0.0,162.0,           ,1.0,1.0,150.0
4206,Hyvinvointijakauneus,2019-06-13 10:59:26.355140184,2019-06-13,2019-06-13,2019-06-13,5.0,-12.15,672.17,0.0,162.0,           ,1.0,1.0,140.0
4207,Muut,2019-06-13 21:31:57.757009343,2019-06-13,2019-06-13,2019-06-13,5.0,-147.27,524.9,0.0,162.0,           ,1.0,1.0,178.0
4208,Asuminen,2019-06-14 13:54:23.551401866,2019-06-14,2019-06-14,2019-06-14,5.0,-83.06,441.84,0.0,106.0,OKOYFIHH   ,0.0,0.0,9.0
4209,Kulttuuri_viihde,2019-06-15 00:26:54.953271025,2019-06-15,2019-06-15,2019-06-15,5.0,-6.94,434.9,0.0,106.0,OKOYFIHH   ,0.0,0.0,11.0
4210,Ruoka_paivittaistavarakauppa,2019-06-17 03:21:52.149532707,2019-06-17,2019-06-17,2019-06-17,5.0,-14.43,420.47,0.0,162.0,           ,1.0,1.0,139.0
4211,Liikkuminen,2019-06-17 06:16:49.345794389,2019-06-17,2019-06-17,2019-06-17,5.0,-19.54,400.93,0.0,162.0,           ,1.0,1.0,51.0
4212,Ruoka_paivittaistavarakauppa,2019-06-17 16:49:20.747663548,2019-06-17,2019-06-17,2019-06-17,5.0,-84.67,316.26,0.0,162.0,           ,1.0,1.0,58.0
4213,Ruoka_paivittaistavarakauppa,2019-06-17 19:44:17.943925230,2019-06-17,2019-06-18,2019-06-17,5.0,-14.11,302.15,0.0,162.0,           ,1.0,1.0,140.0
4214,Liikkuminen,2019-06-18 09:11:46.542056071,2019-06-18,2019-06-18,2019-06-18,5.0,-5.36,296.79,0.0,162.0,           ,1.0,1.0,130.0
4215,Ravintolat_kahvilat,2019-06-18 22:39:15.140186912,2019-06-18,2019-06-18,2019-06-18,5.0,-5.5,291.29,0.0,162.0,           ,1.0,1.0,107.0
4216,Ravintolat_kahvilat,2019-06-19 12:06:43.738317753,2019-06-19,2019-06-19,2019-06-19,5.0,-10.18,281.11,0.0,162.0,           ,1.0,1.0,142.0
4217,Ravintolat_kahvilat,2019-06-20 01:34:12.336448594,2019-06-20,2019-06-20,2019-06-20,5.0,-3.28,277.83,0.0,162.0,           ,1.0,1.0,48.0
4218,Ravintolat_kahvilat,2019-06-20 04:29:09.532710276,2019-06-20,2019-06-20,2019-06-20,5.0,-3.33,274.5,0.0,162.0,           ,1.0,1.0,128.0
4219,Ruoka_paivittaistavarakauppa,2019-06-20 15:01:40.934579435,2019-06-20,2019-06-21,2019-06-20,5.0,-105.74,168.76,0.0,162.0,           ,1.0,1.0,125.0
4220,Ruoka_paivittaistavarakauppa,2019-06-20 17:56:38.130841117,2019-06-20,2019-06-20,2019-06-20,5.0,-8.51,160.25,0.0,162.0,           ,1.0,1.0,66.0
4221,Ruoka_paivittaistavarakauppa,2019-06-21 07:24:06.728971958,2019-06-21,2019-06-21,2019-06-21,5.0,-12.32,147.93,0.0,162.0,           ,1.0,1.0,66.0
4222,Luokittelemattomat,2019-06-21 10:19:03.925233640,2019-06-21,2019-06-21,2019-06-21,5.0,-32.39,115.54,0.0,162.0,           ,1.0,1.0,66.0
4223,Matkailu,2019-06-22 23:46:32.523364481,2019-06-22,2019-06-22,2019-06-22,5.0,-13.2,102.34,0.0,106.0,DABAFIHH   ,0.0,0.0,33.0
4224,Hyvinvointijakauneus,2019-06-24 02:41:29.719626163,2019-06-24,2019-06-24,2019-06-24,5.0,-11.34,91.0,0.0,162.0,           ,1.0,1.0,115.0
4225,Ruoka_paivittaistavarakauppa,2019-06-24 13:14:01.121495322,2019-06-24,2019-06-25,2019-06-24,5.0,-35.03,55.97,0.0,162.0,           ,1.0,1.0,79.0
4226,Kulttuuri_viihde,2019-06-24 16:08:58.317757004,2019-06-24,2019-06-24,2019-06-24,5.0,-7.43,48.54,0.0,106.0,OKOYFIHH   ,0.0,0.0,19.0
4227,Saastot_sijoitukset,2019-06-24 20:51:35.327102799,2019-06-24,2019-06-24,2019-06-24,5.0,-13.58,34.96,0.0,162.0,           ,1.0,1.0,48.0
4228,Liikkuminen,2019-06-25 19:03:55.514018686,2019-06-25,2019-06-25,2019-06-25,5.0,-34.73,0.23,0.0,106.0,OKOYFIHH   ,1.0,0.0,20.0
4229,Lemmikit,2019-06-27 05:36:26.915887845,2019-06-27,2019-06-27,2019-06-27,5.0,-23.34,-23.11,0.0,106.0,OKOYFIHH   ,0.0,0.0,9.0
4230,Ruoka_paivittaistavarakauppa,2019-06-27 08:31:24.112149527,2019-06-27,2019-06-27,2019-06-27,5.0,-2.13,-25.24,0.0,162.0,           ,1.0,1.0,136.0
4231,Ruoka_paivittaistavarakauppa,2019-06-27 11:26:21.308411209,2019-06-27,2019-06-27,2019-06-27,5.0,-11.25,-36.49,0.0,162.0,           ,1.0,1.0,144.0
4232,Ruoka_paivittaistavarakauppa,2019-06-28 00:53:49.906542050,2019-06-28,2019-06-28,2019-06-28,5.0,-5.21,-41.7,0.0,162.0,           ,1.0,1.0,95.0
4233,Tulot,2019-06-28 21:58:52.710280368,2019-06-28,2019-06-28,2019-06-28,5.0,1548.14,1506.44,701.0,506.0,           ,1.0,1.0,230.0
4234,Luokittelemattomat,2019-06-29 17:16:15.700934573,2019-06-29,2019-06-29,2019-06-29,5.0,-68.49,1437.95,0.0,106.0,OKOYFIHH   ,1.0,0.0,12.0
4235,Asuminen,2019-06-30 03:48:47.102803732,2019-06-30,2019-06-30,2019-06-30,5.0,-207.9,1230.05,0.0,106.0,OKOYFIHH   ,0.0,0.0,14.0
4236,Muut,2019-06-30 14:21:18.504672891,2019-06-30,2019-06-30,2019-06-30,5.0,-162.08,1067.97,0.0,106.0,DABAFIHH   ,0.0,0.0,9.0
4237,Asuminen,2019-07-01 07:03:07.677725118,2019-07-01,2019-07-01,2019-07-01,5.0,-37.54,1030.43,706.0,129.0,NDEAFIHH   ,0.0,0.0,249.0
4238,Matkailu,2019-07-01 21:09:23.033175354,2019-07-01,2019-07-01,2019-07-01,5.0,-14.49,1015.94,706.0,129.0,OKOYFIHH   ,0.0,0.0,250.0
4239,Ruoka_paivittaistavarakauppa,2019-07-02 04:12:30.710900472,2019-07-02,2019-07-02,2019-07-02,5.0,-11.18,1004.76,0.0,162.0,           ,1.0,1.0,104.0
4240,Harrastukset,2019-07-02 11:15:38.388625590,2019-07-02,2019-07-02,2019-07-02,5.0,-77.41,927.35,706.0,106.0,DABAFIHH   ,0.0,0.0,246.0
4241,Tulot,2019-07-02 14:06:15.355450236,2019-07-02,2019-07-02,2019-07-02,5.0,1214.18,2141.53,701.0,506.0,           ,1.0,1.0,230.0
4242,Harrastukset,2019-07-02 18:18:46.066350708,2019-07-02,2019-07-02,2019-07-02,5.0,-37.86,2103.67,706.0,129.0,OKOYFIHH   ,0.0,0.0,253.0
4243,Ruoka_paivittaistavarakauppa,2019-07-03 01:21:53.744075826,2019-07-03,2019-07-03,2019-07-03,5.0,-42.42,2061.25,0.0,162.0,           ,1.0,1.0,47.0
4244,Muut,2019-07-03 08:25:01.421800944,2019-07-03,2019-07-03,2019-07-03,5.0,-12.09,2049.16,0.0,162.0,           ,1.0,1.0,174.0
4245,Muut,2019-07-03 13:59:25.876777242,2019-07-03,2019-07-03,2019-07-03,5.0,-39.39,2009.77,706.0,105.0,OKOYFIHH   ,1.0,0.0,242.0
4246,Tulot,2019-07-03 15:28:09.099526062,2019-07-03,2019-07-03,2019-07-03,5.0,-25.97,1983.8,0.0,162.0,           ,1.0,1.0,104.0
4247,Ruoka_paivittaistavarakauppa,2019-07-03 22:31:16.777251180,2019-07-03,2019-07-03,2019-07-03,5.0,-10.09,1973.71,0.0,162.0,           ,1.0,1.0,104.0
4248,Terveys,2019-07-04 05:34:24.454976298,2019-07-04,2019-07-04,2019-07-04,5.0,-12.07,1961.64,0.0,162.0,           ,1.0,1.0,58.0
4249,Ruoka_paivittaistavarakauppa,2019-07-04 12:37:32.132701416,2019-07-04,2019-07-04,2019-07-04,5.0,-15.82,1945.82,0.0,162.0,           ,1.0,1.0,186.0
4250,Ruoka_paivittaistavarakauppa,2019-07-04 19:40:39.810426534,2019-07-04,2019-07-04,2019-07-04,5.0,-54.54,1891.28,0.0,162.0,           ,1.0,1.0,129.0
4251,Luokittelemattomat,2019-07-04 21:02:33.554502360,2019-07-04,2019-07-04,2019-07-04,5.0,-13.49,1877.79,0.0,162.0,           ,1.0,1.0,109.0
4252,Liikkuminen,2019-07-05 02:43:47.488151652,2019-07-05,2019-07-05,2019-07-05,5.0,-49.2,1828.59,0.0,162.0,           ,1.0,1.0,120.0
4253,Tulot,2019-07-05 06:56:18.199052124,2019-07-05,2019-07-05,2019-07-05,5.0,-41.94,1786.65,706.0,129.0,OKOYFIHH   ,0.0,0.0,250.0
4254,Ravintolat_kahvilat,2019-07-05 09:46:55.165876770,2019-07-05,2019-07-05,2019-07-05,5.0,-7.94,1778.71,0.0,162.0,           ,1.0,1.0,162.0
4255,Ravintolat_kahvilat,2019-07-05 16:50:02.843601888,2019-07-05,2019-07-05,2019-07-05,5.0,-9.0,1769.71,0.0,162.0,           ,1.0,1.0,126.0
4256,Muut,2019-07-05 23:53:10.521327006,2019-07-05,2019-07-05,2019-07-05,5.0,-7.82,1761.89,0.0,103.0,           ,0.0,1.0,1.0
4257,Shoppailu,2019-07-08 01:15:04.265402832,2019-07-08,2019-07-08,2019-07-08,5.0,-28.3,1733.59,0.0,162.0,           ,1.0,1.0,57.0
4258,Lemmikit,2019-07-08 02:36:58.009478658,2019-07-08,2019-07-08,2019-07-08,5.0,-2.93,1730.66,0.0,162.0,           ,1.0,1.0,48.0
4259,Ruoka_paivittaistavarakauppa,2019-07-08 04:05:41.232227478,2019-07-08,2019-07-08,2019-07-08,5.0,-41.31,1689.35,0.0,162.0,           ,1.0,1.0,117.0
4260,Terveys,2019-07-08 08:18:11.943127950,2019-07-08,2019-07-08,2019-07-08,5.0,-15.03,1674.32,0.0,162.0,           ,1.0,1.0,117.0
4261,Ruoka_paivittaistavarakauppa,2019-07-08 11:08:48.909952596,2019-07-08,2019-07-08,2019-07-08,5.0,-13.1,1661.22,0.0,162.0,           ,1.0,1.0,48.0
4262,Ruoka_paivittaistavarakauppa,2019-07-08 15:21:19.620853068,2019-07-08,2019-07-09,2019-07-08,5.0,-15.28,1645.94,0.0,162.0,           ,1.0,1.0,84.0
4263,Lapset,2019-07-08 16:43:13.364928894,2019-07-08,2019-07-08,2019-07-08,5.0,-55.3,1590.64,0.0,162.0,           ,1.0,1.0,145.0
4264,Kulttuuri_viihde,2019-07-08 18:11:56.587677714,2019-07-08,2019-07-08,2019-07-08,5.0,-8.73,1581.91,0.0,162.0,           ,1.0,1.0,180.0
4265,Tulot,2019-07-08 22:24:27.298578186,2019-07-08,2019-07-08,2019-07-08,5.0,1441.53,3023.44,701.0,506.0,           ,1.0,1.0,233.0
4266,Ruoka_paivittaistavarakauppa,2019-07-09 05:27:34.976303304,2019-07-09,2019-07-09,2019-07-08,5.0,-25.51,2997.93,0.0,162.0,           ,1.0,1.0,179.0
4267,Lemmikit,2019-07-09 09:40:05.687203776,2019-07-09,2019-07-09,2019-07-09,5.0,-35.8,2962.13,0.0,162.0,           ,1.0,1.0,121.0
4268,Asuminen,2019-07-09 12:30:42.654028422,2019-07-09,2019-07-09,2019-07-09,5.0,-50.82,2911.31,0.0,162.0,           ,1.0,1.0,48.0
4269,Liikkuminen,2019-07-09 19:33:50.331753540,2019-07-09,2019-07-09,2019-07-09,5.0,-41.02,2870.29,0.0,162.0,           ,1.0,1.0,126.0
4270,Ruoka_paivittaistavarakauppa,2019-07-11 06:49:28.720379130,2019-07-11,2019-07-11,2019-07-11,5.0,-72.28,2798.01,0.0,162.0,           ,1.0,1.0,68.0
4271,Ruoka_paivittaistavarakauppa,2019-07-11 13:52:36.398104248,2019-07-11,2019-07-11,2019-07-11,5.0,-7.41,2790.6,0.0,162.0,           ,1.0,1.0,113.0
4272,Ruoka_paivittaistavarakauppa,2019-07-11 20:55:44.075829366,2019-07-11,2019-07-11,2019-07-11,5.0,-4.95,2785.65,0.0,162.0,           ,1.0,1.0,126.0
4273,Ravintolat_kahvilat,2019-07-11 23:46:21.042654012,2019-07-11,2019-07-11,2019-07-10,5.0,-25.53,2760.12,0.0,162.0,           ,1.0,1.0,114.0
4274,Lemmikit,2019-07-12 03:58:51.753554484,2019-07-12,2019-07-17,2019-07-12,5.0,-29.63,2730.49,0.0,162.0,           ,1.0,1.0,117.0
4275,Ruoka_paivittaistavarakauppa,2019-07-12 08:11:22.464454956,2019-07-12,2019-07-12,2019-07-12,5.0,-9.75,2720.74,0.0,162.0,           ,1.0,1.0,153.0
4276,Ruoka_paivittaistavarakauppa,2019-07-12 11:01:59.431279602,2019-07-12,2019-07-12,2019-07-12,5.0,-45.52,2675.22,0.0,162.0,           ,1.0,1.0,174.0
4277,Ravintolat_kahvilat,2019-07-12 18:05:07.109004720,2019-07-12,2019-07-12,2019-07-12,5.0,-13.78,2661.44,0.0,162.0,           ,1.0,1.0,46.0
4278,Tulot,2019-07-12 22:17:37.819905192,2019-07-12,2019-07-12,2019-07-12,5.0,694.19,3355.63,710.0,506.0,           ,1.0,1.0,260.0
4279,Shoppailu,2019-07-15 01:08:14.786729838,2019-07-15,2019-07-15,2019-07-15,5.0,-15.43,3340.2,0.0,162.0,           ,1.0,1.0,116.0
4280,Ruoka_paivittaistavarakauppa,2019-07-15 02:30:08.530805664,2019-07-15,2019-07-15,2019-07-15,5.0,-134.82,3205.38,0.0,162.0,           ,1.0,1.0,47.0
4281,Ravintolat_kahvilat,2019-07-15 05:20:45.497630310,2019-07-15,2019-07-15,2019-07-15,5.0,-6.42,3198.96,0.0,162.0,           ,1.0,1.0,120.0
4282,Kulttuuri_viihde,2019-07-15 09:33:16.208530782,2019-07-15,2019-07-15,2019-07-15,5.0,-3.31,3195.65,0.0,162.0,           ,1.0,1.0,70.0
4283,Liikkuminen,2019-07-15 12:23:53.175355428,2019-07-15,2019-07-15,2019-07-15,5.0,-5.15,3190.5,0.0,162.0,           ,1.0,1.0,137.0
4284,Ruoka_paivittaistavarakauppa,2019-07-15 15:14:30.142180074,2019-07-15,2019-07-15,2019-07-15,5.0,-33.78,3156.72,0.0,162.0,           ,1.0,1.0,121.0
4285,Saastot_sijoitukset,2019-07-15 16:36:23.886255900,2019-07-15,2019-07-15,2019-07-15,5.0,-41.88,3114.84,0.0,162.0,           ,1.0,1.0,116.0
4286,Kulttuuri_viihde,2019-07-15 19:27:00.853080546,2019-07-15,2019-07-15,2019-07-15,5.0,-8.79,3106.05,0.0,162.0,           ,1.0,1.0,168.0
4287,Ruoka_paivittaistavarakauppa,2019-07-15 23:39:31.563981018,2019-07-15,2019-07-15,2019-07-15,5.0,-8.78,3097.27,0.0,162.0,           ,1.0,1.0,125.0
4288,Lapset,2019-07-16 06:42:39.241706136,2019-07-16,2019-07-16,2019-07-16,5.0,-15.48,3081.79,0.0,162.0,           ,1.0,1.0,153.0
4289,Asuminen,2019-07-16 13:45:46.919431254,2019-07-16,2019-07-16,2019-07-16,5.0,-12.21,3069.58,0.0,162.0,           ,1.0,1.0,105.0
4290,Harrastukset,2019-07-16 20:48:54.597156372,2019-07-16,2019-07-17,2019-07-16,5.0,-31.56,3038.02,0.0,162.0,           ,1.0,1.0,114.0
4291,Ravintolat_kahvilat,2019-07-17 03:52:02.274881490,2019-07-17,2019-07-17,2019-07-17,5.0,-36.81,3001.21,0.0,162.0,           ,1.0,1.0,47.0
4292,Ruoka_paivittaistavarakauppa,2019-07-18 01:01:25.308056844,2019-07-18,2019-07-18,2019-07-18,5.0,-25.61,2975.6,0.0,162.0,           ,1.0,1.0,114.0
4293,Saastot_sijoitukset,2019-07-18 08:04:32.985781962,2019-07-18,2019-07-18,2019-07-18,5.0,-121.92,2853.68,0.0,162.0,           ,1.0,1.0,164.0
4294,Lemmikit,2019-07-18 10:55:09.952606608,2019-07-18,2019-07-18,2019-07-18,5.0,-34.68,2819.0,0.0,162.0,           ,1.0,1.0,144.0
4295,Luokittelemattomat,2019-07-18 15:07:40.663507080,2019-07-18,2019-07-18,2019-07-18,5.0,-4.67,2814.33,0.0,162.0,           ,1.0,1.0,84.0
4296,Matkailu,2019-07-18 22:10:48.341232198,2019-07-18,2019-07-18,2019-07-18,5.0,-231.45,2582.88,0.0,162.0,           ,1.0,1.0,111.0
4297,Tulot,2019-07-19 02:23:19.052132670,2019-07-19,2019-07-19,2019-07-19,5.0,300.52,2883.4,0.0,505.0,           ,1.0,1.0,208.0
4298,Ruoka_paivittaistavarakauppa,2019-07-19 05:13:56.018957316,2019-07-19,2019-07-19,2019-07-19,5.0,-16.66,2866.74,0.0,162.0,           ,1.0,1.0,115.0
4299,Asuminen,2019-07-19 09:26:26.729857788,2019-07-19,2019-07-19,2019-07-19,5.0,-22.94,2843.8,0.0,162.0,           ,1.0,1.0,134.0
4300,Tulot,2019-07-19 12:17:03.696682434,2019-07-19,2019-07-19,2019-07-19,5.0,822.91,3666.71,0.0,505.0,           ,1.0,1.0,209.0
4301,Ruoka_paivittaistavarakauppa,2019-07-19 17:58:17.630331726,2019-07-19,2019-07-19,2019-07-19,5.0,-6.65,3660.06,0.0,162.0,           ,1.0,1.0,164.0
4302,Muut,2019-07-19 19:20:11.374407552,2019-07-19,2019-07-19,2019-07-19,5.0,-325.22,3334.84,0.0,163.0,           ,1.0,1.0,193.0
4303,Ruoka_paivittaistavarakauppa,2019-07-19 23:32:42.085308024,2019-07-19,2019-07-19,2019-07-19,5.0,-6.23,3328.61,0.0,162.0,           ,1.0,1.0,101.0
4304,Muut,2019-07-22 03:45:12.796208496,2019-07-22,2019-07-22,2019-07-22,5.0,-128.23,3200.38,0.0,163.0,           ,1.0,1.0,196.0
4305,Ruoka_paivittaistavarakauppa,2019-07-22 06:35:49.763033142,2019-07-22,2019-07-22,2019-07-22,5.0,-9.55,3190.83,0.0,162.0,           ,1.0,1.0,107.0
4306,Tulot,2019-07-22 10:48:20.473933614,2019-07-22,2019-07-22,2019-07-22,5.0,-17.63,3173.2,0.0,162.0,           ,1.0,1.0,109.0
4307,Saastot_sijoitukset,2019-07-22 12:10:14.218009440,2019-07-22,2019-07-23,2019-07-22,5.0,-102.2,3071.0,0.0,162.0,           ,1.0,1.0,142.0
4308,Luokittelemattomat,2019-07-22 13:38:57.440758260,2019-07-22,2019-07-24,2019-07-22,5.0,-8.82,3062.18,0.0,162.0,           ,1.0,1.0,158.0
4309,Liikkuminen,2019-07-22 16:29:34.407582906,2019-07-22,2019-07-22,2019-07-22,5.0,-1.56,3060.62,0.0,162.0,           ,1.0,1.0,152.0
4310,Ruoka_paivittaistavarakauppa,2019-07-22 17:51:28.151658732,2019-07-22,2019-07-22,2019-07-22,5.0,-14.49,3046.13,0.0,162.0,           ,1.0,1.0,101.0
4311,Tulot,2019-07-22 20:42:05.118483378,2019-07-22,2019-07-22,2019-07-22,5.0,539.07,3585.2,0.0,505.0,           ,1.0,1.0,208.0
4312,Luottojen_maksut,2019-07-23 00:54:35.829383850,2019-07-23,2019-07-25,2019-07-23,5.0,-20.03,3565.17,706.0,147.0,DABAFIHH   ,0.0,0.0,255.0
4313,Ruoka_paivittaistavarakauppa,2019-07-23 07:57:43.507108968,2019-07-23,2019-07-23,2019-07-23,5.0,-3.65,3561.52,0.0,162.0,           ,1.0,1.0,88.0
4314,Ruoka_paivittaistavarakauppa,2019-07-23 15:00:51.184834086,2019-07-23,2019-07-23,2019-07-23,5.0,-10.14,3551.38,0.0,162.0,           ,1.0,1.0,141.0
4315,Tulot,2019-07-23 22:03:58.862559204,2019-07-23,2019-07-23,2019-07-23,5.0,334.91,3886.29,0.0,505.0,           ,1.0,1.0,208.0
4316,Luottojen_maksut,2019-07-24 05:07:06.540284322,2019-07-24,2019-07-24,2019-07-24,5.0,-116.16,3770.13,706.0,129.0,NDEAFIHH   ,0.0,0.0,250.0
4317,Ruoka_paivittaistavarakauppa,2019-07-24 19:13:21.895734558,2019-07-24,2019-07-24,2019-07-24,5.0,-24.2,3745.93,0.0,162.0,           ,1.0,1.0,131.0
4318,Tulot,2019-07-25 02:16:29.573459676,2019-07-25,2019-07-25,2019-07-25,5.0,2267.33,6013.26,0.0,505.0,           ,1.0,1.0,210.0
4319,Liikkuminen,2019-07-26 03:38:23.317535502,2019-07-26,2019-07-26,2019-07-26,5.0,-48.83,5964.43,0.0,162.0,           ,1.0,1.0,52.0
4320,Ruoka_paivittaistavarakauppa,2019-07-26 06:29:00.284360148,2019-07-26,2019-07-26,2019-07-26,5.0,-20.23,5944.2,0.0,162.0,           ,1.0,1.0,64.0
4321,Muut,2019-07-26 09:19:37.251184794,2019-07-26,2019-07-26,2019-07-26,5.0,-117.58,5826.62,0.0,163.0,           ,1.0,1.0,195.0
4322,Saastot_sijoitukset,2019-07-26 10:41:30.995260620,2019-07-26,2019-07-26,2019-07-26,5.0,-75.29,5751.33,0.0,162.0,           ,1.0,1.0,123.0
4323,Liikkuminen,2019-07-26 13:32:07.962085266,2019-07-26,2019-07-26,2019-07-26,5.0,-34.62,5716.71,0.0,162.0,           ,1.0,1.0,108.0
4324,Lemmikit,2019-07-26 16:22:44.928909912,2019-07-26,2019-07-26,2019-07-26,5.0,-62.96,5653.75,0.0,162.0,           ,1.0,1.0,115.0
4325,Ruoka_paivittaistavarakauppa,2019-07-26 17:44:38.672985738,2019-07-26,2019-07-26,2019-07-26,5.0,-115.74,5538.01,0.0,162.0,           ,1.0,1.0,116.0
4326,Ruoka_paivittaistavarakauppa,2019-07-26 20:35:15.639810384,2019-07-26,2019-07-26,2019-07-26,5.0,-54.86,5483.15,0.0,162.0,           ,1.0,1.0,142.0
4327,Tulot,2019-07-26 23:25:52.606635030,2019-07-26,2019-07-26,2019-07-26,5.0,512.08,5995.23,0.0,505.0,           ,1.0,1.0,212.0
4328,Luokittelemattomat,2019-07-29 00:47:46.350710856,2019-07-29,2019-07-29,2019-07-29,5.0,-32.83,5962.4,0.0,162.0,           ,1.0,1.0,99.0
4329,Liikkuminen,2019-07-29 05:00:17.061611328,2019-07-29,2019-07-29,2019-07-29,5.0,-65.48,5896.92,0.0,162.0,           ,1.0,1.0,104.0
4330,Ravintolat_kahvilat,2019-07-29 07:50:54.028435974,2019-07-29,2019-07-29,2019-07-29,5.0,-1.9,5895.02,0.0,162.0,           ,1.0,1.0,142.0
4331,Tulot,2019-07-29 12:03:24.739336446,2019-07-29,2019-07-29,2019-07-29,5.0,142.76,6037.78,0.0,505.0,           ,1.0,1.0,209.0
4332,Tulot,2019-07-29 14:54:01.706161092,2019-07-29,2019-07-29,2019-07-29,5.0,1610.08,7647.86,0.0,505.0,           ,1.0,1.0,208.0
4333,Tulot,2019-07-29 19:06:32.417061564,2019-07-29,2019-07-29,2019-07-29,5.0,639.82,8287.68,0.0,505.0,           ,1.0,1.0,208.0
4334,Asuminen,2019-07-29 21:57:09.383886210,2019-07-29,2019-07-29,2019-07-29,5.0,-22.48,8265.2,0.0,162.0,           ,1.0,1.0,161.0
4335,Ruoka_paivittaistavarakauppa,2019-07-29 23:19:03.127962036,2019-07-29,2019-07-29,2019-07-29,5.0,-7.24,8257.96,0.0,162.0,           ,1.0,1.0,117.0
4336,Shoppailu,2019-07-30 02:09:40.094786682,2019-07-30,2019-07-30,2019-07-30,5.0,-34.68,8223.28,0.0,162.0,           ,1.0,1.0,104.0
4337,Terveys,2019-07-30 09:12:47.772511800,2019-07-30,2019-07-30,2019-07-30,5.0,136.33,8359.61,0.0,505.0,           ,1.0,1.0,210.0
4338,Tulot,2019-07-30 16:15:55.450236918,2019-07-30,2019-07-30,2019-07-30,5.0,622.33,8981.94,0.0,505.0,           ,1.0,1.0,214.0
4339,Ruoka_paivittaistavarakauppa,2019-07-31 06:22:10.805687154,2019-07-31,2019-07-31,2019-07-31,5.0,-38.96,8942.98,0.0,162.0,           ,1.0,1.0,79.0
4340,Liikkuminen,2019-07-31 13:25:18.483412272,2019-07-31,2019-07-31,2019-07-31,5.0,-91.4,8851.58,0.0,162.0,           ,1.0,1.0,111.0
4341,Ruoka_paivittaistavarakauppa,2019-07-31 20:28:26.161137390,2019-07-31,2019-07-31,2019-07-31,5.0,-27.7,8823.88,0.0,162.0,           ,1.0,1.0,154.0
4342,Luokittelemattomat,2019-08-01 14:39:09.473684208,2019-08-01,2019-08-01,2019-08-01,5.0,-319.83,8504.05,0.0,162.0,           ,1.0,1.0,174.0
4343,Muut,2019-08-01 15:39:47.368421052,2019-08-01,2019-08-02,2019-08-01,5.0,-308.43,8195.62,0.0,161.0,           ,1.0,1.0,45.0
4344,Ruoka_paivittaistavarakauppa,2019-08-02 07:19:34.736842104,2019-08-02,2019-08-02,2019-08-02,5.0,-34.38,8161.24,0.0,162.0,           ,1.0,1.0,131.0
4345,Luokittelemattomat,2019-08-02 22:59:22.105263156,2019-08-02,2019-08-02,2019-08-02,5.0,-127.22,8034.02,0.0,162.0,           ,1.0,1.0,48.0
4346,Ruoka_paivittaistavarakauppa,2019-08-05 05:18:18.947368416,2019-08-05,2019-08-05,2019-08-05,5.0,-18.38,8015.64,0.0,162.0,           ,1.0,1.0,128.0
4347,Ruoka_paivittaistavarakauppa,2019-08-05 06:18:56.842105260,2019-08-05,2019-08-05,2019-08-05,5.0,-97.57,7918.07,0.0,162.0,           ,1.0,1.0,150.0
4348,Ruoka_paivittaistavarakauppa,2019-08-05 13:38:31.578947364,2019-08-05,2019-08-05,2019-08-05,5.0,-53.74,7864.33,0.0,162.0,           ,1.0,1.0,101.0
4349,Tulot,2019-08-05 20:58:06.315789468,2019-08-05,2019-08-05,2019-08-05,5.0,1163.04,9027.37,0.0,505.0,           ,1.0,1.0,212.0
4350,Liikkuminen,2019-08-05 21:58:44.210526312,2019-08-05,2019-08-07,2019-08-05,5.0,-207.8,8819.57,0.0,162.0,           ,1.0,1.0,142.0
4351,Liikkuminen,2019-08-06 12:37:53.684210520,2019-08-06,2019-08-09,2019-08-06,5.0,-131.7,8687.87,0.0,162.0,           ,1.0,1.0,117.0
4352,Muut,2019-08-08 19:57:28.421052624,2019-08-08,2019-08-08,2019-08-08,5.0,-1171.57,7516.3,0.0,105.0,OKOYFIHH   ,1.0,0.0,7.0
4353,Muut,2019-08-09 03:17:03.157894728,2019-08-09,2019-08-09,2019-08-09,5.0,-20.4,7495.9,0.0,105.0,OKOYFIHH   ,1.0,0.0,3.0
4354,Tulot,2019-08-09 04:17:41.052631572,2019-08-09,2019-08-09,2019-08-09,5.0,1482.93,8978.83,0.0,505.0,           ,1.0,1.0,208.0
4355,Tulot,2019-08-09 11:37:15.789473676,2019-08-09,2019-08-09,2019-08-09,5.0,285.35,9264.18,0.0,505.0,           ,1.0,1.0,209.0
4356,Tulot,2019-08-10 10:36:37.894736832,2019-08-10,2019-08-10,2019-08-10,5.0,347.58,9611.76,0.0,505.0,           ,1.0,1.0,208.0
4357,Ruoka_paivittaistavarakauppa,2019-08-12 02:16:25.263157884,2019-08-12,2019-08-13,2019-08-12,5.0,-132.21,9479.55,0.0,162.0,           ,1.0,1.0,104.0
4358,Muut,2019-08-12 17:56:12.631578936,2019-08-12,2019-08-12,2019-08-12,5.0,-1516.25,7963.3,0.0,105.0,OKOYFIHH   ,1.0,0.0,4.0
4359,Liikkuminen,2019-08-12 18:56:50.526315780,2019-08-12,2019-08-14,2019-08-12,5.0,-929.25,7034.05,0.0,106.0,NDEAFIHH   ,1.0,0.0,22.0
4360,Tulot,2019-08-13 01:15:47.368421040,2019-08-13,2019-08-13,2019-08-13,5.0,42.92,7076.97,0.0,505.0,           ,1.0,1.0,210.0
4361,Tulot,2019-08-13 09:35:59.999999988,2019-08-13,2019-08-13,2019-08-13,5.0,685.3,7762.27,0.0,505.0,           ,1.0,1.0,213.0
4362,Tulot,2019-08-13 16:55:34.736842092,2019-08-13,2019-08-13,2019-08-13,5.0,158.63,7920.9,0.0,505.0,           ,1.0,1.0,208.0
4363,Muut,2019-08-15 08:35:22.105263144,2019-08-15,2019-08-16,2019-08-15,5.0,-62.54,7858.36,0.0,105.0,OKOYFIHH   ,1.0,0.0,3.0
4364,Tulot,2019-08-16 00:15:09.473684196,2019-08-16,2019-08-16,2019-08-16,5.0,346.91,8205.27,0.0,505.0,           ,1.0,1.0,208.0
4365,Muut,2019-08-16 15:54:56.842105248,2019-08-16,2019-08-16,2019-08-16,5.0,-1630.4,6574.87,0.0,105.0,OKOYFIHH   ,1.0,0.0,3.0
4366,Tulot,2019-08-18 14:54:18.947368404,2019-08-18,2019-08-18,2019-08-18,5.0,655.29,7230.16,0.0,505.0,           ,1.0,1.0,208.0
4367,Tulot,2019-08-18 23:14:31.578947352,2019-08-18,2019-08-18,2019-08-18,5.0,256.4,7486.56,0.0,505.0,           ,1.0,1.0,208.0
4368,Ruoka_paivittaistavarakauppa,2019-08-19 06:34:06.315789456,2019-08-19,2019-08-19,2019-08-19,5.0,-34.23,7452.33,0.0,162.0,           ,1.0,1.0,104.0
4369,Ruoka_paivittaistavarakauppa,2019-08-19 07:34:44.210526300,2019-08-19,2019-08-19,2019-08-19,5.0,-3.54,7448.79,0.0,162.0,           ,1.0,1.0,108.0
4370,Liikkuminen,2019-08-19 22:13:53.684210508,2019-08-19,2019-08-19,2019-08-19,5.0,-6.64,7442.15,0.0,162.0,           ,1.0,1.0,164.0
4371,Liikkuminen,2019-08-20 05:33:28.421052612,2019-08-20,2019-08-20,2019-08-20,5.0,-9.33,7432.82,0.0,162.0,           ,1.0,1.0,191.0
4372,Liikkuminen,2019-08-20 13:53:41.052631560,2019-08-20,2019-08-20,2019-08-20,5.0,-31.62,7401.2,0.0,162.0,           ,1.0,1.0,137.0
4373,Ruoka_paivittaistavarakauppa,2019-08-21 21:13:15.789473664,2019-08-21,2019-08-21,2019-08-20,5.0,-39.92,7361.28,0.0,162.0,           ,1.0,1.0,93.0
4374,Tulot,2019-08-23 04:32:50.526315768,2019-08-23,2019-08-23,2019-08-23,5.0,687.13,8048.41,0.0,505.0,           ,1.0,1.0,208.0
4375,Liikkuminen,2019-08-23 12:53:03.157894716,2019-08-23,2019-08-23,2019-08-23,5.0,-40.94,8007.47,0.0,162.0,           ,1.0,1.0,152.0
4376,Luokittelemattomat,2019-08-23 20:12:37.894736820,2019-08-23,2019-08-23,2019-08-23,5.0,-4.98,8002.49,0.0,162.0,           ,1.0,1.0,153.0
4377,Tulot,2019-08-24 03:32:12.631578924,2019-08-24,2019-08-24,2019-08-24,5.0,25.15,8027.64,0.0,505.0,           ,1.0,1.0,209.0
4378,Tulot,2019-08-25 19:11:59.999999976,2019-08-25,2019-08-25,2019-08-25,5.0,933.15,8960.79,0.0,505.0,           ,1.0,1.0,208.0
4379,Saastot_sijoitukset,2019-08-26 10:51:47.368421028,2019-08-26,2019-08-26,2019-08-26,5.0,-72.98,8887.81,0.0,162.0,           ,1.0,1.0,151.0
4380,Liikkuminen,2019-08-26 11:52:25.263157872,2019-08-26,2019-08-26,2019-08-26,5.0,-6.41,8881.4,0.0,162.0,           ,1.0,1.0,111.0
4381,Saastot_sijoitukset,2019-08-27 02:31:34.736842080,2019-08-27,2019-08-27,2019-08-27,5.0,-25.86,8855.54,0.0,162.0,           ,1.0,1.0,123.0
4382,Lapset,2019-08-27 09:51:09.473684184,2019-08-27,2019-08-27,2019-08-27,5.0,-3.87,8851.67,0.0,162.0,           ,1.0,1.0,138.0
4383,Ruoka_paivittaistavarakauppa,2019-08-27 18:11:22.105263132,2019-08-27,2019-08-27,2019-08-27,5.0,-4.74,8846.93,0.0,162.0,           ,1.0,1.0,187.0
4384,Tulot,2019-08-28 17:10:44.210526288,2019-08-28,2019-08-28,2019-08-28,5.0,710.99,9557.92,0.0,505.0,           ,1.0,1.0,209.0
4385,Tulot,2019-08-29 01:30:56.842105236,2019-08-29,2019-08-29,2019-08-29,5.0,33.99,9591.91,0.0,505.0,           ,1.0,1.0,209.0
4386,Ruoka_paivittaistavarakauppa,2019-08-30 00:30:18.947368392,2019-08-30,2019-08-30,2019-08-30,5.0,-2.86,9589.05,0.0,162.0,           ,1.0,1.0,122.0
4387,Ruoka_paivittaistavarakauppa,2019-08-30 08:50:31.578947340,2019-08-30,2019-08-30,2019-08-30,5.0,-84.83,9504.22,0.0,162.0,           ,1.0,1.0,137.0
4388,Tulot,2019-08-30 16:10:06.315789444,2019-08-30,2019-08-30,2019-08-30,5.0,260.22,9764.44,0.0,505.0,           ,1.0,1.0,208.0
4389,Tulot,2019-09-02 17:44:20.869565216,2019-09-02,2019-09-02,2019-09-02,5.0,25.75,9790.19,0.0,505.0,           ,1.0,1.0,209.0
4390,Ruoka_paivittaistavarakauppa,2019-09-02 20:52:10.434782608,2019-09-02,2019-09-02,2019-09-02,5.0,-93.31,9696.88,0.0,162.0,           ,1.0,1.0,134.0
4391,Tulot,2019-09-03 14:36:31.304347824,2019-09-03,2019-09-03,2019-09-03,5.0,1739.74,11436.62,0.0,505.0,           ,1.0,1.0,212.0
4392,Asuminen,2019-09-04 11:28:41.739130432,2019-09-04,2019-09-04,2019-09-04,5.0,-80.51,11356.11,0.0,162.0,           ,1.0,1.0,161.0
4393,Ravintolat_kahvilat,2019-09-05 05:13:02.608695648,2019-09-05,2019-09-05,2019-09-05,5.0,-2.47,11353.64,0.0,162.0,           ,1.0,1.0,171.0
4394,Ravintolat_kahvilat,2019-09-06 02:05:13.043478256,2019-09-06,2019-09-06,2019-09-06,5.0,-5.18,11348.46,0.0,162.0,           ,1.0,1.0,144.0
4395,Saastot_sijoitukset,2019-09-06 08:20:52.173913040,2019-09-06,2019-09-06,2019-09-06,5.0,-235.37,11113.09,0.0,162.0,           ,1.0,1.0,156.0
4396,Kulttuuri_viihde,2019-09-06 22:57:23.478260864,2019-09-06,2019-09-06,2019-09-06,5.0,-4.74,11108.35,0.0,162.0,           ,1.0,1.0,126.0
4397,Liikkuminen,2019-09-09 16:41:44.347826080,2019-09-09,2019-09-09,2019-09-09,5.0,-13.88,11094.47,0.0,162.0,           ,1.0,1.0,131.0
4398,Saastot_sijoitukset,2019-09-09 19:49:33.913043472,2019-09-09,2019-09-09,2019-09-09,5.0,-3.5,11090.97,0.0,162.0,           ,1.0,1.0,47.0
4399,Hyvinvointijakauneus,2019-09-10 10:26:05.217391296,2019-09-10,2019-09-10,2019-09-10,5.0,-47.87,11043.1,0.0,162.0,           ,1.0,1.0,153.0
4400,Ravintolat_kahvilat,2019-09-10 13:33:54.782608688,2019-09-10,2019-09-10,2019-09-10,5.0,-21.27,11021.83,0.0,162.0,           ,1.0,1.0,141.0
4401,Tulot,2019-09-12 01:02:36.521739120,2019-09-12,2019-09-12,2019-09-12,5.0,20.75,11042.58,0.0,505.0,           ,1.0,1.0,208.0
4402,Ruoka_paivittaistavarakauppa,2019-09-12 07:18:15.652173904,2019-09-12,2019-09-12,2019-09-12,5.0,-27.05,11015.53,0.0,162.0,           ,1.0,1.0,172.0
4403,Ruoka_paivittaistavarakauppa,2019-09-13 04:10:26.086956512,2019-09-13,2019-09-13,2019-09-12,5.0,-9.55,11005.98,0.0,162.0,           ,1.0,1.0,46.0
4404,Shoppailu,2019-09-16 15:39:07.826086944,2019-09-16,2019-09-16,2019-09-16,5.0,419.38,11425.36,0.0,505.0,           ,1.0,1.0,208.0
4405,Luottojen_maksut,2019-09-16 18:46:57.391304336,2019-09-16,2019-09-16,2019-09-16,5.0,-1421.89,10003.47,0.0,172.0,           ,1.0,1.0,205.0
4406,Luottojen_maksut,2019-09-16 21:54:46.956521728,2019-09-16,2019-09-17,2019-09-16,5.0,-4798.52,5204.95,0.0,172.0,           ,1.0,1.0,204.0
4407,Luottojen_maksut,2019-09-17 12:31:18.260869552,2019-09-17,2019-09-17,2019-09-17,5.0,-1331.04,3873.91,0.0,172.0,           ,1.0,1.0,202.0
4408,Muut,2019-09-18 09:23:28.695652160,2019-09-18,2019-09-18,2019-09-18,5.0,-4.48,3869.43,0.0,103.0,           ,0.0,1.0,0.0
4409,Ruoka_paivittaistavarakauppa,2019-09-19 06:15:39.130434768,2019-09-19,2019-09-19,2019-09-19,5.0,-41.28,3828.15,0.0,162.0,           ,1.0,1.0,147.0
4410,Tulot,2019-09-20 03:07:49.565217376,2019-09-20,2019-09-20,2019-09-20,5.0,1128.85,4957.0,0.0,505.0,           ,1.0,1.0,208.0
4411,Liikkuminen,2019-09-20 23:59:59.999999984,2019-09-20,2019-09-20,2019-09-20,5.0,-14.56,4942.44,0.0,162.0,           ,1.0,1.0,160.0
4412,Tulot,2019-09-21 20:52:10.434782592,2019-09-21,2019-09-21,2019-09-21,5.0,100.04,5042.48,0.0,505.0,           ,1.0,1.0,209.0
4413,Liikkuminen,2019-09-23 14:36:31.304347808,2019-09-23,2019-09-23,2019-09-23,5.0,-78.43,4964.05,0.0,162.0,           ,1.0,1.0,84.0
4414,Liikkuminen,2019-09-23 17:44:20.869565200,2019-09-23,2019-09-23,2019-09-23,5.0,-103.56,4860.49,0.0,162.0,           ,1.0,1.0,131.0
4415,Liikkuminen,2019-09-24 08:20:52.173913024,2019-09-24,2019-09-24,2019-09-24,5.0,-11.14,4849.35,0.0,162.0,           ,1.0,1.0,151.0
4416,Ruoka_paivittaistavarakauppa,2019-09-24 11:28:41.739130416,2019-09-24,2019-09-24,2019-09-24,5.0,-50.93,4798.42,0.0,162.0,           ,1.0,1.0,104.0
4417,Ruoka_paivittaistavarakauppa,2019-09-25 05:13:02.608695632,2019-09-25,2019-09-25,2019-09-25,5.0,-24.9,4773.52,0.0,162.0,           ,1.0,1.0,93.0
4418,Ruoka_paivittaistavarakauppa,2019-09-27 02:05:13.043478240,2019-09-27,2019-09-27,2019-09-27,5.0,-134.38,4639.14,0.0,162.0,           ,1.0,1.0,74.0
4419,Tulot,2019-09-27 19:49:33.913043456,2019-09-27,2019-09-27,2019-09-27,5.0,602.12,5241.26,0.0,505.0,           ,1.0,1.0,215.0
4420,Tulot,2019-09-27 22:57:23.478260848,2019-09-27,2019-09-27,2019-09-27,5.0,18.49,5259.75,0.0,505.0,           ,1.0,1.0,209.0
4421,Liikkuminen,2019-09-30 13:33:54.782608672,2019-09-30,2019-09-30,2019-10-02,5.0,-25.74,5234.01,0.0,162.0,           ,1.0,1.0,136.0
4422,Ravintolat_kahvilat,2019-09-30 16:41:44.347826064,2019-09-30,2019-09-30,2019-09-30,5.0,-2.43,5231.58,0.0,162.0,           ,1.0,1.0,169.0
4423,Ruoka_paivittaistavarakauppa,2019-10-02 05:10:35.294117647,2019-10-02,2019-10-02,2019-10-02,5.0,-29.63,5201.95,0.0,162.0,           ,1.0,1.0,152.0
4424,Ruoka_paivittaistavarakauppa,2019-10-03 10:21:10.588235294,2019-10-03,2019-10-03,2019-10-03,5.0,-32.61,5169.34,0.0,162.0,           ,1.0,1.0,134.0
4425,Liikkuminen,2019-10-03 20:42:21.176470588,2019-10-03,2019-10-03,2019-10-03,5.0,-53.52,5115.82,0.0,162.0,           ,1.0,1.0,165.0
4426,Matkailu,2019-10-04 15:31:45.882352941,2019-10-04,2019-10-04,2019-10-04,5.0,-234.9,4880.92,0.0,162.0,           ,1.0,1.0,185.0
4427,Shoppailu,2019-10-07 01:52:56.470588235,2019-10-07,2019-10-07,2019-10-07,5.0,-17.88,4863.04,0.0,162.0,           ,1.0,1.0,110.0
4428,Ravintolat_kahvilat,2019-10-08 07:03:31.764705882,2019-10-08,2019-10-08,2019-10-08,5.0,-37.33,4825.71,0.0,162.0,           ,1.0,1.0,139.0
4429,Liikkuminen,2019-10-08 12:14:07.058823529,2019-10-08,2019-10-10,2019-10-08,5.0,-102.29,4723.42,0.0,162.0,           ,1.0,1.0,132.0
4430,Saastot_sijoitukset,2019-10-10 03:45:52.941176470,2019-10-10,2019-10-10,2019-10-10,5.0,-35.13,4688.29,0.0,162.0,           ,1.0,1.0,85.0
4431,Liikkuminen,2019-10-11 17:24:42.352941176,2019-10-11,2019-10-11,2019-10-11,5.0,-43.02,4645.27,0.0,162.0,           ,1.0,1.0,122.0
4432,Ruoka_paivittaistavarakauppa,2019-10-11 22:35:17.647058823,2019-10-11,2019-10-11,2019-10-11,5.0,-5.39,4639.88,0.0,162.0,           ,1.0,1.0,74.0
4433,Muut,2019-10-15 08:56:28.235294117,2019-10-15,2019-10-15,2019-10-15,5.0,-8.07,4631.81,0.0,103.0,           ,0.0,1.0,0.0
4434,Ruoka_paivittaistavarakauppa,2019-10-15 14:07:03.529411764,2019-10-15,2019-10-15,2019-10-15,5.0,-9.31,4622.5,0.0,162.0,           ,1.0,1.0,133.0
4435,Muut,2019-10-15 19:17:38.823529411,2019-10-15,2019-10-15,2019-10-15,5.0,-127.83,4494.67,0.0,105.0,OKOYFIHH   ,1.0,0.0,3.0
4436,Luokittelemattomat,2019-10-18 00:28:14.117647058,2019-10-18,2019-10-18,2019-10-18,5.0,-15.39,4479.28,0.0,162.0,           ,1.0,1.0,126.0
4437,Ruoka_paivittaistavarakauppa,2019-10-18 05:38:49.411764705,2019-10-21,2019-10-18,2019-10-18,5.0,-9.64,4469.64,0.0,162.0,           ,1.0,1.0,47.0
4438,Asuminen,2019-10-21 10:49:24.705882352,2019-10-21,2019-10-21,2019-10-21,5.0,-50.78,4418.86,0.0,162.0,           ,1.0,1.0,150.0
4439,Liikkuminen,2019-10-21 15:59:59.999999999,2019-10-21,2019-10-21,2019-10-21,5.0,-57.99,4360.87,0.0,162.0,           ,1.0,1.0,66.0
4440,Ruoka_paivittaistavarakauppa,2019-10-22 21:10:35.294117646,2019-10-22,2019-10-22,2019-10-22,5.0,-9.06,4351.81,0.0,162.0,           ,1.0,1.0,121.0
4441,Ravintolat_kahvilat,2019-10-25 02:21:10.588235293,2019-10-25,2019-10-25,2019-10-25,5.0,-9.86,4341.95,0.0,162.0,           ,1.0,1.0,129.0
4442,Tulot,2019-10-25 07:31:45.882352940,2019-10-25,2019-10-25,2019-10-25,5.0,79.64,4421.59,0.0,505.0,           ,1.0,1.0,209.0
4443,Liikkuminen,2019-10-25 12:42:21.176470587,2019-10-25,2019-10-25,2019-10-24,5.0,-65.38,4356.21,0.0,162.0,           ,1.0,1.0,69.0
4444,Ruoka_paivittaistavarakauppa,2019-10-28 04:14:07.058823528,2019-10-28,2019-10-28,2019-10-28,5.0,-41.82,4314.39,0.0,162.0,           ,1.0,1.0,92.0
4445,Tulot,2019-10-28 17:52:56.470588234,2019-10-28,2019-10-28,2019-10-28,5.0,956.75,5271.14,0.0,505.0,           ,1.0,1.0,211.0
4446,Kulttuuri_viihde,2019-10-28 23:03:31.764705881,2019-10-28,2019-10-28,2019-10-28,5.0,-3.18,5267.96,0.0,162.0,           ,1.0,1.0,86.0
4447,Tulot,2019-10-30 09:24:42.352941175,2019-10-30,2019-10-30,2019-10-30,5.0,8.18,5276.14,0.0,505.0,           ,1.0,1.0,212.0
4448,Tulot,2019-11-12 00:00:00.000000000,2019-11-12,2019-11-12,2019-11-12,5.0,470.56,5746.7,710.0,505.0,           ,1.0,1.0,258.0
4449,Shoppailu,2019-11-25 00:00:00.000000000,2019-11-25,2019-11-25,2019-11-25,5.0,-24.12,5722.58,0.0,162.0,           ,1.0,1.0,97.0
4450,Ruoka_paivittaistavarakauppa,2019-12-06 15:16:21.818181818,2019-12-06,2019-12-06,2019-12-06,5.0,-21.0,5701.58,0.0,103.0,           ,0.0,1.0,1.0
4451,Saastot_sijoitukset,2019-12-12 06:32:43.636363636,2019-12-12,2019-12-12,2019-12-12,5.0,-67.28,5634.3,0.0,162.0,           ,1.0,1.0,123.0
4452,Tulot,2019-12-17 21:49:05.454545454,2019-12-17,2019-12-17,2019-12-17,5.0,247.08,5881.38,0.0,505.0,           ,1.0,1.0,208.0
4453,Liikkuminen,2019-12-23 13:05:27.272727272,2019-12-23,2019-12-23,2019-12-23,5.0,-82.6,5798.78,0.0,162.0,           ,1.0,1.0,47.0
4454,Kulttuuri_viihde,2019-12-30 04:21:49.090909090,2019-12-30,2019-12-30,2019-12-30,5.0,-21.35,5777.43,0.0,162.0,           ,1.0,1.0,114.0
4455,Ruoka_paivittaistavarakauppa,2020-01-02 12:17:33.658536585,2020-01-02,2020-01-02,2020-01-02,5.0,-141.12,5636.31,0.0,162.0,           ,1.0,1.0,133.0
4456,Ruoka_paivittaistavarakauppa,2020-01-03 00:35:07.317073170,2020-01-03,2020-01-03,2020-01-03,5.0,-9.48,5626.83,0.0,162.0,           ,1.0,1.0,185.0
4457,Luokittelemattomat,2020-01-06 12:52:40.975609755,2020-01-06,2020-01-07,2020-01-06,5.0,-24.43,5602.4,0.0,162.0,           ,1.0,1.0,114.0
4458,Ruoka_paivittaistavarakauppa,2020-01-06 13:27:48.292682925,2020-01-06,2020-01-06,2020-01-06,5.0,-5.24,5597.16,0.0,162.0,           ,1.0,1.0,125.0
4459,Tulot,2020-01-07 01:10:14.634146340,2020-01-07,2020-01-07,2020-01-07,5.0,6.73,5603.89,710.0,588.0,           ,0.0,1.0,267.0
4460,Terveys,2020-01-09 01:45:21.951219510,2020-01-09,2020-01-09,2020-01-09,5.0,-23.86,5580.03,0.0,162.0,           ,1.0,1.0,94.0
4461,Tulot,2020-01-13 02:20:29.268292680,2020-01-13,2020-01-13,2020-01-13,5.0,202.42,5782.45,0.0,505.0,           ,1.0,1.0,209.0
4462,Ruoka_paivittaistavarakauppa,2020-01-13 14:02:55.609756095,2020-01-13,2020-01-14,2020-01-13,5.0,-55.75,5726.7,0.0,162.0,           ,1.0,1.0,47.0
4463,Liikkuminen,2020-01-13 14:38:02.926829265,2020-01-13,2020-01-13,2020-01-13,5.0,-24.02,5702.68,0.0,162.0,           ,1.0,1.0,174.0
4464,Ravintolat_kahvilat,2020-01-16 02:55:36.585365850,2020-01-16,2020-01-16,2020-01-16,5.0,-2.4,5700.28,0.0,162.0,           ,1.0,1.0,48.0
4465,Ravintolat_kahvilat,2020-01-17 15:13:10.243902435,2020-01-17,2020-01-17,2020-01-17,5.0,-11.22,5689.06,0.0,162.0,           ,1.0,1.0,145.0
4466,Ruoka_paivittaistavarakauppa,2020-01-20 03:30:43.902439020,2020-01-20,2020-01-22,2020-01-20,5.0,-15.26,5673.8,0.0,162.0,           ,1.0,1.0,185.0
4467,Hyvinvointijakauneus,2020-01-20 15:48:17.560975605,2020-01-20,2020-01-20,2020-01-20,5.0,-34.61,5639.19,0.0,162.0,           ,1.0,1.0,105.0
4468,Muut,2020-01-22 04:05:51.219512190,2020-01-22,2020-01-22,2020-01-22,5.0,-4.05,5635.14,0.0,103.0,           ,0.0,1.0,1.0
4469,Ruoka_paivittaistavarakauppa,2020-01-23 16:23:24.878048775,2020-01-23,2020-01-23,2020-01-23,5.0,-123.43,5511.71,0.0,162.0,           ,1.0,1.0,131.0
4470,Muut,2020-01-24 04:40:58.536585360,2020-01-24,2020-01-24,2020-01-24,5.0,-270.9,5240.81,0.0,129.0,OKOYFIHH   ,0.0,0.0,44.0
4471,Matkailu,2020-01-26 16:58:32.195121945,2020-01-26,2020-01-26,2020-01-26,5.0,-600.44,4640.37,0.0,106.0,NDEAFIHH   ,1.0,0.0,33.0
4472,Luokittelemattomat,2020-01-27 05:16:05.853658530,2020-01-27,2020-01-27,2020-01-27,5.0,-89.18,4551.19,0.0,106.0,NDEAFIHH   ,1.0,0.0,41.0
4473,Kulttuuri_viihde,2020-01-29 17:33:39.512195115,2020-01-29,2020-01-29,2020-01-29,5.0,-19.61,4531.58,0.0,106.0,OKOYFIHH   ,0.0,0.0,16.0
4474,Muut,2020-01-31 05:51:13.170731700,2020-01-31,2020-01-31,2020-01-31,5.0,-46.69,4484.89,0.0,105.0,OKOYFIHH   ,1.0,0.0,3.0
4475,Tulot,2020-02-03 03:33:20.000000000,2020-02-03,2020-02-03,2020-02-03,5.0,176.18,4661.07,0.0,505.0,           ,1.0,1.0,209.0
4476,Luokittelemattomat,2020-02-05 07:06:40.000000000,2020-02-05,2020-02-05,2020-02-05,5.0,-20.77,4640.3,0.0,106.0,OKOYFIHH   ,0.0,0.0,14.0
4477,Luokittelemattomat,2020-02-07 10:40:00.000000000,2020-02-07,2020-02-07,2020-02-07,5.0,-95.9,4544.4,0.0,106.0,ITELFIHH   ,1.0,0.0,11.0
4478,Kulttuuri_viihde,2020-02-10 14:13:20.000000000,2020-02-10,2020-02-10,2020-02-10,5.0,-283.4,4261.0,0.0,106.0,HANDFIHH   ,1.0,0.0,27.0
4479,Tulot,2020-02-11 17:46:40.000000000,2020-02-11,2020-02-13,2020-02-11,5.0,1080.12,5341.12,710.0,506.0,           ,1.0,1.0,264.0
4480,Asuminen,2020-02-17 00:53:20.000000000,2020-02-17,2020-02-17,2020-02-17,5.0,-52.24,5288.88,0.0,162.0,           ,1.0,1.0,149.0
4481,Ruoka_paivittaistavarakauppa,2020-02-17 21:20:00.000000000,2020-02-17,2020-02-17,2020-02-17,5.0,-221.81,5067.07,0.0,103.0,           ,0.0,1.0,1.0
4482,Liikkuminen,2020-02-18 04:26:40.000000000,2020-02-18,2020-02-18,2020-02-18,5.0,-3.88,5063.19,0.0,162.0,           ,1.0,1.0,79.0
4483,Luokittelemattomat,2020-02-20 08:00:00.000000000,2020-02-20,2020-02-20,2020-02-20,5.0,-34.98,5028.21,0.0,162.0,           ,1.0,1.0,154.0
4484,Lapset,2020-02-24 11:33:20.000000000,2020-02-24,2020-02-24,2020-02-24,5.0,-16.92,5011.29,0.0,162.0,           ,1.0,1.0,120.0
4485,Ruoka_paivittaistavarakauppa,2020-02-24 15:06:40.000000000,2020-02-24,2020-02-24,2020-02-24,5.0,-2.07,5009.22,0.0,162.0,           ,1.0,1.0,127.0
4486,Ruoka_paivittaistavarakauppa,2020-02-26 18:40:00.000000000,2020-02-26,2020-02-26,2020-02-26,5.0,-6.59,5002.63,0.0,162.0,           ,1.0,1.0,79.0
4487,Ruoka_paivittaistavarakauppa,2020-02-27 22:13:20.000000000,2020-02-27,2020-02-27,2020-02-27,5.0,-74.13,4928.5,0.0,162.0,           ,1.0,1.0,101.0
4488,Tulot,2020-03-02 06:40:49.484536082,2020-03-02,2020-03-02,2020-03-02,5.0,16.28,4944.78,0.0,505.0,           ,1.0,1.0,208.0
4489,Luokittelemattomat,2020-03-02 15:20:24.742268041,2020-03-02,2020-03-02,2020-03-02,5.0,-32.63,4912.15,0.0,162.0,           ,1.0,1.0,97.0
4490,Shoppailu,2020-03-02 22:01:14.226804123,2020-03-02,2020-03-02,2020-03-02,5.0,-171.26,4740.89,0.0,162.0,           ,1.0,1.0,111.0
4491,Tulot,2020-03-03 13:21:38.969072164,2020-03-03,2020-03-03,2020-03-03,5.0,192.81,4933.7,710.0,506.0,           ,1.0,1.0,266.0
4492,Hyvinvointi,2020-03-04 04:42:03.711340205,2020-03-04,2020-03-04,2020-03-04,5.0,-17.69,4916.01,0.0,162.0,           ,1.0,1.0,93.0
4493,Ruoka_paivittaistavarakauppa,2020-03-04 20:02:28.453608246,2020-03-04,2020-03-04,2020-03-04,5.0,-85.42,4830.59,0.0,162.0,           ,1.0,1.0,119.0
4494,Kulttuuri_viihde,2020-03-05 11:22:53.195876287,2020-03-05,2020-03-05,2020-03-05,5.0,-23.15,4807.44,0.0,162.0,           ,1.0,1.0,71.0
4495,Luokittelemattomat,2020-03-06 02:43:17.938144328,2020-03-06,2020-03-06,2020-03-06,5.0,-34.34,4773.1,0.0,106.0,OKOYFIHH   ,1.0,0.0,9.0
4496,Luokittelemattomat,2020-03-06 18:03:42.680412369,2020-03-06,2020-03-06,2020-03-06,5.0,-1702.51,3070.59,0.0,106.0,OKOYFIHH   ,1.0,0.0,27.0
4497,Luokittelemattomat,2020-03-07 09:24:07.422680410,2020-03-07,2020-03-07,2020-03-07,5.0,-1229.77,1840.82,0.0,106.0,OKOYFIHH   ,1.0,0.0,10.0
4498,Tulot,2020-03-08 16:04:56.907216492,2020-03-08,2020-03-08,2020-03-08,5.0,621.95,2462.77,0.0,505.0,           ,1.0,1.0,208.0
4499,Hyvinvointijakauneus,2020-03-09 00:44:32.164948451,2020-03-09,2020-03-09,2020-03-09,5.0,-17.16,2445.61,0.0,162.0,           ,1.0,1.0,142.0
4500,Asuminen,2020-03-09 07:25:21.649484533,2020-03-09,2020-03-09,2020-03-09,5.0,-17.9,2427.71,0.0,106.0,OKOYFIHH   ,0.0,0.0,43.0
4501,Luokittelemattomat,2020-03-09 22:45:46.391752574,2020-03-09,2020-03-09,2020-03-09,5.0,-35.62,2392.09,0.0,106.0,OKOYFIHH   ,1.0,0.0,20.0
4502,Muut,2020-03-10 14:06:11.134020615,2020-03-10,2020-03-10,2020-03-10,5.0,-0.84,2391.25,0.0,103.0,           ,0.0,1.0,1.0
4503,Liikkuminen,2020-03-10 20:47:00.618556697,2020-03-10,2020-03-10,2020-03-10,5.0,-54.55,2336.7,0.0,162.0,           ,1.0,1.0,161.0
4504,Ruoka_paivittaistavarakauppa,2020-03-11 05:26:35.876288656,2020-03-11,2020-03-11,2020-03-11,5.0,-3.67,2333.03,0.0,162.0,           ,1.0,1.0,47.0
4505,Ravintolat_kahvilat,2020-03-12 12:07:25.360824738,2020-03-12,2020-03-12,2020-03-12,5.0,-29.59,2303.44,0.0,162.0,           ,1.0,1.0,175.0
4506,Saastot_sijoitukset,2020-03-13 01:29:04.329896902,2020-03-13,2020-03-13,2020-03-13,5.0,-24.62,2278.82,0.0,106.0,OKOYFIHH   ,0.0,0.0,10.0
4507,Ruoka_paivittaistavarakauppa,2020-03-13 03:27:50.103092779,2020-03-13,2020-03-13,2020-03-13,5.0,-14.67,2264.15,0.0,162.0,           ,1.0,1.0,134.0
4508,Ravintolat_kahvilat,2020-03-13 18:48:14.845360820,2020-03-13,2020-03-13,2020-03-13,5.0,-2.31,2261.84,0.0,162.0,           ,1.0,1.0,164.0
4509,Ruoka_paivittaistavarakauppa,2020-03-14 10:08:39.587628861,2020-03-14,2020-03-14,2020-03-14,5.0,-136.53,2125.31,0.0,106.0,DABAFIHH   ,0.0,0.0,13.0
4510,Lemmikit,2020-03-15 14:50:43.298969066,2020-03-15,2020-03-15,2020-03-15,5.0,-83.93,2041.38,0.0,106.0,OKOYFIHH   ,0.0,0.0,20.0
4511,Asuminen,2020-03-16 08:09:53.814432984,2020-03-16,2020-03-16,2020-03-16,5.0,-12.94,2028.44,0.0,106.0,OKOYFIHH   ,0.0,0.0,10.0
4512,Hyvinvointijakauneus,2020-03-16 16:49:29.072164943,2020-03-16,2020-03-16,2020-03-16,5.0,-19.01,2009.43,0.0,106.0,OKOYFIHH   ,0.0,0.0,42.0
4513,Ruoka_paivittaistavarakauppa,2020-03-16 23:30:18.556701025,2020-03-16,2020-03-16,2020-03-16,5.0,-38.33,1971.1,0.0,162.0,           ,1.0,1.0,74.0
4514,Lemmikit,2020-03-17 06:11:08.041237107,2020-03-17,2020-03-17,2020-03-17,5.0,-15.94,1955.16,0.0,106.0,OKOYFIHH   ,1.0,0.0,33.0
4515,Asuminen,2020-03-19 21:31:32.783505148,2020-03-19,2020-03-19,2020-03-19,5.0,-319.8,1635.36,0.0,106.0,NDEAFIHH   ,0.0,0.0,16.0
4516,Tulot,2020-03-20 02:13:36.494845353,2020-03-20,2020-03-20,2020-03-20,5.0,1429.1,3064.46,710.0,506.0,           ,1.0,1.0,262.0
4517,Ruoka_paivittaistavarakauppa,2020-03-20 04:12:22.268041230,2020-03-20,2020-03-20,2020-03-20,5.0,-8.61,3055.85,0.0,162.0,           ,1.0,1.0,173.0
4518,Liikkuminen,2020-03-20 10:53:11.752577312,2020-03-20,2020-03-20,2020-03-20,5.0,-30.48,3025.37,0.0,162.0,           ,1.0,1.0,101.0
4519,Luokittelemattomat,2020-03-20 12:51:57.525773189,2020-03-20,2020-03-20,2020-03-20,5.0,-67.83,2957.54,0.0,106.0,OKOYFIHH   ,1.0,0.0,29.0
4520,Ravintolat_kahvilat,2020-03-20 19:32:47.010309271,2020-03-20,2020-03-20,2020-03-20,5.0,-14.92,2942.62,0.0,162.0,           ,1.0,1.0,164.0
4521,Ruoka_paivittaistavarakauppa,2020-03-23 00:14:50.721649476,2020-03-23,2020-03-23,2020-03-23,5.0,-2.14,2940.48,0.0,162.0,           ,1.0,1.0,126.0
4522,Liikkuminen,2020-03-23 08:54:25.979381435,2020-03-23,2020-03-27,2020-03-23,5.0,-125.28,2815.2,0.0,162.0,           ,1.0,1.0,130.0
4523,Saastot_sijoitukset,2020-03-23 15:35:15.463917517,2020-03-23,2020-03-23,2020-03-23,5.0,-8.94,2806.26,0.0,162.0,           ,1.0,1.0,77.0
4524,Ravintolat_kahvilat,2020-03-23 17:34:01.237113394,2020-03-23,2020-03-23,2020-03-23,5.0,-6.2,2800.06,0.0,162.0,           ,1.0,1.0,132.0
4525,Muut,2020-03-23 22:16:04.948453599,2020-03-23,2020-03-23,2020-03-23,5.0,-38.08,2761.98,0.0,106.0,OKOYFIHH   ,0.0,0.0,40.0
4526,Ruoka_paivittaistavarakauppa,2020-03-24 06:55:40.206185558,2020-03-24,2020-03-26,2020-03-24,5.0,-45.7,2716.28,0.0,162.0,           ,1.0,1.0,172.0
4527,Tulot,2020-03-26 13:36:29.690721640,2020-03-26,2020-03-26,2020-03-26,5.0,700.93,3417.21,0.0,505.0,           ,1.0,1.0,209.0
4528,Ravintolat_kahvilat,2020-03-27 04:56:54.432989681,2020-03-27,2020-03-27,2020-03-27,5.0,-3.27,3413.94,0.0,162.0,           ,1.0,1.0,185.0
4529,Ruoka_paivittaistavarakauppa,2020-03-27 11:37:43.917525763,2020-03-27,2020-03-27,2020-03-27,5.0,-22.61,3391.33,0.0,162.0,           ,1.0,1.0,117.0
4530,Liikkuminen,2020-03-27 20:17:19.175257722,2020-03-27,2020-03-27,2020-03-27,5.0,-2.22,3389.11,0.0,162.0,           ,1.0,1.0,111.0
4531,Ruoka_paivittaistavarakauppa,2020-03-30 00:59:22.886597927,2020-03-30,2020-03-30,2020-03-30,5.0,-6.46,3382.65,0.0,162.0,           ,1.0,1.0,107.0
4532,Luottojen_maksut,2020-03-30 02:58:08.659793804,2020-03-30,2020-04-01,2020-03-30,5.0,-384.69,2997.96,706.0,106.0,OKOYFIHH   ,1.0,0.0,248.0
4533,Muut,2020-03-30 09:38:58.144329886,2020-03-30,2020-03-30,2020-03-30,5.0,-16.78,2981.18,0.0,162.0,           ,1.0,1.0,107.0
4534,Ruoka_paivittaistavarakauppa,2020-03-30 16:19:47.628865968,2020-03-30,2020-03-30,2020-03-30,5.0,-1.46,2979.72,0.0,162.0,           ,1.0,1.0,109.0
4535,Ruoka_paivittaistavarakauppa,2020-03-30 18:18:33.402061845,2020-03-30,2020-03-30,2020-03-30,5.0,-25.55,2954.17,0.0,162.0,           ,1.0,1.0,178.0
4536,Lemmikit,2020-04-01 16:10:47.191011235,2020-04-01,2020-04-03,2020-04-01,5.0,-75.76,2878.41,0.0,162.0,           ,1.0,1.0,132.0
4537,Terveys,2020-04-02 08:21:34.382022470,2020-04-02,2020-04-02,2020-04-02,5.0,-3.86,2874.55,0.0,162.0,           ,1.0,1.0,127.0
4538,Saastot_sijoitukset,2020-04-03 00:32:21.573033705,2020-04-03,2020-04-03,2020-04-03,5.0,-19.26,2855.29,0.0,162.0,           ,1.0,1.0,174.0
4539,Ruoka_paivittaistavarakauppa,2020-04-03 08:53:55.955056175,2020-04-03,2020-04-03,2020-04-03,5.0,-6.48,2848.81,0.0,162.0,           ,1.0,1.0,120.0
4540,Ravintolat_kahvilat,2020-04-03 16:43:08.764044940,2020-04-03,2020-04-03,2020-04-03,5.0,-51.93,2796.88,0.0,162.0,           ,1.0,1.0,115.0
4541,Muut,2020-04-06 01:04:43.146067410,2020-04-06,2020-04-07,2020-04-06,5.0,-188.27,2608.61,0.0,162.0,           ,1.0,1.0,176.0
4542,Tulot,2020-04-06 09:26:17.528089880,2020-04-06,2020-04-06,2020-04-06,5.0,0.4,2609.01,710.0,588.0,           ,0.0,1.0,268.0
4543,Ruoka_paivittaistavarakauppa,2020-04-06 17:15:30.337078645,2020-04-06,2020-04-06,2020-04-06,5.0,-5.72,2603.29,0.0,162.0,           ,1.0,1.0,74.0
4544,Ravintolat_kahvilat,2020-04-07 01:37:04.719101115,2020-04-07,2020-04-07,2020-04-07,5.0,-44.27,2559.02,0.0,162.0,           ,1.0,1.0,109.0
4545,Ravintolat_kahvilat,2020-04-07 09:58:39.101123585,2020-04-07,2020-04-07,2020-04-07,5.0,-57.57,2501.45,0.0,106.0,OKOYFIHH   ,0.0,0.0,43.0
4546,Muut,2020-04-07 17:47:51.910112350,2020-04-07,2020-04-07,2020-04-07,5.0,-138.9,2362.55,0.0,162.0,           ,1.0,1.0,177.0
4547,Muut,2020-04-09 02:09:26.292134820,2020-04-09,2020-04-09,2020-04-09,5.0,-135.31,2227.24,0.0,163.0,           ,1.0,1.0,196.0
4548,Luokittelemattomat,2020-04-09 18:20:13.483146055,2020-04-09,2020-04-09,2020-04-09,5.0,-15.92,2211.32,0.0,162.0,           ,1.0,1.0,93.0
4549,Luottojen_maksut,2020-04-10 02:41:47.865168525,2020-04-10,2020-04-10,2020-04-10,5.0,-10.4,2200.92,0.0,106.0,OKOYFIHH   ,0.0,0.0,16.0
4550,Muut,2020-04-10 10:31:00.674157290,2020-04-10,2020-04-10,2020-04-10,5.0,-189.78,2011.14,706.0,129.0,SBANFIHH   ,0.0,0.0,250.0
4551,Liikkuminen,2020-04-10 11:03:22.247190995,2020-04-10,2020-04-10,2020-04-10,5.0,-116.96,1894.18,0.0,162.0,           ,1.0,1.0,115.0
4552,Ruoka_paivittaistavarakauppa,2020-04-13 03:14:09.438202230,2020-04-13,2020-04-13,2020-04-13,5.0,-28.1,1866.08,0.0,162.0,           ,1.0,1.0,101.0
4553,Ruoka_paivittaistavarakauppa,2020-04-13 18:52:35.056179760,2020-04-13,2020-04-13,2020-04-13,5.0,-16.79,1849.29,0.0,162.0,           ,1.0,1.0,107.0
4554,Liikkuminen,2020-04-13 19:24:56.629213465,2020-04-13,2020-04-13,2020-04-13,5.0,-75.75,1773.54,0.0,162.0,           ,1.0,1.0,120.0
4555,Ruoka_paivittaistavarakauppa,2020-04-14 03:46:31.011235935,2020-04-14,2020-04-14,2020-04-14,5.0,-6.6,1766.94,0.0,162.0,           ,1.0,1.0,150.0
4556,Asuminen,2020-04-15 11:35:43.820224700,2020-04-15,2020-04-15,2020-04-15,5.0,-49.74,1717.2,706.0,106.0,DABAFIHH   ,0.0,0.0,246.0
4557,Lemmikit,2020-04-15 19:57:18.202247170,2020-04-15,2020-04-15,2020-04-15,5.0,-26.09,1691.11,0.0,106.0,OKOYFIHH   ,0.0,0.0,36.0
4558,Luokittelemattomat,2020-04-16 12:08:05.393258405,2020-04-16,2020-04-17,2020-04-16,5.0,-8.03,1683.08,0.0,162.0,           ,1.0,1.0,157.0
4559,Ruoka_paivittaistavarakauppa,2020-04-16 20:29:39.775280875,2020-04-16,2020-04-16,2020-04-16,5.0,-15.65,1667.43,0.0,162.0,           ,1.0,1.0,135.0
4560,Liikkuminen,2020-04-17 04:18:52.584269640,2020-04-17,2020-04-17,2020-04-17,5.0,-38.08,1629.35,0.0,162.0,           ,1.0,1.0,145.0
4561,Ruoka_paivittaistavarakauppa,2020-04-17 12:40:26.966292110,2020-04-17,2020-04-17,2020-04-17,5.0,-26.12,1603.23,0.0,162.0,           ,1.0,1.0,112.0
4562,Asuminen,2020-04-17 21:02:01.348314580,2020-04-17,2020-04-17,2020-04-17,5.0,-74.45,1528.78,706.0,129.0,NDEAFIHH   ,0.0,0.0,254.0
4563,Muut,2020-04-18 21:34:22.921348285,2020-04-18,2020-04-18,2020-04-18,5.0,-78.37,1450.41,0.0,163.0,           ,1.0,1.0,195.0
4564,Tulot,2020-04-20 04:51:14.157303345,2020-04-20,2020-04-20,2020-04-20,5.0,741.8,2192.21,701.0,510.0,           ,1.0,1.0,234.0
4565,Luokittelemattomat,2020-04-20 13:12:48.539325815,2020-04-20,2020-04-20,2020-04-20,5.0,-82.7,2109.51,706.0,106.0,NDEAFIHH   ,0.0,0.0,247.0
4566,Ruoka_paivittaistavarakauppa,2020-04-21 05:23:35.730337050,2020-04-21,2020-04-21,2020-04-21,5.0,-4.67,2104.84,0.0,162.0,           ,1.0,1.0,153.0
4567,Ruoka_paivittaistavarakauppa,2020-04-22 13:45:10.112359520,2020-04-22,2020-04-22,2020-04-22,5.0,-8.02,2096.82,0.0,162.0,           ,1.0,1.0,129.0
4568,Ruoka_paivittaistavarakauppa,2020-04-23 22:06:44.494381990,2020-04-23,2020-04-23,2020-04-23,5.0,-5.31,2091.51,0.0,162.0,           ,1.0,1.0,138.0
4569,Ruoka_paivittaistavarakauppa,2020-04-23 22:39:06.067415695,2020-04-23,2020-04-23,2020-04-23,5.0,-41.8,2049.71,0.0,162.0,           ,1.0,1.0,107.0
4570,Liikkuminen,2020-04-24 05:55:57.303370755,2020-04-24,2020-04-24,2020-04-24,5.0,-79.97,1969.74,0.0,162.0,           ,1.0,1.0,123.0
4571,Ravintolat_kahvilat,2020-04-24 14:17:31.685393225,2020-04-24,2020-04-24,2020-04-24,5.0,-106.44,1863.3,0.0,162.0,           ,1.0,1.0,97.0
4572,Ravintolat_kahvilat,2020-04-24 14:49:53.258426930,2020-04-24,2020-04-24,2020-04-24,5.0,-13.02,1850.28,0.0,162.0,           ,1.0,1.0,74.0
4573,Saastot_sijoitukset,2020-04-27 06:28:18.876404460,2020-04-27,2020-04-28,2020-04-27,5.0,-55.09,1795.19,0.0,162.0,           ,1.0,1.0,114.0
4574,Luokittelemattomat,2020-04-27 07:00:40.449438165,2020-04-27,2020-04-27,2020-04-27,5.0,-8.84,1786.35,0.0,162.0,           ,1.0,1.0,162.0
4575,Hyvinvointijakauneus,2020-04-27 07:33:02.022471870,2020-04-27,2020-04-27,2020-04-27,5.0,-4.55,1781.8,0.0,162.0,           ,1.0,1.0,164.0
4576,Hyvinvointijakauneus,2020-04-27 15:22:14.831460635,2020-04-27,2020-04-27,2020-04-27,5.0,-19.14,1762.66,0.0,162.0,           ,1.0,1.0,118.0
4577,Ruoka_paivittaistavarakauppa,2020-04-27 23:11:27.640449400,2020-04-27,2020-04-27,2020-04-27,5.0,-14.32,1748.34,0.0,162.0,           ,1.0,1.0,151.0
4578,Luokittelemattomat,2020-04-29 23:43:49.213483105,2020-04-29,2020-04-29,2020-04-29,5.0,-4.61,1743.73,0.0,162.0,           ,1.0,1.0,183.0
4579,Tulot,2020-04-30 15:54:36.404494340,2020-04-30,2020-04-30,2020-04-30,5.0,364.68,2108.41,701.0,506.0,           ,1.0,1.0,231.0
4580,Asuminen,2020-05-01 10:36:16.744186044,2020-05-01,2020-05-01,2020-05-01,5.0,-57.46,2050.95,706.0,106.0,NDEAFIHH   ,0.0,0.0,245.0
4581,Muut,2020-05-01 11:32:05.581395348,2020-05-01,2020-05-01,2020-05-01,5.0,-21.92,2029.03,0.0,162.0,           ,1.0,1.0,84.0
4582,Harrastukset,2020-05-01 22:08:22.325581392,2020-05-01,2020-05-01,2020-05-01,5.0,-213.82,1815.21,0.0,162.0,           ,1.0,1.0,174.0
4583,Lemmikit,2020-05-01 23:04:11.162790696,2020-05-01,2020-05-01,2020-05-01,5.0,-9.85,1805.36,0.0,162.0,           ,1.0,1.0,114.0
4584,Luottojen_maksut,2020-05-04 08:44:39.069767436,2020-05-04,2020-05-04,2020-05-04,5.0,-42.45,1762.91,0.0,106.0,NDEAFIHH   ,1.0,0.0,13.0
4585,Ruoka_paivittaistavarakauppa,2020-05-04 20:16:44.651162784,2020-05-04,2020-05-04,2020-05-04,5.0,-3.96,1758.95,0.0,162.0,           ,1.0,1.0,46.0
4586,Hyvinvointijakauneus,2020-05-04 21:12:33.488372088,2020-05-04,2020-05-04,2020-05-04,5.0,-2.32,1756.63,0.0,162.0,           ,1.0,1.0,140.0
4587,Ravintolat_kahvilat,2020-05-05 07:48:50.232558132,2020-05-05,2020-05-05,2020-05-05,5.0,-3.25,1753.38,0.0,162.0,           ,1.0,1.0,131.0
4588,Liikkuminen,2020-05-05 09:40:27.906976740,2020-05-05,2020-05-05,2020-05-05,5.0,-62.24,1691.14,0.0,162.0,           ,1.0,1.0,121.0
4589,Hyvinvointijakauneus,2020-05-05 19:20:55.813953480,2020-05-05,2020-05-05,2020-05-05,5.0,-14.3,1676.84,0.0,162.0,           ,1.0,1.0,166.0
4590,Asuminen,2020-05-06 06:53:01.395348828,2020-05-06,2020-05-06,2020-05-06,5.0,-12.8,1664.04,0.0,162.0,           ,1.0,1.0,131.0
4591,Tulot,2020-05-06 17:29:18.139534872,2020-05-06,2020-05-06,2020-05-06,5.0,1294.27,2958.31,701.0,506.0,           ,1.0,1.0,230.0
4592,Muut,2020-05-06 18:25:06.976744176,2020-05-06,2020-05-06,2020-05-06,5.0,-850.03,2108.28,0.0,163.0,           ,1.0,1.0,194.0
4593,Ravintolat_kahvilat,2020-05-07 05:57:12.558139524,2020-05-07,2020-05-07,2020-05-07,5.0,-5.08,2103.2,0.0,162.0,           ,1.0,1.0,157.0
4594,Hyvinvointijakauneus,2020-05-08 04:05:34.883720916,2020-05-08,2020-05-08,2020-05-08,5.0,-6.43,2096.77,0.0,162.0,           ,1.0,1.0,133.0
4595,Liikkuminen,2020-05-08 05:01:23.720930220,2020-05-08,2020-05-08,2020-05-08,5.0,-37.68,2059.09,0.0,162.0,           ,1.0,1.0,153.0
4596,Liikkuminen,2020-05-08 16:33:29.302325568,2020-05-08,2020-05-08,2020-05-08,5.0,-5.44,2053.65,0.0,162.0,           ,1.0,1.0,107.0
4597,Lemmikit,2020-05-11 02:13:57.209302308,2020-05-11,2020-05-11,2020-05-11,5.0,-5.22,2048.43,0.0,162.0,           ,1.0,1.0,125.0
4598,Ruoka_paivittaistavarakauppa,2020-05-11 03:09:46.046511612,2020-05-11,2020-05-11,2020-05-11,5.0,-133.25,1915.18,0.0,162.0,           ,1.0,1.0,129.0
4599,Ruoka_paivittaistavarakauppa,2020-05-11 13:46:02.790697656,2020-05-11,2020-05-11,2020-05-11,5.0,-45.29,1869.89,0.0,162.0,           ,1.0,1.0,181.0
4600,Liikkuminen,2020-05-11 14:41:51.627906960,2020-05-11,2020-05-11,2020-05-11,5.0,-40.9,1828.99,0.0,162.0,           ,1.0,1.0,134.0
4601,Ruoka_paivittaistavarakauppa,2020-05-11 15:37:40.465116264,2020-05-11,2020-05-11,2020-05-11,5.0,-11.03,1817.96,0.0,162.0,           ,1.0,1.0,105.0
4602,Ruoka_paivittaistavarakauppa,2020-05-12 01:18:08.372093004,2020-05-12,2020-05-14,2020-05-12,5.0,-28.24,1789.72,0.0,162.0,           ,1.0,1.0,114.0
4603,Ruoka_paivittaistavarakauppa,2020-05-12 11:54:25.116279048,2020-05-12,2020-05-12,2020-05-12,5.0,-24.46,1765.26,0.0,162.0,           ,1.0,1.0,111.0
4604,Ravintolat_kahvilat,2020-05-12 12:50:13.953488352,2020-05-12,2020-05-12,2020-05-12,5.0,-38.78,1726.48,0.0,162.0,           ,1.0,1.0,48.0
4605,Ruoka_paivittaistavarakauppa,2020-05-12 23:26:30.697674396,2020-05-12,2020-05-12,2020-05-12,5.0,-23.16,1703.32,0.0,162.0,           ,1.0,1.0,133.0
4606,Liikkuminen,2020-05-13 00:22:19.534883700,2020-05-13,2020-05-13,2020-05-12,5.0,-16.49,1686.83,0.0,162.0,           ,1.0,1.0,150.0
4607,Ruoka_paivittaistavarakauppa,2020-05-13 10:02:47.441860440,2020-05-13,2020-05-13,2020-05-13,5.0,-16.31,1670.52,0.0,162.0,           ,1.0,1.0,120.0
4608,Ruoka_paivittaistavarakauppa,2020-05-13 21:34:53.023255788,2020-05-13,2020-05-14,2020-05-13,5.0,-106.37,1564.15,0.0,162.0,           ,1.0,1.0,174.0
4609,Ruoka_paivittaistavarakauppa,2020-05-14 22:30:41.860465092,2020-05-14,2020-05-14,2020-05-14,5.0,-51.88,1512.27,0.0,162.0,           ,1.0,1.0,66.0
4610,Ruoka_paivittaistavarakauppa,2020-05-15 09:06:58.604651136,2020-05-15,2020-05-15,2020-05-15,5.0,-3.85,1508.42,0.0,162.0,           ,1.0,1.0,114.0
4611,Liikkuminen,2020-05-15 10:58:36.279069744,2020-05-15,2020-05-15,2020-05-15,5.0,-97.32,1411.1,0.0,162.0,           ,1.0,1.0,128.0
4612,Asuminen,2020-05-15 20:39:04.186046484,2020-05-15,2020-05-15,2020-05-15,5.0,-26.88,1384.22,0.0,162.0,           ,1.0,1.0,47.0
4613,Muut,2020-05-18 06:19:32.093023224,2020-05-18,2020-05-18,2020-05-18,5.0,-60.69,1323.53,0.0,163.0,           ,1.0,1.0,195.0
4614,Ruoka_paivittaistavarakauppa,2020-05-18 07:15:20.930232528,2020-05-18,2020-05-18,2020-05-18,5.0,-16.0,1307.53,0.0,162.0,           ,1.0,1.0,185.0
4615,Ruoka_paivittaistavarakauppa,2020-05-18 08:11:09.767441832,2020-05-18,2020-05-19,2020-05-18,5.0,-37.38,1270.15,0.0,162.0,           ,1.0,1.0,142.0
4616,Shoppailu,2020-05-18 16:55:48.837209268,2020-05-18,2020-05-19,2020-05-18,5.0,-216.91,1053.24,0.0,162.0,           ,1.0,1.0,46.0
4617,Tulot,2020-05-18 18:47:26.511627876,2020-05-18,2020-05-18,2020-05-18,5.0,338.37,1391.61,701.0,506.0,           ,1.0,1.0,230.0
4618,Liikkuminen,2020-05-18 19:43:15.348837180,2020-05-18,2020-05-18,2020-05-18,5.0,-4.58,1387.03,0.0,162.0,           ,1.0,1.0,103.0
4619,Ravintolat_kahvilat,2020-05-19 04:27:54.418604616,2020-05-19,2020-05-19,2020-05-19,5.0,-4.87,1382.16,0.0,162.0,           ,1.0,1.0,111.0
4620,Terveys,2020-05-19 05:23:43.255813920,2020-05-19,2020-05-19,2020-05-19,5.0,-16.85,1365.31,0.0,162.0,           ,1.0,1.0,185.0
4621,Ravintolat_kahvilat,2020-05-19 15:04:11.162790660,2020-05-19,2020-05-19,2020-05-19,5.0,-67.22,1298.09,0.0,103.0,           ,0.0,1.0,0.0
4622,Ruoka_paivittaistavarakauppa,2020-05-19 17:51:37.674418572,2020-05-19,2020-05-19,2020-05-19,5.0,-7.29,1290.8,0.0,162.0,           ,1.0,1.0,132.0
4623,Ruoka_paivittaistavarakauppa,2020-05-21 02:36:16.744186008,2020-05-21,2020-05-21,2020-05-21,5.0,-80.66,1210.14,0.0,162.0,           ,1.0,1.0,124.0
4624,Ravintolat_kahvilat,2020-05-22 03:32:05.581395312,2020-05-22,2020-05-22,2020-05-22,5.0,-2.9,1207.24,0.0,162.0,           ,1.0,1.0,109.0
4625,Ruoka_paivittaistavarakauppa,2020-05-22 14:08:22.325581356,2020-05-22,2020-05-22,2020-05-22,5.0,-12.6,1194.64,0.0,162.0,           ,1.0,1.0,101.0
4626,Ruoka_paivittaistavarakauppa,2020-05-22 15:59:59.999999964,2020-05-22,2020-05-22,2020-05-22,5.0,-9.5,1185.14,0.0,162.0,           ,1.0,1.0,131.0
4627,Tulot,2020-05-25 00:44:39.069767400,2020-05-25,2020-05-25,2020-05-25,5.0,32.69,1217.83,701.0,506.0,           ,1.0,1.0,230.0
4628,Liikkuminen,2020-05-25 01:40:27.906976704,2020-05-25,2020-05-25,2020-05-25,5.0,-12.97,1204.86,0.0,162.0,           ,1.0,1.0,105.0
4629,Ruoka_paivittaistavarakauppa,2020-05-25 12:16:44.651162748,2020-05-25,2020-05-25,2020-05-25,5.0,-6.58,1198.28,0.0,162.0,           ,1.0,1.0,135.0
4630,Ruoka_paivittaistavarakauppa,2020-05-25 13:12:33.488372052,2020-05-25,2020-05-27,2020-05-25,5.0,-11.74,1186.54,0.0,162.0,           ,1.0,1.0,150.0
4631,Luottojen_maksut,2020-05-25 23:48:50.232558096,2020-05-25,2020-05-25,2020-05-25,5.0,-39.53,1147.01,0.0,162.0,           ,1.0,1.0,124.0
4632,Ruoka_paivittaistavarakauppa,2020-05-26 11:20:55.813953444,2020-05-26,2020-05-26,2020-05-26,5.0,-24.49,1122.52,0.0,162.0,           ,1.0,1.0,171.0
4633,Ravintolat_kahvilat,2020-05-26 22:53:01.395348792,2020-05-26,2020-05-26,2020-05-26,5.0,-5.07,1117.45,0.0,162.0,           ,1.0,1.0,74.0
4634,Ravintolat_kahvilat,2020-05-27 10:25:06.976744140,2020-05-27,2020-05-27,2020-05-27,5.0,-19.82,1097.63,0.0,162.0,           ,1.0,1.0,68.0
4635,Ruoka_paivittaistavarakauppa,2020-05-27 21:57:12.558139488,2020-05-27,2020-05-27,2020-05-27,5.0,-58.41,1039.22,0.0,162.0,           ,1.0,1.0,185.0
4636,Ravintolat_kahvilat,2020-05-28 08:33:29.302325532,2020-05-28,2020-05-28,2020-05-27,5.0,-9.57,1029.65,0.0,162.0,           ,1.0,1.0,124.0
4637,Liikkuminen,2020-05-28 09:29:18.139534836,2020-05-28,2020-05-28,2020-05-28,5.0,-2.62,1027.03,0.0,162.0,           ,1.0,1.0,74.0
4638,Ruoka_paivittaistavarakauppa,2020-05-28 21:01:23.720930184,2020-05-28,2020-05-28,2020-05-25,5.0,-10.63,1016.4,0.0,162.0,           ,1.0,1.0,111.0
4639,Luokittelemattomat,2020-05-29 06:41:51.627906924,2020-05-29,2020-05-29,2020-05-29,5.0,-380.16,636.24,706.0,129.0,OKOYFIHH   ,0.0,0.0,250.0
4640,Ruoka_paivittaistavarakauppa,2020-05-29 07:37:40.465116228,2020-05-29,2020-05-29,2020-05-29,5.0,-20.42,615.82,0.0,162.0,           ,1.0,1.0,116.0
4641,Luottojen_maksut,2020-05-29 18:13:57.209302272,2020-05-29,2020-05-29,2020-05-29,5.0,-12.39,603.43,0.0,162.0,           ,1.0,1.0,144.0
4642,Ravintolat_kahvilat,2020-05-29 19:09:46.046511576,2020-05-29,2020-05-29,2020-05-29,5.0,-9.43,594.0,0.0,162.0,           ,1.0,1.0,127.0
4643,Ruoka_paivittaistavarakauppa,2020-05-29 20:05:34.883720880,2020-05-29,2020-05-29,2020-05-29,5.0,-92.66,501.34,0.0,162.0,           ,1.0,1.0,91.0
4644,Matkailu,2020-06-01 16:10:47.191011235,2020-06-01,2020-06-01,2020-06-01,5.0,-110.79,390.55,0.0,162.0,           ,1.0,1.0,155.0
4645,Tulot,2020-06-02 08:21:34.382022470,2020-06-02,2020-06-02,2020-06-02,5.0,-67.24,323.31,0.0,162.0,           ,1.0,1.0,166.0
4646,Ruoka_paivittaistavarakauppa,2020-06-03 00:32:21.573033705,2020-06-03,2020-06-03,2020-06-03,5.0,-17.94,305.37,0.0,162.0,           ,1.0,1.0,131.0
4647,Saastot_sijoitukset,2020-06-03 16:43:08.764044940,2020-06-03,2020-06-04,2020-06-03,5.0,-8.78,296.59,0.0,162.0,           ,1.0,1.0,135.0
4648,Asuminen,2020-06-05 01:04:43.146067410,2020-06-05,2020-06-05,2020-06-05,5.0,-17.46,279.13,0.0,106.0,OKOYFIHH   ,0.0,0.0,14.0
4649,Lapset,2020-06-05 01:37:04.719101115,2020-06-05,2020-06-05,2020-06-05,5.0,-10.42,268.71,0.0,106.0,OKOYFIHH   ,0.0,0.0,17.0
4650,Tulot,2020-06-05 08:53:55.955056175,2020-06-05,2020-06-05,2020-06-05,5.0,1076.49,1345.2,701.0,506.0,           ,1.0,1.0,230.0
4651,Asuminen,2020-06-05 17:15:30.337078645,2020-06-05,2020-06-05,2020-06-05,5.0,-30.65,1314.55,0.0,106.0,DABAFIHH   ,0.0,0.0,40.0
4652,Muut,2020-06-07 09:26:17.528089880,2020-06-07,2020-06-07,2020-06-07,5.0,-21.54,1293.01,0.0,106.0,OKOYFIHH   ,0.0,0.0,24.0
4653,Matkailu,2020-06-08 09:58:39.101123585,2020-06-08,2020-06-08,2020-06-08,5.0,-11.69,1281.32,706.0,129.0,OKOYFIHH   ,0.0,0.0,251.0
4654,Ruoka_paivittaistavarakauppa,2020-06-08 17:47:51.910112350,2020-06-08,2020-06-08,2020-06-08,5.0,-1.97,1279.35,0.0,162.0,           ,1.0,1.0,76.0
4655,Muut,2020-06-09 02:09:26.292134820,2020-06-09,2020-06-09,2020-06-09,5.0,-3.42,1275.93,0.0,162.0,           ,1.0,1.0,128.0
4656,Lemmikit,2020-06-09 18:20:13.483146055,2020-06-09,2020-06-09,2020-06-09,5.0,-54.41,1221.52,0.0,162.0,           ,1.0,1.0,185.0
4657,Ruoka_paivittaistavarakauppa,2020-06-10 10:31:00.674157290,2020-06-10,2020-06-10,2020-06-10,5.0,-24.73,1196.79,0.0,162.0,           ,1.0,1.0,127.0
4658,Ruoka_paivittaistavarakauppa,2020-06-11 02:41:47.865168525,2020-06-11,2020-06-11,2020-06-11,5.0,-6.93,1189.86,0.0,162.0,           ,1.0,1.0,74.0
4659,Ruoka_paivittaistavarakauppa,2020-06-12 11:03:22.247190995,2020-06-12,2020-06-12,2020-06-12,5.0,-8.38,1181.48,0.0,162.0,           ,1.0,1.0,111.0
4660,Vakuutukset,2020-06-12 18:52:35.056179760,2020-06-12,2020-06-12,2020-06-12,5.0,-521.29,660.19,706.0,129.0,OKOYFIHH   ,0.0,0.0,250.0
4661,Matkailu,2020-06-15 03:14:09.438202230,2020-06-15,2020-06-15,2020-06-15,5.0,-13.34,646.85,0.0,162.0,           ,1.0,1.0,185.0
4662,Ravintolat_kahvilat,2020-06-15 03:46:31.011235935,2020-06-15,2020-06-15,2020-06-15,5.0,-11.35,635.5,0.0,162.0,           ,1.0,1.0,172.0
4663,Tulot,2020-06-15 19:24:56.629213465,2020-06-15,2020-06-15,2020-06-15,5.0,1151.16,1786.66,701.0,506.0,           ,1.0,1.0,230.0
4664,Terveys,2020-06-15 19:57:18.202247170,2020-06-15,2020-06-15,2020-06-15,5.0,-14.06,1772.6,0.0,162.0,           ,1.0,1.0,171.0
4665,Ravintolat_kahvilat,2020-06-15 20:29:39.775280875,2020-06-15,2020-06-15,2020-06-15,5.0,-50.8,1721.8,0.0,162.0,           ,1.0,1.0,163.0
4666,Asuminen,2020-06-16 11:35:43.820224700,2020-06-16,2020-06-16,2020-06-16,5.0,-71.25,1650.55,0.0,106.0,OKOYFIHH   ,0.0,0.0,26.0
4667,Hyvinvointijakauneus,2020-06-16 12:08:05.393258405,2020-06-16,2020-06-16,2020-06-16,5.0,-441.05,1209.5,0.0,162.0,           ,1.0,1.0,120.0
4668,Liikkuminen,2020-06-17 04:18:52.584269640,2020-06-17,2020-06-17,2020-06-17,5.0,-6.3,1203.2,0.0,162.0,           ,1.0,1.0,119.0
4669,Ruoka_paivittaistavarakauppa,2020-06-18 12:40:26.966292110,2020-06-18,2020-06-18,2020-06-18,5.0,-35.65,1167.55,0.0,162.0,           ,1.0,1.0,104.0
4670,Liikkuminen,2020-06-19 04:51:14.157303345,2020-06-19,2020-06-19,2020-06-19,5.0,-9.71,1157.84,0.0,162.0,           ,1.0,1.0,136.0
4671,Ravintolat_kahvilat,2020-06-19 13:12:48.539325815,2020-06-19,2020-06-19,2020-06-19,5.0,-22.15,1135.69,0.0,162.0,           ,1.0,1.0,120.0
4672,Lapset,2020-06-19 21:02:01.348314580,2020-06-19,2020-06-19,2020-06-19,5.0,-5.52,1130.17,0.0,162.0,           ,1.0,1.0,115.0
4673,Tulot,2020-06-19 22:06:44.494381990,2020-06-19,2020-06-19,2020-06-19,5.0,237.2,1367.37,701.0,506.0,           ,1.0,1.0,232.0
4674,Luokittelemattomat,2020-06-22 05:23:35.730337050,2020-06-22,2020-06-22,2020-06-22,5.0,-307.22,1060.15,706.0,129.0,OKOYFIHH   ,0.0,0.0,250.0
4675,Luokittelemattomat,2020-06-22 13:45:10.112359520,2020-06-22,2020-06-22,2020-06-22,5.0,-4.38,1055.77,0.0,162.0,           ,1.0,1.0,185.0
4676,Terveys,2020-06-22 21:34:22.921348285,2020-06-22,2020-06-22,2020-06-22,5.0,-12.55,1043.22,0.0,162.0,           ,1.0,1.0,142.0
4677,Liikkuminen,2020-06-23 05:55:57.303370755,2020-06-23,2020-06-23,2020-06-23,5.0,-50.4,992.82,0.0,162.0,           ,1.0,1.0,101.0
4678,Matkailu,2020-06-25 07:00:40.449438165,2020-06-25,2020-06-25,2020-06-25,5.0,-52.42,940.4,0.0,162.0,           ,1.0,1.0,48.0
4679,Tulot,2020-06-25 14:17:31.685393225,2020-06-25,2020-06-25,2020-06-25,5.0,484.44,1424.84,701.0,506.0,           ,1.0,1.0,230.0
4680,Ruoka_paivittaistavarakauppa,2020-06-25 14:49:53.258426930,2020-06-25,2020-06-25,2020-06-25,5.0,-19.32,1405.52,0.0,162.0,           ,1.0,1.0,79.0
4681,Ruoka_paivittaistavarakauppa,2020-06-25 22:39:06.067415695,2020-06-25,2020-06-25,2020-06-25,5.0,-44.65,1360.87,0.0,162.0,           ,1.0,1.0,102.0
4682,Asuminen,2020-06-26 06:28:18.876404460,2020-06-26,2020-06-26,2020-06-26,5.0,-34.33,1326.54,0.0,162.0,           ,1.0,1.0,116.0
4683,Liikkuminen,2020-06-29 07:33:02.022471870,2020-06-29,2020-06-29,2020-06-29,5.0,-222.39,1104.15,706.0,129.0,OKOYFIHH   ,0.0,0.0,252.0
4684,Ruoka_paivittaistavarakauppa,2020-06-29 15:22:14.831460635,2020-06-29,2020-06-30,2020-06-29,5.0,-13.63,1090.52,0.0,162.0,           ,1.0,1.0,141.0
4685,Ruoka_paivittaistavarakauppa,2020-06-29 23:11:27.640449400,2020-06-29,2020-06-29,2020-06-29,5.0,-12.02,1078.5,0.0,162.0,           ,1.0,1.0,164.0
4686,Ruoka_paivittaistavarakauppa,2020-06-29 23:43:49.213483105,2020-06-29,2020-06-29,2020-06-29,5.0,-4.09,1074.41,0.0,162.0,           ,1.0,1.0,51.0
4687,Asuminen,2020-06-30 15:54:36.404494340,2020-06-30,2020-06-30,2020-06-30,5.0,-25.06,1049.35,706.0,129.0,OKOYFIHH   ,0.0,0.0,252.0
4688,Luokittelemattomat,2020-07-01 03:05:36.798336798,2020-07-01,2020-07-01,2020-07-01,5.0,-152.11,897.24,706.0,129.0,OKOYFIHH   ,0.0,0.0,249.0
4689,Ravintolat_kahvilat,2020-07-01 06:11:13.596673596,2020-07-01,2020-07-01,2020-07-01,5.0,-22.39,874.85,0.0,162.0,           ,1.0,1.0,166.0
4690,Muut,2020-07-01 12:22:27.193347192,2020-07-01,2020-07-01,2020-07-01,5.0,-19.27,855.58,0.0,106.0,OKOYFIHH   ,0.0,0.0,11.0
4691,Asuminen,2020-07-01 15:28:03.991683990,2020-07-01,2020-07-01,2020-07-01,5.0,-15.83,839.75,0.0,106.0,OKOYFIHH   ,0.0,0.0,39.0
4692,Muut,2020-07-02 00:44:54.386694384,2020-07-02,2020-07-03,2020-07-02,5.0,-97.32,742.43,0.0,163.0,           ,1.0,1.0,195.0
4693,Ruoka_paivittaistavarakauppa,2020-07-02 03:50:31.185031182,2020-07-02,2020-07-02,2020-07-02,5.0,-60.96,681.47,0.0,162.0,           ,1.0,1.0,185.0
4694,Luokittelemattomat,2020-07-02 06:56:07.983367980,2020-07-02,2020-07-02,2020-07-02,5.0,-4.15,677.32,0.0,162.0,           ,1.0,1.0,163.0
4695,Ruoka_paivittaistavarakauppa,2020-07-02 08:25:56.756756748,2020-07-02,2020-07-02,2020-07-02,5.0,-55.81,621.51,0.0,162.0,           ,1.0,1.0,84.0
4696,Ruoka_paivittaistavarakauppa,2020-07-02 09:16:50.395010394,2020-07-02,2020-07-02,2020-07-02,5.0,-7.06,614.45,0.0,162.0,           ,1.0,1.0,93.0
4697,Ruoka_paivittaistavarakauppa,2020-07-02 10:01:44.781704778,2020-07-02,2020-07-02,2020-07-02,5.0,-48.59,565.86,0.0,162.0,           ,1.0,1.0,89.0
4698,Ravintolat_kahvilat,2020-07-02 13:07:21.580041576,2020-07-02,2020-07-02,2020-07-02,5.0,-9.57,556.29,0.0,162.0,           ,1.0,1.0,129.0
4699,Ruoka_paivittaistavarakauppa,2020-07-02 16:12:58.378378374,2020-07-02,2020-07-02,2020-07-02,5.0,-4.81,551.48,0.0,162.0,           ,1.0,1.0,58.0
4700,Ruoka_paivittaistavarakauppa,2020-07-02 19:18:35.176715172,2020-07-02,2020-07-02,2020-07-02,5.0,-13.34,538.14,0.0,162.0,           ,1.0,1.0,131.0
4701,Ravintolat_kahvilat,2020-07-02 22:24:11.975051970,2020-07-02,2020-07-02,2020-07-02,5.0,-13.55,524.59,0.0,162.0,           ,1.0,1.0,93.0
4702,Tulot,2020-07-03 01:29:48.773388768,2020-07-03,2020-07-03,2020-07-03,5.0,906.99,1431.58,701.0,506.0,           ,1.0,1.0,230.0
4703,Luottojen_maksut,2020-07-03 04:35:25.571725566,2020-07-03,2020-07-03,2020-07-03,5.0,-6.68,1424.9,706.0,129.0,OKOYFIHH   ,0.0,0.0,249.0
4704,Muut,2020-07-03 05:20:19.958419950,2020-07-03,2020-07-03,2020-07-03,5.0,-314.57,1110.33,0.0,162.0,           ,1.0,1.0,131.0
4705,Ruoka_paivittaistavarakauppa,2020-07-03 07:41:02.370062364,2020-07-03,2020-07-03,2020-07-03,5.0,-12.91,1097.42,0.0,162.0,           ,1.0,1.0,67.0
4706,Asuminen,2020-07-03 10:46:39.168399162,2020-07-03,2020-07-03,2020-07-03,5.0,-111.42,986.0,0.0,129.0,OKOYFIHH   ,0.0,0.0,44.0
4707,Luokittelemattomat,2020-07-03 13:52:15.966735960,2020-07-03,2020-07-03,2020-07-03,5.0,-31.28,954.72,0.0,106.0,OKOYFIHH   ,0.0,0.0,16.0
4708,Ruoka_paivittaistavarakauppa,2020-07-03 14:37:10.353430344,2020-07-03,2020-07-03,2020-07-03,5.0,-15.59,939.13,0.0,162.0,           ,1.0,1.0,109.0
4709,Ravintolat_kahvilat,2020-07-03 16:57:52.765072758,2020-07-03,2020-07-03,2020-07-03,5.0,-3.67,935.46,0.0,162.0,           ,1.0,1.0,50.0
4710,Muut,2020-07-03 17:42:47.151767142,2020-07-03,2020-07-03,2020-07-03,5.0,-122.62,812.84,0.0,162.0,           ,1.0,1.0,188.0
4711,Liikkuminen,2020-07-03 18:33:40.790020788,2020-07-03,2020-07-03,2020-07-03,5.0,-13.36,799.48,0.0,162.0,           ,1.0,1.0,179.0
4712,Ruoka_paivittaistavarakauppa,2020-07-03 20:03:29.563409556,2020-07-03,2020-07-03,2020-07-03,5.0,-35.22,764.26,0.0,162.0,           ,1.0,1.0,107.0
4713,Luokittelemattomat,2020-07-03 21:39:17.588357586,2020-07-03,2020-07-03,2020-07-03,5.0,-100.28,663.98,0.0,162.0,           ,1.0,1.0,47.0
4714,Saastot_sijoitukset,2020-07-03 23:09:06.361746354,2020-07-03,2020-07-03,2020-07-03,5.0,-6.1,657.88,0.0,162.0,           ,1.0,1.0,97.0
4715,Ravintolat_kahvilat,2020-07-03 23:54:00.748440738,2020-07-03,2020-07-03,2020-07-03,5.0,-13.78,644.1,0.0,162.0,           ,1.0,1.0,108.0
4716,Terveys,2020-07-06 00:38:55.135135122,2020-07-06,2020-07-06,2020-07-06,5.0,-66.41,577.69,0.0,162.0,           ,1.0,1.0,121.0
4717,Ruoka_paivittaistavarakauppa,2020-07-06 02:14:43.160083152,2020-07-06,2020-07-06,2020-07-06,5.0,-21.23,556.46,0.0,162.0,           ,1.0,1.0,46.0
4718,Saastot_sijoitukset,2020-07-06 02:59:37.546777536,2020-07-06,2020-07-06,2020-07-06,5.0,-135.68,420.78,0.0,192.0,           ,0.0,1.0,206.0
4719,Ravintolat_kahvilat,2020-07-06 03:44:31.933471920,2020-07-06,2020-07-06,2020-07-06,5.0,-3.24,417.54,0.0,162.0,           ,1.0,1.0,151.0
4720,Saastot_sijoitukset,2020-07-06 06:05:14.345114334,2020-07-06,2020-07-06,2020-07-06,5.0,-45.06,372.48,0.0,192.0,           ,0.0,1.0,206.0
4721,Ruoka_paivittaistavarakauppa,2020-07-06 06:50:08.731808718,2020-07-06,2020-07-06,2020-07-06,5.0,-90.87,281.61,0.0,162.0,           ,1.0,1.0,133.0
4722,Ravintolat_kahvilat,2020-07-06 09:10:51.143451132,2020-07-06,2020-07-06,2020-07-06,5.0,-11.44,270.17,0.0,192.0,           ,0.0,1.0,206.0
4723,Ruoka_paivittaistavarakauppa,2020-07-06 09:55:45.530145516,2020-07-06,2020-07-06,2020-07-06,5.0,-21.58,248.59,0.0,162.0,           ,1.0,1.0,89.0
4724,Ruoka_paivittaistavarakauppa,2020-07-06 11:25:34.303534284,2020-07-06,2020-07-06,2020-07-06,5.0,-16.59,232.0,0.0,162.0,           ,1.0,1.0,125.0
4725,Ruoka_paivittaistavarakauppa,2020-07-06 11:31:33.555093546,2020-07-06,2020-07-06,2020-07-06,5.0,-19.09,212.91,0.0,162.0,           ,1.0,1.0,97.0
4726,Saastot_sijoitukset,2020-07-06 12:16:27.941787930,2020-07-06,2020-07-06,2020-07-06,5.0,-102.7,110.21,0.0,192.0,           ,0.0,1.0,206.0
4727,Shoppailu,2020-07-06 13:01:22.328482314,2020-07-06,2020-07-06,2020-07-06,5.0,-8.88,101.33,0.0,162.0,           ,1.0,1.0,58.0
4728,Liikkuminen,2020-07-06 15:22:04.740124728,2020-07-06,2020-07-06,2020-07-06,5.0,-3.56,97.77,0.0,162.0,           ,1.0,1.0,64.0
4729,Ruoka_paivittaistavarakauppa,2020-07-06 16:06:59.126819112,2020-07-06,2020-07-06,2020-07-06,5.0,-7.47,90.3,0.0,162.0,           ,1.0,1.0,84.0
4730,Tulot,2020-07-06 19:12:35.925155910,2020-07-06,2020-07-07,2020-07-06,5.0,408.15,498.45,710.0,506.0,           ,1.0,1.0,259.0
4731,Lemmikit,2020-07-06 20:48:23.950103940,2020-07-06,2020-07-06,2020-07-06,5.0,-16.47,481.98,0.0,162.0,           ,1.0,1.0,191.0
4732,Ravintolat_kahvilat,2020-07-06 21:33:18.336798324,2020-07-06,2020-07-06,2020-07-06,5.0,-14.04,467.94,0.0,162.0,           ,1.0,1.0,74.0
4733,Liikkuminen,2020-07-06 22:18:12.723492708,2020-07-06,2020-07-06,2020-07-06,5.0,-42.78,425.16,0.0,162.0,           ,1.0,1.0,164.0
4734,Ruoka_paivittaistavarakauppa,2020-07-07 01:23:49.521829506,2020-07-07,2020-07-07,2020-07-07,5.0,-46.02,379.14,0.0,162.0,           ,1.0,1.0,100.0
4735,Ravintolat_kahvilat,2020-07-07 04:29:26.320166304,2020-07-07,2020-07-07,2020-07-07,5.0,-12.28,366.86,0.0,162.0,           ,1.0,1.0,116.0
4736,Terveys,2020-07-07 07:35:03.118503102,2020-07-07,2020-07-07,2020-07-07,5.0,-29.1,337.76,0.0,162.0,           ,1.0,1.0,119.0
4737,Ruoka_paivittaistavarakauppa,2020-07-07 10:40:39.916839900,2020-07-07,2020-07-07,2020-07-07,5.0,-3.32,334.44,0.0,162.0,           ,1.0,1.0,185.0
4738,Hyvinvointi,2020-07-07 13:46:16.715176698,2020-07-07,2020-07-07,2020-07-07,5.0,-4.36,330.08,0.0,162.0,           ,1.0,1.0,59.0
4739,Ruoka_paivittaistavarakauppa,2020-07-07 16:51:53.513513496,2020-07-07,2020-07-07,2020-07-07,5.0,-23.56,306.52,0.0,162.0,           ,1.0,1.0,80.0
4740,Ruoka_paivittaistavarakauppa,2020-07-07 17:36:47.900207880,2020-07-07,2020-07-07,2020-07-07,5.0,-19.87,286.65,0.0,162.0,           ,1.0,1.0,164.0
4741,Luottojen_maksut,2020-07-07 18:27:41.538461526,2020-07-07,2020-07-07,2020-07-07,5.0,-49.65,237.0,0.0,162.0,           ,1.0,1.0,120.0
4742,Liikkuminen,2020-07-07 19:57:30.311850294,2020-07-07,2020-07-07,2020-07-07,5.0,-11.0,226.0,0.0,162.0,           ,1.0,1.0,161.0
4743,Ruoka_paivittaistavarakauppa,2020-07-07 23:03:07.110187092,2020-07-07,2020-07-07,2020-07-07,5.0,-38.33,187.67,0.0,162.0,           ,1.0,1.0,74.0
4744,Ruoka_paivittaistavarakauppa,2020-07-07 23:48:01.496881476,2020-07-07,2020-07-07,2020-07-07,5.0,-6.45,181.22,0.0,162.0,           ,1.0,1.0,115.0
4745,Ruoka_paivittaistavarakauppa,2020-07-08 02:08:43.908523890,2020-07-08,2020-07-08,2020-07-08,5.0,-8.66,172.56,0.0,162.0,           ,1.0,1.0,142.0
4746,Liikkuminen,2020-07-08 08:19:57.505197486,2020-07-08,2020-07-08,2020-07-08,5.0,-2.42,170.14,0.0,162.0,           ,1.0,1.0,47.0
4747,Ravintolat_kahvilat,2020-07-08 09:49:46.278586254,2020-07-08,2020-07-08,2020-07-08,5.0,-2.93,167.21,0.0,162.0,           ,1.0,1.0,148.0
4748,Ruoka_paivittaistavarakauppa,2020-07-08 14:31:11.101871082,2020-07-08,2020-07-08,2020-07-08,5.0,-3.0,164.21,0.0,162.0,           ,1.0,1.0,47.0
4749,Muut,2020-07-09 00:32:55.883575860,2020-07-09,2020-07-09,2020-07-09,5.0,-21.79,142.42,0.0,162.0,           ,1.0,1.0,117.0
4750,Liikkuminen,2020-07-09 02:53:38.295218274,2020-07-09,2020-07-09,2020-07-09,5.0,-1.87,140.55,0.0,162.0,           ,1.0,1.0,141.0
4751,Ruoka_paivittaistavarakauppa,2020-07-09 05:14:20.706860688,2020-07-09,2020-07-09,2020-07-09,5.0,-19.45,121.1,0.0,162.0,           ,1.0,1.0,127.0
4752,Lemmikit,2020-07-09 05:59:15.093555072,2020-07-09,2020-07-09,2020-07-09,5.0,-9.08,112.02,0.0,162.0,           ,1.0,1.0,84.0
4753,Ruoka_paivittaistavarakauppa,2020-07-09 06:44:09.480249456,2020-07-09,2020-07-09,2020-07-09,5.0,-16.42,95.6,0.0,162.0,           ,1.0,1.0,143.0
4754,Ruoka_paivittaistavarakauppa,2020-07-09 09:04:51.891891870,2020-07-09,2020-07-09,2020-07-09,5.0,-22.29,73.31,0.0,162.0,           ,1.0,1.0,122.0
4755,Ruoka_paivittaistavarakauppa,2020-07-09 12:10:28.690228668,2020-07-09,2020-07-09,2020-07-09,5.0,-54.14,19.17,0.0,162.0,           ,1.0,1.0,105.0
4756,Ruoka_paivittaistavarakauppa,2020-07-09 15:16:05.488565466,2020-07-09,2020-07-09,2020-07-09,5.0,-0.79,18.38,0.0,162.0,           ,1.0,1.0,131.0
4757,Ruoka_paivittaistavarakauppa,2020-07-09 18:21:42.286902264,2020-07-09,2020-07-09,2020-07-09,5.0,-6.85,11.53,0.0,162.0,           ,1.0,1.0,170.0
4758,Shoppailu,2020-07-09 20:42:24.698544678,2020-07-09,2020-07-09,2020-07-08,5.0,-40.0,-28.47,0.0,162.0,           ,1.0,1.0,128.0
4759,Ruoka_paivittaistavarakauppa,2020-07-09 21:27:19.085239062,2020-07-09,2020-07-09,2020-07-09,5.0,-3.04,-31.51,0.0,162.0,           ,1.0,1.0,105.0
4760,Ravintolat_kahvilat,2020-07-10 01:17:50.270270244,2020-07-10,2020-07-10,2020-07-10,5.0,-8.88,-40.39,0.0,162.0,           ,1.0,1.0,173.0
4761,Liikkuminen,2020-07-10 03:38:32.681912658,2020-07-10,2020-07-10,2020-07-10,5.0,-7.33,-47.72,0.0,162.0,           ,1.0,1.0,133.0
4762,Ruoka_paivittaistavarakauppa,2020-07-10 04:23:27.068607042,2020-07-10,2020-07-10,2020-07-10,5.0,-5.59,-53.31,0.0,162.0,           ,1.0,1.0,139.0
4763,Ruoka_paivittaistavarakauppa,2020-07-10 12:55:23.076923052,2020-07-10,2020-07-10,2020-07-10,5.0,-7.9,-61.21,0.0,162.0,           ,1.0,1.0,79.0
4764,Matkailu,2020-07-10 13:40:17.463617436,2020-07-10,2020-07-10,2020-07-10,5.0,-1.89,-63.1,0.0,162.0,           ,1.0,1.0,117.0
4765,Ruoka_paivittaistavarakauppa,2020-07-10 16:00:59.875259850,2020-07-10,2020-07-10,2020-07-10,5.0,-0.42,-63.52,0.0,162.0,           ,1.0,1.0,48.0
4766,Kulttuuri_viihde,2020-07-10 16:45:54.261954234,2020-07-10,2020-07-10,2020-07-10,5.0,-7.2,-70.72,0.0,162.0,           ,1.0,1.0,62.0
4767,Ruoka_paivittaistavarakauppa,2020-07-10 19:06:36.673596648,2020-07-10,2020-07-10,2020-07-10,5.0,-9.89,-80.61,0.0,162.0,           ,1.0,1.0,153.0
4768,Hyvinvointijakauneus,2020-07-10 19:51:31.060291032,2020-07-10,2020-07-10,2020-07-10,5.0,-0.48,-81.09,0.0,162.0,           ,1.0,1.0,105.0
4769,Lapset,2020-07-10 22:12:13.471933446,2020-07-10,2020-07-10,2020-07-10,5.0,-0.7,-81.79,0.0,162.0,           ,1.0,1.0,104.0
4770,Tulot,2020-07-10 22:57:07.858627830,2020-07-10,2020-07-10,2020-07-10,5.0,43.88,-37.91,710.0,506.0,           ,1.0,1.0,261.0
4771,Lapset,2020-07-12 02:02:44.656964628,2020-07-12,2020-07-12,2020-07-12,5.0,-6.8,-44.71,0.0,106.0,OKOYFIHH   ,0.0,0.0,20.0
4772,Muut,2020-07-13 00:26:56.632016598,2020-07-13,2020-07-13,2020-07-13,5.0,-2.93,-47.64,0.0,162.0,           ,1.0,1.0,109.0
4773,Ravintolat_kahvilat,2020-07-13 02:47:39.043659012,2020-07-13,2020-07-13,2020-07-13,5.0,-2.02,-49.66,0.0,162.0,           ,1.0,1.0,119.0
4774,Muut,2020-07-13 05:08:21.455301426,2020-07-13,2020-07-13,2020-07-13,5.0,-28.14,-77.8,0.0,164.0,           ,1.0,1.0,198.0
4775,Lemmikit,2020-07-13 05:53:15.841995810,2020-07-13,2020-07-13,2020-07-13,5.0,-3.32,-81.12,0.0,162.0,           ,1.0,1.0,142.0
4776,Ruoka_paivittaistavarakauppa,2020-07-13 06:38:10.228690194,2020-07-13,2020-07-13,2020-07-13,5.0,-5.12,-86.24,0.0,162.0,           ,1.0,1.0,164.0
4777,Ruoka_paivittaistavarakauppa,2020-07-13 07:29:03.866943840,2020-07-13,2020-07-13,2020-07-13,5.0,-3.2,-89.44,0.0,162.0,           ,1.0,1.0,181.0
4778,Lapset,2020-07-13 08:13:58.253638224,2020-07-13,2020-07-13,2020-07-13,5.0,-3.66,-93.1,0.0,162.0,           ,1.0,1.0,109.0
4779,Luottojen_maksut,2020-07-13 08:58:52.640332608,2020-07-13,2020-07-13,2020-07-13,5.0,-0.83,-93.93,0.0,162.0,           ,1.0,1.0,48.0
4780,Ruoka_paivittaistavarakauppa,2020-07-13 10:28:41.413721376,2020-07-13,2020-07-13,2020-07-13,5.0,-4.08,-98.01,0.0,162.0,           ,1.0,1.0,93.0
4781,Liikkuminen,2020-07-13 10:34:40.665280638,2020-07-13,2020-07-13,2020-07-13,5.0,-10.49,-108.5,0.0,162.0,           ,1.0,1.0,124.0
4782,Kulttuuri_viihde,2020-07-13 11:19:35.051975022,2020-07-13,2020-07-13,2020-07-13,5.0,-14.03,-122.53,0.0,162.0,           ,1.0,1.0,121.0
4783,Asuminen,2020-07-13 12:04:29.438669406,2020-07-13,2020-07-13,2020-07-13,5.0,-8.43,-130.96,0.0,162.0,           ,1.0,1.0,119.0
4784,Liikkuminen,2020-07-13 12:49:23.825363790,2020-07-13,2020-07-13,2020-07-13,5.0,-5.77,-136.73,0.0,162.0,           ,1.0,1.0,130.0
4785,Ruoka_paivittaistavarakauppa,2020-07-13 14:25:11.850311820,2020-07-13,2020-07-13,2020-07-13,5.0,-3.5,-140.23,0.0,162.0,           ,1.0,1.0,66.0
4786,Luottojen_maksut,2020-07-13 15:10:06.237006204,2020-07-13,2020-07-13,2020-07-13,5.0,-4.95,-145.18,0.0,162.0,           ,1.0,1.0,154.0
4787,Ruoka_paivittaistavarakauppa,2020-07-13 15:55:00.623700588,2020-07-13,2020-07-13,2020-07-13,5.0,-18.97,-164.15,0.0,162.0,           ,1.0,1.0,139.0
4788,Asuminen,2020-07-13 18:15:43.035343002,2020-07-13,2020-07-13,2020-07-13,5.0,-7.05,-171.2,0.0,162.0,           ,1.0,1.0,46.0
4789,Ruoka_paivittaistavarakauppa,2020-07-13 19:00:37.422037386,2020-07-13,2020-07-13,2020-07-13,5.0,-2.0,-173.2,0.0,162.0,           ,1.0,1.0,117.0
4790,Ruoka_paivittaistavarakauppa,2020-07-13 21:21:19.833679800,2020-07-13,2020-07-13,2020-07-13,5.0,-9.31,-182.51,0.0,162.0,           ,1.0,1.0,142.0
4791,Hyvinvointijakauneus,2020-07-13 22:06:14.220374184,2020-07-13,2020-07-13,2020-07-13,5.0,-4.82,-187.33,0.0,162.0,           ,1.0,1.0,107.0
4792,Luottojen_maksut,2020-07-13 23:42:02.245322214,2020-07-13,2020-07-13,2020-07-13,5.0,-5.07,-192.4,0.0,162.0,           ,1.0,1.0,60.0
4793,Ravintolat_kahvilat,2020-07-14 03:32:33.430353396,2020-07-14,2020-07-14,2020-07-14,5.0,-10.34,-202.74,0.0,162.0,           ,1.0,1.0,47.0
4794,Ruoka_paivittaistavarakauppa,2020-07-14 09:43:47.027026992,2020-07-14,2020-07-14,2020-07-14,5.0,-1.41,-204.15,0.0,162.0,           ,1.0,1.0,125.0
4795,Ruoka_paivittaistavarakauppa,2020-07-14 13:34:18.212058174,2020-07-14,2020-07-14,2020-07-14,5.0,-2.32,-206.47,0.0,162.0,           ,1.0,1.0,98.0
4796,Ruoka_paivittaistavarakauppa,2020-07-14 17:30:48.648648618,2020-07-14,2020-07-14,2020-07-14,5.0,-13.6,-220.07,0.0,162.0,           ,1.0,1.0,131.0
4797,Muut,2020-07-14 22:51:08.607068568,2020-07-14,2020-07-16,2020-07-14,5.0,-8.42,-228.49,0.0,162.0,           ,1.0,1.0,83.0
4798,Ruoka_paivittaistavarakauppa,2020-07-15 01:11:51.018710982,2020-07-15,2020-07-15,2020-07-15,5.0,-28.02,-256.51,0.0,162.0,           ,1.0,1.0,114.0
4799,Ruoka_paivittaistavarakauppa,2020-07-15 01:56:45.405405366,2020-07-15,2020-07-15,2020-07-15,5.0,-1.53,-258.04,0.0,162.0,           ,1.0,1.0,114.0
4800,Ruoka_paivittaistavarakauppa,2020-07-15 04:17:27.817047780,2020-07-15,2020-07-16,2020-07-15,5.0,-9.47,-267.51,0.0,162.0,           ,1.0,1.0,185.0
4801,Ruoka_paivittaistavarakauppa,2020-07-15 07:23:04.615384578,2020-07-15,2020-07-15,2020-07-15,5.0,-3.12,-270.63,0.0,162.0,           ,1.0,1.0,153.0
4802,Tulot,2020-07-15 11:58:30.187110144,2020-07-15,2020-07-15,2020-07-15,5.0,1495.61,1224.98,701.0,510.0,           ,1.0,1.0,235.0
4803,Ruoka_paivittaistavarakauppa,2020-07-15 19:45:31.808731770,2020-07-15,2020-07-15,2020-07-15,5.0,-6.56,1218.42,0.0,162.0,           ,1.0,1.0,117.0
4804,Ruoka_paivittaistavarakauppa,2020-07-15 20:36:25.446985416,2020-07-15,2020-07-15,2020-07-15,5.0,-3.36,1215.06,0.0,162.0,           ,1.0,1.0,127.0
4805,Liikkuminen,2020-07-16 05:02:22.203742164,2020-07-16,2020-07-16,2020-07-16,5.0,-26.75,1188.31,0.0,162.0,           ,1.0,1.0,143.0
4806,Matkailu,2020-07-16 06:32:10.977130932,2020-07-16,2020-07-16,2020-07-16,5.0,-17.85,1170.46,0.0,162.0,           ,1.0,1.0,142.0
4807,Tulot,2020-07-16 11:13:35.800415760,2020-07-16,2020-07-16,2020-07-16,5.0,39.97,1210.43,0.0,506.0,           ,1.0,1.0,220.0
4808,Ruoka_paivittaistavarakauppa,2020-07-16 14:19:12.598752558,2020-07-16,2020-07-17,2020-07-16,5.0,-37.82,1172.61,0.0,162.0,           ,1.0,1.0,152.0
4809,Ravintolat_kahvilat,2020-07-16 17:24:49.397089356,2020-07-16,2020-07-16,2020-07-16,5.0,-5.97,1166.64,0.0,162.0,           ,1.0,1.0,123.0
4810,Liikkuminen,2020-07-16 21:15:20.582120538,2020-07-16,2020-07-16,2020-07-16,5.0,-37.42,1129.22,0.0,162.0,           ,1.0,1.0,58.0
4811,Muut,2020-07-16 22:00:14.968814922,2020-07-16,2020-07-16,2020-07-16,5.0,-22.28,1106.94,0.0,106.0,OKOYFIHH   ,0.0,0.0,33.0
4812,Ruoka_paivittaistavarakauppa,2020-07-17 00:20:57.380457336,2020-07-17,2020-07-17,2020-07-17,5.0,-11.42,1095.52,0.0,162.0,           ,1.0,1.0,47.0
4813,Ruoka_paivittaistavarakauppa,2020-07-17 02:41:39.792099750,2020-07-17,2020-07-17,2020-07-17,5.0,-20.09,1075.43,0.0,162.0,           ,1.0,1.0,66.0
4814,Shoppailu,2020-07-17 03:26:34.178794134,2020-07-17,2020-07-17,2020-07-17,5.0,-23.72,1051.71,0.0,162.0,           ,1.0,1.0,185.0
4815,Tulot,2020-07-17 05:47:16.590436548,2020-07-17,2020-07-17,2020-07-17,5.0,51.05,1102.76,0.0,506.0,           ,1.0,1.0,224.0
4816,Ruoka_paivittaistavarakauppa,2020-07-17 08:07:59.002078962,2020-07-17,2020-07-17,2020-07-17,5.0,-5.65,1097.11,0.0,162.0,           ,1.0,1.0,140.0
4817,Ruoka_paivittaistavarakauppa,2020-07-17 08:52:53.388773346,2020-07-17,2020-07-17,2020-07-17,5.0,-10.49,1086.62,0.0,162.0,           ,1.0,1.0,153.0
4818,Luottojen_maksut,2020-07-17 15:04:06.985446942,2020-07-17,2020-07-17,2020-07-17,5.0,-355.46,731.16,0.0,172.0,           ,1.0,1.0,202.0
4819,Liikkuminen,2020-07-17 16:39:55.010394972,2020-07-17,2020-07-17,2020-07-17,5.0,-11.99,719.17,0.0,162.0,           ,1.0,1.0,172.0
4820,Ruoka_paivittaistavarakauppa,2020-07-17 18:09:43.783783740,2020-07-17,2020-07-17,2020-07-17,5.0,-3.05,716.12,0.0,162.0,           ,1.0,1.0,105.0
4821,Ravintolat_kahvilat,2020-07-17 20:30:26.195426154,2020-07-17,2020-07-17,2020-07-17,5.0,-6.46,709.66,0.0,162.0,           ,1.0,1.0,185.0
4822,Liikkuminen,2020-07-17 23:36:02.993762952,2020-07-17,2020-07-17,2020-07-17,5.0,-32.23,677.43,0.0,162.0,           ,1.0,1.0,143.0
4823,Kulttuuri_viihde,2020-07-18 15:49:01.372141326,2020-07-18,2020-07-18,2020-07-18,5.0,-4.57,672.86,0.0,106.0,OKOYFIHH   ,0.0,0.0,14.0
4824,Saastot_sijoitukset,2020-07-19 12:43:24.573804528,2020-07-19,2020-07-19,2020-07-19,5.0,-14.58,658.28,0.0,106.0,OKOYFIHH   ,0.0,0.0,23.0
4825,Ruoka_paivittaistavarakauppa,2020-07-20 01:05:51.767151720,2020-07-20,2020-07-20,2020-07-20,5.0,-4.13,654.15,0.0,162.0,           ,1.0,1.0,89.0
4826,Asuminen,2020-07-20 01:50:46.153846104,2020-07-20,2020-07-20,2020-07-20,5.0,-16.85,637.3,0.0,162.0,           ,1.0,1.0,154.0
4827,Ruoka_paivittaistavarakauppa,2020-07-20 04:11:28.565488518,2020-07-20,2020-07-20,2020-07-20,5.0,-1.28,636.02,0.0,162.0,           ,1.0,1.0,139.0
4828,Ravintolat_kahvilat,2020-07-20 04:56:22.952182902,2020-07-20,2020-07-20,2020-07-20,5.0,-33.15,602.87,0.0,162.0,           ,1.0,1.0,50.0
4829,Terveys,2020-07-20 05:41:17.338877286,2020-07-20,2020-07-20,2020-07-20,5.0,-12.11,590.76,0.0,162.0,           ,1.0,1.0,129.0
4830,Liikkuminen,2020-07-20 07:17:05.363825316,2020-07-20,2020-07-20,2020-07-20,5.0,-14.75,576.01,0.0,162.0,           ,1.0,1.0,145.0
4831,Ruoka_paivittaistavarakauppa,2020-07-20 08:01:59.750519700,2020-07-20,2020-07-20,2020-07-20,5.0,-13.23,562.78,0.0,162.0,           ,1.0,1.0,128.0
4832,Saastot_sijoitukset,2020-07-20 08:46:54.137214084,2020-07-20,2020-07-20,2020-07-20,5.0,-19.96,542.82,0.0,162.0,           ,1.0,1.0,164.0
4833,Luottojen_maksut,2020-07-20 09:37:47.775467730,2020-07-20,2020-07-20,2020-07-20,5.0,-302.58,240.24,0.0,106.0,DABAFIHH   ,0.0,0.0,42.0
4834,Ruoka_paivittaistavarakauppa,2020-07-20 10:22:42.162162114,2020-07-20,2020-07-20,2020-07-20,5.0,-12.22,228.02,0.0,162.0,           ,1.0,1.0,58.0
4835,Luokittelemattomat,2020-07-20 11:07:36.548856498,2020-07-20,2020-07-20,2020-07-20,5.0,-217.91,10.11,0.0,106.0,OKOYFIHH   ,1.0,0.0,23.0
4836,Kulttuuri_viihde,2020-07-20 11:52:30.935550882,2020-07-20,2020-07-20,2020-07-20,5.0,-3.24,6.87,0.0,162.0,           ,1.0,1.0,127.0
4837,Ruoka_paivittaistavarakauppa,2020-07-20 13:28:18.960498912,2020-07-20,2020-07-20,2020-07-20,5.0,-3.23,3.64,0.0,162.0,           ,1.0,1.0,79.0
4838,Ruoka_paivittaistavarakauppa,2020-07-20 14:13:13.347193296,2020-07-20,2020-07-20,2020-07-20,5.0,-3.1,0.54,0.0,162.0,           ,1.0,1.0,153.0
4839,Ruoka_paivittaistavarakauppa,2020-07-20 14:58:07.733887680,2020-07-20,2020-07-20,2020-07-20,5.0,-2.83,-2.29,0.0,162.0,           ,1.0,1.0,153.0
4840,Ravintolat_kahvilat,2020-07-20 16:33:55.758835710,2020-07-20,2020-07-20,2020-07-20,5.0,-7.74,-10.03,0.0,162.0,           ,1.0,1.0,138.0
4841,Liikkuminen,2020-07-20 17:18:50.145530094,2020-07-20,2020-07-20,2020-07-20,5.0,-12.11,-22.14,0.0,162.0,           ,1.0,1.0,111.0
4842,Kulttuuri_viihde,2020-07-20 18:03:44.532224478,2020-07-20,2020-07-20,2020-07-20,5.0,-10.17,-32.31,0.0,162.0,           ,1.0,1.0,74.0
4843,Tulot,2020-07-20 18:54:38.170478124,2020-07-20,2020-07-20,2020-07-20,5.0,-3.15,-35.46,0.0,162.0,           ,1.0,1.0,137.0
4844,Ruoka_paivittaistavarakauppa,2020-07-20 19:39:32.557172508,2020-07-20,2020-07-20,2020-07-20,5.0,-2.58,-38.04,0.0,162.0,           ,1.0,1.0,141.0
4845,Ruoka_paivittaistavarakauppa,2020-07-20 20:24:26.943866892,2020-07-20,2020-07-20,2020-07-20,5.0,-1.04,-39.08,0.0,162.0,           ,1.0,1.0,89.0
4846,Lapset,2020-07-20 22:45:09.355509306,2020-07-20,2020-07-20,2020-07-20,5.0,-2.49,-41.57,0.0,162.0,           ,1.0,1.0,48.0
4847,Luokittelemattomat,2020-07-20 23:30:03.742203690,2020-07-20,2020-07-20,2020-07-20,5.0,-2.73,-44.3,0.0,162.0,           ,1.0,1.0,135.0
4848,Ruoka_paivittaistavarakauppa,2020-07-21 09:31:48.523908468,2020-07-21,2020-07-21,2020-07-21,5.0,-0.5,-44.8,0.0,162.0,           ,1.0,1.0,93.0
4849,Terveys,2020-07-21 10:16:42.910602852,2020-07-21,2020-07-21,2020-07-21,5.0,-5.74,-50.54,0.0,162.0,           ,1.0,1.0,174.0
4850,Ravintolat_kahvilat,2020-07-21 15:43:02.120582064,2020-07-21,2020-07-21,2020-07-21,5.0,-5.8,-56.34,0.0,162.0,           ,1.0,1.0,169.0
4851,Tulot,2020-07-21 18:48:38.918918862,2020-07-21,2020-07-23,2020-07-21,5.0,151.06,94.72,0.0,506.0,           ,1.0,1.0,220.0
4852,Liikkuminen,2020-07-21 21:09:21.330561276,2020-07-21,2020-07-21,2020-07-21,5.0,-7.61,87.11,0.0,162.0,           ,1.0,1.0,188.0
4853,Ruoka_paivittaistavarakauppa,2020-07-22 00:14:58.128898074,2020-07-22,2020-07-22,2020-07-22,5.0,-12.81,74.3,0.0,162.0,           ,1.0,1.0,138.0
4854,Ruoka_paivittaistavarakauppa,2020-07-22 02:35:40.540540488,2020-07-22,2020-07-24,2020-07-22,5.0,-2.13,72.17,0.0,162.0,           ,1.0,1.0,125.0
4855,Ravintolat_kahvilat,2020-07-22 11:01:37.297297236,2020-07-22,2020-07-22,2020-07-22,5.0,-11.29,60.88,0.0,162.0,           ,1.0,1.0,185.0
4856,Ruoka_paivittaistavarakauppa,2020-07-22 12:37:25.322245266,2020-07-22,2020-07-22,2020-07-22,5.0,-17.07,43.81,0.0,162.0,           ,1.0,1.0,183.0
4857,Ruoka_paivittaistavarakauppa,2020-07-23 00:59:52.515592458,2020-07-23,2020-07-23,2020-07-23,5.0,-11.03,32.78,0.0,162.0,           ,1.0,1.0,49.0
4858,Lapset,2020-07-23 01:44:46.902286842,2020-07-23,2020-07-23,2020-07-23,5.0,-8.6,24.18,0.0,162.0,           ,1.0,1.0,104.0
4859,Ruoka_paivittaistavarakauppa,2020-07-23 04:05:29.313929256,2020-07-23,2020-07-23,2020-07-23,5.0,-3.55,20.63,0.0,162.0,           ,1.0,1.0,105.0
4860,Lapset,2020-07-23 06:26:11.725571670,2020-07-23,2020-07-23,2020-07-23,5.0,-24.91,-4.28,0.0,162.0,           ,1.0,1.0,55.0
4861,Ruoka_paivittaistavarakauppa,2020-07-23 07:11:06.112266054,2020-07-23,2020-07-23,2020-07-23,5.0,-3.4,-7.68,0.0,162.0,           ,1.0,1.0,97.0
4862,Ruoka_paivittaistavarakauppa,2020-07-23 16:27:56.507276448,2020-07-23,2020-07-23,2020-07-23,5.0,-1.73,-9.41,0.0,162.0,           ,1.0,1.0,127.0
4863,Ruoka_paivittaistavarakauppa,2020-07-23 17:12:50.893970832,2020-07-23,2020-07-23,2020-07-23,5.0,-5.91,-15.32,0.0,162.0,           ,1.0,1.0,133.0
4864,Ruoka_paivittaistavarakauppa,2020-07-23 19:33:33.305613246,2020-07-23,2020-07-24,2020-07-23,5.0,-0.63,-15.95,0.0,162.0,           ,1.0,1.0,145.0
4865,Lemmikit,2020-07-23 21:54:15.717255660,2020-07-23,2020-07-23,2020-07-23,5.0,-4.31,-20.26,0.0,162.0,           ,1.0,1.0,58.0
4866,Ruoka_paivittaistavarakauppa,2020-07-24 00:08:58.877338812,2020-07-24,2020-07-24,2020-07-24,5.0,-4.77,-25.03,0.0,162.0,           ,1.0,1.0,183.0
4867,Lemmikit,2020-07-24 03:20:34.927234872,2020-07-24,2020-07-24,2020-07-24,5.0,-12.78,-37.81,0.0,162.0,           ,1.0,1.0,163.0
4868,Liikkuminen,2020-07-24 04:50:23.700623640,2020-07-24,2020-07-24,2020-07-24,5.0,-10.48,-48.29,0.0,162.0,           ,1.0,1.0,79.0
4869,Ravintolat_kahvilat,2020-07-24 05:35:18.087318024,2020-07-24,2020-07-24,2020-07-24,5.0,-4.77,-53.06,0.0,162.0,           ,1.0,1.0,174.0
4870,Hyvinvointijakauneus,2020-07-24 07:56:00.498960438,2020-07-24,2020-07-24,2020-07-24,5.0,-4.64,-57.7,0.0,162.0,           ,1.0,1.0,134.0
4871,Ruoka_paivittaistavarakauppa,2020-07-24 13:22:19.708939650,2020-07-24,2020-07-24,2020-07-24,5.0,-19.32,-77.02,0.0,162.0,           ,1.0,1.0,126.0
4872,Ruoka_paivittaistavarakauppa,2020-07-24 14:07:14.095634034,2020-07-24,2020-07-24,2020-07-24,5.0,-12.99,-90.01,0.0,162.0,           ,1.0,1.0,165.0
4873,Ruoka_paivittaistavarakauppa,2020-07-24 17:57:45.280665216,2020-07-24,2020-07-24,2020-07-24,5.0,-5.02,-95.03,0.0,162.0,           ,1.0,1.0,175.0
4874,Kulttuuri_viihde,2020-07-24 20:18:27.692307630,2020-07-24,2020-07-24,2020-07-24,5.0,-0.27,-95.3,0.0,162.0,           ,1.0,1.0,120.0
4875,Ruoka_paivittaistavarakauppa,2020-07-24 22:39:10.103950044,2020-07-24,2020-07-24,2020-07-24,5.0,-4.36,-99.66,0.0,162.0,           ,1.0,1.0,48.0
4876,Ruoka_paivittaistavarakauppa,2020-07-24 23:24:04.490644428,2020-07-24,2020-07-24,2020-07-24,5.0,-3.83,-103.49,0.0,162.0,           ,1.0,1.0,58.0
4877,Tulot,2020-07-26 14:52:08.482328418,2020-07-26,2020-07-26,2020-07-26,5.0,320.32,216.83,0.0,506.0,           ,1.0,1.0,218.0
4878,Ravintolat_kahvilat,2020-07-27 00:53:53.264033196,2020-07-27,2020-07-27,2020-07-27,5.0,-3.41,213.42,0.0,162.0,           ,1.0,1.0,109.0
4879,Muut,2020-07-27 01:38:47.650727580,2020-07-27,2020-07-27,2020-07-27,5.0,-14.94,198.48,0.0,162.0,           ,1.0,1.0,158.0
4880,Ruoka_paivittaistavarakauppa,2020-07-27 02:29:41.288981226,2020-07-27,2020-07-27,2020-07-27,5.0,-20.99,177.49,0.0,162.0,           ,1.0,1.0,78.0
4881,Ruoka_paivittaistavarakauppa,2020-07-27 03:14:35.675675610,2020-07-27,2020-07-27,2020-07-27,5.0,-3.44,174.05,0.0,162.0,           ,1.0,1.0,159.0
4882,Ruoka_paivittaistavarakauppa,2020-07-27 03:59:30.062369994,2020-07-27,2020-07-27,2020-07-27,5.0,-8.68,165.37,0.0,162.0,           ,1.0,1.0,138.0
4883,Ravintolat_kahvilat,2020-07-27 04:44:24.449064378,2020-07-27,2020-07-27,2020-07-27,5.0,-15.82,149.55,0.0,162.0,           ,1.0,1.0,162.0
4884,Ruoka_paivittaistavarakauppa,2020-07-27 07:05:06.860706792,2020-07-27,2020-07-27,2020-07-27,5.0,-40.97,108.58,0.0,162.0,           ,1.0,1.0,105.0
4885,Matkailu,2020-07-27 09:25:49.272349206,2020-07-27,2020-07-28,2020-07-27,5.0,-6.58,102.0,0.0,162.0,           ,1.0,1.0,47.0
4886,Saastot_sijoitukset,2020-07-27 10:10:43.659043590,2020-07-27,2020-07-27,2020-07-27,5.0,-13.22,88.78,0.0,162.0,           ,1.0,1.0,154.0
4887,Lapset,2020-07-27 10:55:38.045737974,2020-07-27,2020-07-27,2020-07-27,5.0,-7.03,81.75,0.0,162.0,           ,1.0,1.0,160.0
4888,Ruoka_paivittaistavarakauppa,2020-07-27 12:31:26.070686004,2020-07-27,2020-07-27,2020-07-27,5.0,-38.02,43.73,0.0,162.0,           ,1.0,1.0,119.0
4889,Ruoka_paivittaistavarakauppa,2020-07-27 13:16:20.457380388,2020-07-27,2020-07-27,2020-07-27,5.0,-5.81,37.92,0.0,162.0,           ,1.0,1.0,104.0
4890,Lemmikit,2020-07-27 15:37:02.869022802,2020-07-27,2020-07-27,2020-07-27,5.0,-6.95,30.97,0.0,162.0,           ,1.0,1.0,105.0
4891,Ruoka_paivittaistavarakauppa,2020-07-27 16:21:57.255717186,2020-07-27,2020-07-27,2020-07-27,5.0,-4.39,26.58,0.0,162.0,           ,1.0,1.0,96.0
4892,Lemmikit,2020-07-27 18:36:40.415800338,2020-07-27,2020-07-28,2020-07-27,5.0,-4.4,22.18,0.0,162.0,           ,1.0,1.0,174.0
4893,Ruoka_paivittaistavarakauppa,2020-07-27 18:42:39.667359600,2020-07-27,2020-07-27,2020-07-27,5.0,-1.7,20.48,0.0,162.0,           ,1.0,1.0,109.0
4894,Ruoka_paivittaistavarakauppa,2020-07-27 19:27:34.054053984,2020-07-27,2020-07-27,2020-07-27,5.0,-5.55,14.93,0.0,162.0,           ,1.0,1.0,53.0
4895,Ruoka_paivittaistavarakauppa,2020-07-27 20:12:28.440748368,2020-07-27,2020-07-27,2020-07-27,5.0,-2.57,12.36,0.0,162.0,           ,1.0,1.0,97.0
4896,Liikkuminen,2020-07-27 21:03:22.079002014,2020-07-27,2020-07-27,2020-07-27,5.0,-5.79,6.57,0.0,162.0,           ,1.0,1.0,48.0
4897,Lemmikit,2020-07-27 21:48:16.465696398,2020-07-27,2020-07-27,2020-07-27,5.0,-8.69,-2.12,0.0,162.0,           ,1.0,1.0,48.0
4898,Tulot,2020-07-27 22:33:10.852390782,2020-07-27,2020-07-29,2020-07-27,5.0,-24.04,-26.16,706.0,129.0,OKOYFIHH   ,0.0,0.0,249.0
4899,Ruoka_paivittaistavarakauppa,2020-07-27 23:18:05.239085166,2020-07-27,2020-07-27,2020-07-27,5.0,-2.88,-29.04,0.0,162.0,           ,1.0,1.0,175.0
4900,Ruoka_paivittaistavarakauppa,2020-07-28 05:29:18.835758762,2020-07-28,2020-07-28,2020-07-28,5.0,-4.85,-33.89,0.0,162.0,           ,1.0,1.0,132.0
4901,Ruoka_paivittaistavarakauppa,2020-07-28 06:20:12.474012408,2020-07-28,2020-07-28,2020-07-28,5.0,-2.75,-36.64,0.0,162.0,           ,1.0,1.0,164.0
4902,Ruoka_paivittaistavarakauppa,2020-07-28 07:50:01.247401176,2020-07-28,2020-07-28,2020-07-28,5.0,-0.91,-37.55,0.0,162.0,           ,1.0,1.0,185.0
4903,Ruoka_paivittaistavarakauppa,2020-07-28 08:40:54.885654822,2020-07-28,2020-07-28,2020-07-28,5.0,-4.46,-42.01,0.0,162.0,           ,1.0,1.0,126.0
4904,Liikkuminen,2020-07-28 11:46:31.683991620,2020-07-28,2020-07-28,2020-07-28,5.0,-11.28,-53.29,0.0,162.0,           ,1.0,1.0,132.0
4905,Asuminen,2020-07-28 14:01:14.844074772,2020-07-28,2020-07-28,2020-07-28,5.0,-1.08,-54.37,0.0,162.0,           ,1.0,1.0,48.0
4906,Ruoka_paivittaistavarakauppa,2020-07-28 14:46:09.230769156,2020-07-28,2020-07-28,2020-07-28,5.0,-1.7,-56.07,0.0,162.0,           ,1.0,1.0,185.0
4907,Kulttuuri_viihde,2020-07-29 03:08:36.424116348,2020-07-29,2020-07-29,2020-07-29,5.0,-16.1,-72.17,0.0,162.0,           ,1.0,1.0,145.0
4908,Ruoka_paivittaistavarakauppa,2020-07-29 08:34:55.634095560,2020-07-29,2020-07-29,2020-07-29,5.0,-16.3,-88.47,0.0,162.0,           ,1.0,1.0,146.0
4909,Matkailu,2020-07-29 09:19:50.020789944,2020-07-29,2020-07-29,2020-07-29,5.0,-5.5,-93.97,0.0,162.0,           ,1.0,1.0,58.0
4910,Ruoka_paivittaistavarakauppa,2020-07-29 10:04:44.407484328,2020-07-29,2020-07-29,2020-07-29,5.0,-3.79,-97.76,0.0,162.0,           ,1.0,1.0,147.0
4911,Ruoka_paivittaistavarakauppa,2020-07-29 15:31:03.617463540,2020-07-29,2020-07-29,2020-07-29,5.0,-2.13,-99.89,0.0,162.0,           ,1.0,1.0,176.0
4912,Ravintolat_kahvilat,2020-07-29 16:15:58.004157924,2020-07-29,2020-07-29,2020-07-29,5.0,-7.72,-107.61,0.0,162.0,           ,1.0,1.0,142.0
4913,Ruoka_paivittaistavarakauppa,2020-07-29 17:51:46.029105954,2020-07-29,2020-07-29,2020-07-29,5.0,-2.27,-109.88,0.0,162.0,           ,1.0,1.0,108.0
4914,Ruoka_paivittaistavarakauppa,2020-07-29 20:57:22.827442752,2020-07-29,2020-07-29,2020-07-29,5.0,-4.18,-114.06,0.0,162.0,           ,1.0,1.0,154.0
4915,Hyvinvointijakauneus,2020-07-30 00:47:54.012473934,2020-07-30,2020-07-30,2020-07-30,5.0,-5.23,-119.29,0.0,162.0,           ,1.0,1.0,74.0
4916,Ruoka_paivittaistavarakauppa,2020-07-30 06:14:13.222453146,2020-07-30,2020-07-30,2020-07-30,5.0,-3.18,-122.47,0.0,162.0,           ,1.0,1.0,153.0
4917,Ruoka_paivittaistavarakauppa,2020-07-30 11:40:32.432432358,2020-07-30,2020-07-30,2020-07-30,5.0,-9.29,-131.76,0.0,162.0,           ,1.0,1.0,115.0
4918,Ruoka_paivittaistavarakauppa,2020-07-30 12:25:26.819126742,2020-07-30,2020-07-30,2020-07-30,5.0,-1.67,-133.43,0.0,162.0,           ,1.0,1.0,163.0
4919,Ruoka_paivittaistavarakauppa,2020-07-30 13:10:21.205821126,2020-07-30,2020-07-30,2020-07-30,5.0,-24.55,-157.98,0.0,162.0,           ,1.0,1.0,133.0
4920,Luokittelemattomat,2020-07-30 17:06:51.642411570,2020-07-30,2020-07-30,2020-07-30,5.0,-5.51,-163.49,0.0,162.0,           ,1.0,1.0,131.0
4921,Lapset,2020-07-30 22:27:11.600831520,2020-07-30,2020-07-30,2020-07-30,5.0,-9.71,-173.2,0.0,162.0,           ,1.0,1.0,165.0
4922,Ruoka_paivittaistavarakauppa,2020-07-31 00:02:59.625779550,2020-07-31,2020-07-31,2020-07-31,5.0,-14.03,-187.23,0.0,162.0,           ,1.0,1.0,133.0
4923,Tulot,2020-07-31 02:23:42.037421964,2020-07-31,2020-07-31,2020-07-31,5.0,435.68,248.45,710.0,506.0,           ,1.0,1.0,260.0
4924,Ravintolat_kahvilat,2020-07-31 03:53:30.810810732,2020-07-31,2020-07-31,2020-07-31,5.0,-9.72,238.73,0.0,162.0,           ,1.0,1.0,75.0
4925,Ruoka_paivittaistavarakauppa,2020-07-31 06:59:07.609147530,2020-07-31,2020-07-31,2020-07-31,5.0,-18.98,219.75,0.0,162.0,           ,1.0,1.0,105.0
4926,Liikkuminen,2020-07-31 19:21:34.802494722,2020-07-31,2020-07-31,2020-07-31,5.0,-21.79,197.96,0.0,162.0,           ,1.0,1.0,142.0
4927,Lapset,2020-07-31 21:42:17.214137136,2020-07-31,2020-07-31,2020-07-31,5.0,-98.48,99.48,0.0,162.0,           ,1.0,1.0,174.0
4928,Ruoka_paivittaistavarakauppa,2020-08-03 03:18:37.241379309,2020-08-03,2020-08-03,2020-08-03,5.0,-6.27,93.21,0.0,162.0,           ,1.0,1.0,48.0
4929,Ruoka_paivittaistavarakauppa,2020-08-03 10:12:24.827586206,2020-08-03,2020-08-05,2020-08-03,5.0,-17.86,75.35,0.0,162.0,           ,1.0,1.0,176.0
4930,Tulot,2020-08-03 17:06:12.413793103,2020-08-03,2020-08-03,2020-07-31,5.0,244.33,319.68,701.0,520.0,           ,1.0,1.0,236.0
4931,Liikkuminen,2020-08-03 20:24:49.655172412,2020-08-03,2020-08-03,2020-08-03,5.0,-14.52,305.16,0.0,162.0,           ,1.0,1.0,111.0
4932,Ruoka_paivittaistavarakauppa,2020-08-04 13:31:02.068965515,2020-08-04,2020-08-04,2020-08-04,5.0,-1.03,304.13,0.0,162.0,           ,1.0,1.0,163.0
4933,Luokittelemattomat,2020-08-05 16:49:39.310344824,2020-08-05,2020-08-05,2020-08-05,5.0,-10.93,293.2,0.0,162.0,           ,1.0,1.0,134.0
4934,Ruoka_paivittaistavarakauppa,2020-08-05 23:43:26.896551721,2020-08-05,2020-08-05,2020-08-05,5.0,-10.53,282.67,0.0,162.0,           ,1.0,1.0,48.0
4935,Kulttuuri_viihde,2020-08-06 06:37:14.482758618,2020-08-06,2020-08-06,2020-08-06,5.0,-18.04,264.63,0.0,162.0,           ,1.0,1.0,63.0
4936,Tulot,2020-08-07 03:02:04.137931030,2020-08-07,2020-08-07,2020-08-07,5.0,1053.25,1317.88,701.0,520.0,           ,1.0,1.0,237.0
4937,Liikkuminen,2020-08-07 09:55:51.724137927,2020-08-07,2020-08-07,2020-08-07,5.0,-89.39,1228.49,0.0,162.0,           ,1.0,1.0,107.0
4938,Shoppailu,2020-08-07 13:14:28.965517236,2020-08-07,2020-08-07,2020-08-07,5.0,-9.01,1219.48,0.0,162.0,           ,1.0,1.0,129.0
4939,Luottojen_maksut,2020-08-07 20:08:16.551724133,2020-08-07,2020-08-07,2020-08-07,5.0,-4.5,1214.98,0.0,162.0,           ,1.0,1.0,108.0
4940,Luokittelemattomat,2020-08-10 06:20:41.379310339,2020-08-10,2020-08-11,2020-08-10,5.0,-106.71,1108.27,0.0,106.0,OKOYFIHH   ,1.0,0.0,24.0
4941,Ruoka_paivittaistavarakauppa,2020-08-10 09:39:18.620689648,2020-08-10,2020-08-10,2020-08-10,5.0,-5.79,1102.48,0.0,162.0,           ,1.0,1.0,66.0
4942,Ruoka_paivittaistavarakauppa,2020-08-10 23:26:53.793103442,2020-08-10,2020-08-10,2020-08-10,5.0,-5.06,1097.42,0.0,162.0,           ,1.0,1.0,146.0
4943,Ruoka_paivittaistavarakauppa,2020-08-11 02:45:31.034482751,2020-08-11,2020-08-11,2020-08-11,5.0,-10.79,1086.63,0.0,162.0,           ,1.0,1.0,105.0
4944,Ruoka_paivittaistavarakauppa,2020-08-11 16:33:06.206896545,2020-08-11,2020-08-11,2020-08-11,5.0,-6.73,1079.9,0.0,162.0,           ,1.0,1.0,58.0
4945,Ruoka_paivittaistavarakauppa,2020-08-13 19:51:43.448275854,2020-08-13,2020-08-13,2020-08-13,5.0,-5.13,1074.77,0.0,162.0,           ,1.0,1.0,46.0
4946,Ruoka_paivittaistavarakauppa,2020-08-14 12:57:55.862068957,2020-08-14,2020-08-14,2020-08-14,5.0,-24.93,1049.84,0.0,162.0,           ,1.0,1.0,122.0
4947,Matkailu,2020-08-15 16:16:33.103448266,2020-08-15,2020-08-15,2020-08-15,5.0,-27.99,1021.85,0.0,163.0,           ,1.0,1.0,193.0
4948,Tulot,2020-08-16 23:10:20.689655163,2020-08-16,2020-08-16,2020-08-16,5.0,1014.27,2036.12,0.0,506.0,           ,1.0,1.0,222.0
4949,Ravintolat_kahvilat,2020-08-17 06:04:08.275862060,2020-08-17,2020-08-17,2020-08-17,5.0,-10.2,2025.92,0.0,103.0,           ,0.0,1.0,2.0
4950,Terveys,2020-08-17 09:22:45.517241369,2020-08-17,2020-08-17,2020-08-17,5.0,-15.44,2010.48,0.0,162.0,           ,1.0,1.0,129.0
4951,Ruoka_paivittaistavarakauppa,2020-08-18 02:28:57.931034472,2020-08-18,2020-08-18,2020-08-18,5.0,-35.99,1974.49,0.0,162.0,           ,1.0,1.0,171.0
4952,Ruoka_paivittaistavarakauppa,2020-08-18 19:35:10.344827575,2020-08-18,2020-08-18,2020-08-18,5.0,-5.0,1969.49,0.0,162.0,           ,1.0,1.0,145.0
4953,Ruoka_paivittaistavarakauppa,2020-08-19 12:41:22.758620678,2020-08-19,2020-08-19,2020-08-19,5.0,-17.68,1951.81,0.0,162.0,           ,1.0,1.0,153.0
4954,Ravintolat_kahvilat,2020-08-20 05:47:35.172413781,2020-08-20,2020-08-20,2020-08-20,5.0,-27.06,1924.75,0.0,162.0,           ,1.0,1.0,126.0
4955,Muut,2020-08-20 22:53:47.586206884,2020-08-20,2020-08-20,2020-08-20,5.0,-3.81,1920.94,0.0,162.0,           ,1.0,1.0,130.0
4956,Ruoka_paivittaistavarakauppa,2020-08-21 09:06:12.413793090,2020-08-21,2020-08-21,2020-08-21,5.0,-5.14,1915.8,0.0,162.0,           ,1.0,1.0,58.0
4957,Liikkuminen,2020-08-21 15:59:59.999999987,2020-08-21,2020-08-21,2020-08-21,5.0,-31.1,1884.7,0.0,162.0,           ,1.0,1.0,104.0
4958,Ruoka_paivittaistavarakauppa,2020-08-24 02:12:24.827586193,2020-08-24,2020-08-24,2020-08-24,5.0,-24.99,1859.71,0.0,162.0,           ,1.0,1.0,167.0
4959,Asuminen,2020-08-24 12:24:49.655172399,2020-08-24,2020-08-24,2020-08-24,5.0,-23.09,1836.62,706.0,129.0,NDEAFIHH   ,0.0,0.0,250.0
4960,Ruoka_paivittaistavarakauppa,2020-08-24 19:18:37.241379296,2020-08-24,2020-08-24,2020-08-24,5.0,-8.68,1827.94,0.0,162.0,           ,1.0,1.0,131.0
4961,Shoppailu,2020-08-25 05:31:02.068965502,2020-08-25,2020-08-25,2020-08-25,5.0,-11.08,1816.86,0.0,162.0,           ,1.0,1.0,66.0
4962,Ruoka_paivittaistavarakauppa,2020-08-26 22:37:14.482758605,2020-08-26,2020-08-26,2020-08-26,5.0,-2.3,1814.56,0.0,162.0,           ,1.0,1.0,146.0
4963,Liikkuminen,2020-08-27 08:49:39.310344811,2020-08-27,2020-08-27,2020-08-27,5.0,-9.85,1804.71,0.0,162.0,           ,1.0,1.0,101.0
4964,Luokittelemattomat,2020-08-27 15:43:26.896551708,2020-08-27,2020-08-27,2020-08-27,5.0,-2.4,1802.31,0.0,162.0,           ,1.0,1.0,89.0
4965,Asuminen,2020-08-28 01:55:51.724137914,2020-08-28,2020-08-28,2020-08-28,5.0,-35.93,1766.38,706.0,147.0,OKOYFIHH   ,0.0,0.0,255.0
4966,Ruoka_paivittaistavarakauppa,2020-08-28 12:08:16.551724120,2020-08-28,2020-08-28,2020-08-28,5.0,-32.12,1734.26,0.0,162.0,           ,1.0,1.0,66.0
4967,Liikkuminen,2020-08-28 19:02:04.137931017,2020-08-28,2020-08-28,2020-08-28,5.0,-104.76,1629.5,0.0,162.0,           ,1.0,1.0,107.0
4968,Ravintolat_kahvilat,2020-08-31 05:14:28.965517223,2020-08-31,2020-08-31,2020-08-31,5.0,-31.13,1598.37,0.0,162.0,           ,1.0,1.0,133.0
4969,Ravintolat_kahvilat,2020-08-31 15:26:53.793103429,2020-08-31,2020-08-31,2020-08-31,5.0,-12.65,1585.72,0.0,162.0,           ,1.0,1.0,58.0
4970,Ruoka_paivittaistavarakauppa,2020-08-31 22:20:41.379310326,2020-08-31,2020-08-31,2020-08-31,5.0,-23.39,1562.33,0.0,162.0,           ,1.0,1.0,111.0
4971,Tulot,2020-09-01 10:59:32.519083969,2020-09-01,2020-09-01,2020-09-01,5.0,841.3,2403.63,701.0,520.0,           ,1.0,1.0,236.0
4972,Tulot,2020-09-02 08:58:37.557251907,2020-09-02,2020-09-02,2020-09-02,5.0,710.87,3114.5,701.0,520.0,           ,1.0,1.0,239.0
4973,Asuminen,2020-09-02 19:58:10.076335876,2020-09-02,2020-09-02,2020-09-02,5.0,-11.81,3102.69,0.0,162.0,           ,1.0,1.0,46.0
4974,Liikkuminen,2020-09-02 21:59:05.038167938,2020-09-02,2020-09-02,2020-09-02,5.0,-38.81,3063.88,0.0,162.0,           ,1.0,1.0,68.0
4975,Ruoka_paivittaistavarakauppa,2020-09-03 04:56:47.633587783,2020-09-03,2020-09-03,2020-09-03,5.0,-216.04,2847.84,0.0,192.0,           ,0.0,1.0,207.0
4976,Asuminen,2020-09-03 06:57:42.595419845,2020-09-03,2020-09-03,2020-09-03,5.0,-5.44,2842.4,0.0,162.0,           ,1.0,1.0,111.0
4977,Saastot_sijoitukset,2020-09-03 15:56:20.152671752,2020-09-03,2020-09-03,2020-09-03,5.0,-115.6,2726.8,0.0,192.0,           ,0.0,1.0,207.0
4978,Ravintolat_kahvilat,2020-09-03 17:57:15.114503814,2020-09-03,2020-09-03,2020-09-03,5.0,-42.01,2684.79,0.0,162.0,           ,1.0,1.0,89.0
4979,Luottojen_maksut,2020-09-07 00:54:57.709923659,2020-09-07,2020-09-07,2020-09-07,5.0,-58.47,2626.32,706.0,147.0,OKOYFIHH   ,0.0,0.0,255.0
4980,Tulot,2020-09-07 02:55:52.671755721,2020-09-07,2020-09-08,2020-09-07,5.0,1036.91,3663.23,701.0,520.0,           ,1.0,1.0,238.0
4981,Terveys,2020-09-07 05:51:45.343511442,2020-09-07,2020-09-07,2020-09-07,5.0,-13.39,3649.84,0.0,162.0,           ,1.0,1.0,91.0
4982,Ruoka_paivittaistavarakauppa,2020-09-07 09:53:35.267175566,2020-09-07,2020-09-07,2020-09-07,5.0,-12.17,3637.67,0.0,162.0,           ,1.0,1.0,147.0
4983,Shoppailu,2020-09-07 11:54:30.229007628,2020-09-07,2020-09-07,2020-09-07,5.0,-80.56,3557.11,0.0,162.0,           ,1.0,1.0,153.0
4984,Kulttuuri_viihde,2020-09-07 13:55:25.190839690,2020-09-07,2020-09-07,2020-09-07,5.0,-303.77,3253.34,706.0,147.0,OKOYFIHH   ,0.0,0.0,256.0
4985,Muut,2020-09-07 16:51:17.862595411,2020-09-07,2020-09-07,2020-09-07,5.0,-16.82,3236.52,0.0,103.0,           ,0.0,1.0,2.0
4986,Terveys,2020-09-07 20:53:07.786259535,2020-09-07,2020-09-07,2020-09-07,5.0,-20.9,3215.62,0.0,162.0,           ,1.0,1.0,145.0
4987,Liikkuminen,2020-09-07 22:54:02.748091597,2020-09-07,2020-09-07,2020-09-07,5.0,-26.37,3189.25,0.0,162.0,           ,1.0,1.0,120.0
4988,Ruoka_paivittaistavarakauppa,2020-09-08 07:52:40.305343504,2020-09-08,2020-09-08,2020-09-08,5.0,-47.79,3141.46,0.0,162.0,           ,1.0,1.0,48.0
4989,Matkailu,2020-09-08 18:52:12.824427473,2020-09-08,2020-09-08,2020-09-08,5.0,-203.76,2937.7,0.0,163.0,           ,1.0,1.0,193.0
4990,Muut,2020-09-10 03:50:50.381679380,2020-09-10,2020-09-10,2020-09-10,5.0,-91.38,2846.32,0.0,163.0,           ,1.0,1.0,194.0
4991,Muut,2020-09-10 14:50:22.900763349,2020-09-10,2020-09-10,2020-09-10,5.0,-1012.9,1833.42,0.0,105.0,OKOYFIHH   ,1.0,0.0,3.0
4992,Saastot_sijoitukset,2020-09-11 01:49:55.419847318,2020-09-11,2020-09-11,2020-09-11,5.0,-4.51,1828.91,0.0,162.0,           ,1.0,1.0,65.0
4993,Shoppailu,2020-09-11 12:49:27.938931287,2020-09-11,2020-09-11,2020-09-11,5.0,-3.51,1825.4,0.0,162.0,           ,1.0,1.0,121.0
4994,Ravintolat_kahvilat,2020-09-11 21:48:05.496183194,2020-09-11,2020-09-11,2020-09-11,5.0,-15.53,1809.87,0.0,162.0,           ,1.0,1.0,97.0
4995,Liikkuminen,2020-09-11 23:49:00.458015256,2020-09-11,2020-09-11,2020-09-11,5.0,-78.34,1731.53,0.0,162.0,           ,1.0,1.0,46.0
4996,Lemmikit,2020-09-14 06:46:43.053435101,2020-09-14,2020-09-14,2020-09-14,5.0,-34.89,1696.64,0.0,162.0,           ,1.0,1.0,176.0
4997,Ravintolat_kahvilat,2020-09-14 08:47:38.015267163,2020-09-14,2020-09-14,2020-09-14,5.0,-41.48,1655.16,0.0,162.0,           ,1.0,1.0,142.0
4998,Liikkuminen,2020-09-14 10:48:32.977099225,2020-09-14,2020-09-14,2020-09-14,5.0,-27.13,1628.03,0.0,162.0,           ,1.0,1.0,115.0
4999,Terveys,2020-09-14 15:45:20.610687008,2020-09-14,2020-09-14,2020-09-14,5.0,-21.4,1606.63,0.0,162.0,           ,1.0,1.0,90.0
5000,Lapset,2020-09-14 17:46:15.572519070,2020-09-14,2020-09-14,2020-09-14,5.0,-29.83,1576.8,0.0,162.0,           ,1.0,1.0,59.0
5001,Ruoka_paivittaistavarakauppa,2020-09-14 19:47:10.534351132,2020-09-14,2020-09-14,2020-09-14,5.0,-37.8,1539.0,0.0,162.0,           ,1.0,1.0,147.0
5002,Ravintolat_kahvilat,2020-09-15 13:44:25.648854946,2020-09-15,2020-09-15,2020-09-15,5.0,-2.18,1536.82,0.0,162.0,           ,1.0,1.0,68.0
5003,Ruoka_paivittaistavarakauppa,2020-09-16 00:43:58.167938915,2020-09-16,2020-09-16,2020-09-16,5.0,-19.78,1517.04,0.0,162.0,           ,1.0,1.0,93.0
5004,Tulot,2020-09-16 02:44:53.129770977,2020-09-16,2020-09-18,2020-09-16,5.0,-40.73,1476.31,706.0,129.0,OKOYFIHH   ,0.0,0.0,249.0
5005,Lemmikit,2020-09-16 04:45:48.091603039,2020-09-16,2020-09-16,2020-09-16,5.0,-18.23,1458.08,0.0,162.0,           ,1.0,1.0,48.0
5006,Hyvinvointijakauneus,2020-09-16 22:43:03.206106853,2020-09-16,2020-09-16,2020-09-16,5.0,-22.76,1435.32,0.0,162.0,           ,1.0,1.0,66.0
5007,Shoppailu,2020-09-17 11:43:30.687022884,2020-09-17,2020-09-17,2020-09-17,5.0,-143.44,1291.88,0.0,162.0,           ,1.0,1.0,114.0
5008,Ruoka_paivittaistavarakauppa,2020-09-18 07:41:40.763358760,2020-09-18,2020-09-18,2020-09-18,5.0,-9.09,1282.79,0.0,162.0,           ,1.0,1.0,114.0
5009,Ruoka_paivittaistavarakauppa,2020-09-18 09:42:35.725190822,2020-09-18,2020-09-18,2020-09-18,5.0,-22.74,1260.05,0.0,162.0,           ,1.0,1.0,122.0
5010,Asuminen,2020-09-18 20:42:08.244274791,2020-09-18,2020-09-18,2020-09-18,5.0,-14.42,1245.63,0.0,162.0,           ,1.0,1.0,105.0
5011,Matkailu,2020-09-20 18:41:13.282442729,2020-09-20,2020-09-20,2020-09-20,5.0,-18.44,1227.19,0.0,106.0,OKOYFIHH   ,0.0,0.0,22.0
5012,Ruoka_paivittaistavarakauppa,2020-09-21 01:38:55.877862574,2020-09-17,2020-09-21,2020-09-21,5.0,-4.54,1222.65,0.0,162.0,           ,1.0,1.0,174.0
5013,Ruoka_paivittaistavarakauppa,2020-09-21 03:39:50.839694636,2020-09-21,2020-09-21,2020-09-21,5.0,-31.17,1191.48,0.0,162.0,           ,1.0,1.0,120.0
5014,Saastot_sijoitukset,2020-09-21 12:38:28.396946543,2020-09-21,2020-09-21,2020-09-21,5.0,-6.3,1185.18,0.0,162.0,           ,1.0,1.0,164.0
5015,Ruoka_paivittaistavarakauppa,2020-09-21 14:39:23.358778605,2020-09-21,2020-09-21,2020-09-21,5.0,-11.74,1173.44,0.0,162.0,           ,1.0,1.0,93.0
5016,Ruoka_paivittaistavarakauppa,2020-09-21 16:40:18.320610667,2020-09-21,2020-09-21,2020-09-21,5.0,-120.92,1052.52,0.0,162.0,           ,1.0,1.0,192.0
5017,Asuminen,2020-09-21 23:38:00.916030512,2020-09-21,2020-09-21,2020-09-21,5.0,-184.21,868.31,706.0,129.0,NDEAFIHH   ,0.0,0.0,249.0
5018,Asuminen,2020-09-22 05:40:45.801526698,2020-09-22,2020-09-22,2020-09-22,5.0,-37.35,830.96,706.0,147.0,NDEAFIHH   ,0.0,0.0,257.0
5019,Ruoka_paivittaistavarakauppa,2020-09-23 08:36:38.473282419,2020-09-23,2020-09-23,2020-09-23,5.0,-88.26,742.7,0.0,162.0,           ,1.0,1.0,152.0
5020,Muut,2020-09-23 10:37:33.435114481,2020-09-23,2020-09-23,2020-09-23,5.0,-131.18,611.52,0.0,163.0,           ,1.0,1.0,193.0
5021,Ruoka_paivittaistavarakauppa,2020-09-23 21:37:05.954198450,2020-09-23,2020-09-23,2020-09-23,5.0,-10.02,601.5,0.0,162.0,           ,1.0,1.0,120.0
5022,Asuminen,2020-09-24 19:36:10.992366388,2020-09-24,2020-09-24,2020-09-24,5.0,-79.29,522.21,0.0,162.0,           ,1.0,1.0,142.0
5023,Ravintolat_kahvilat,2020-09-25 04:34:48.549618295,2020-09-25,2020-09-25,2020-09-25,5.0,-6.23,515.98,0.0,162.0,           ,1.0,1.0,66.0
5024,Ruoka_paivittaistavarakauppa,2020-09-25 06:35:43.511450357,2020-09-25,2020-09-25,2020-09-25,5.0,-10.92,505.06,0.0,162.0,           ,1.0,1.0,74.0
5025,Ravintolat_kahvilat,2020-09-25 15:34:21.068702264,2020-09-25,2020-09-25,2020-09-25,5.0,-18.19,486.87,0.0,162.0,           ,1.0,1.0,187.0
5026,Tulot,2020-09-25 17:35:16.030534326,2020-09-25,2020-09-25,2020-09-25,5.0,-111.89,374.98,0.0,162.0,           ,1.0,1.0,135.0
5027,Ruoka_paivittaistavarakauppa,2020-09-28 00:32:58.625954171,2020-09-28,2020-09-28,2020-09-28,5.0,-5.99,368.99,0.0,162.0,           ,1.0,1.0,58.0
5028,Tulot,2020-09-28 02:33:53.587786233,2020-09-28,2020-09-28,2020-09-28,5.0,-7.86,361.13,0.0,162.0,           ,1.0,1.0,114.0
5029,Saastot_sijoitukset,2020-09-28 11:32:31.145038140,2020-09-28,2020-09-28,2020-09-28,5.0,-16.32,344.81,0.0,162.0,           ,1.0,1.0,129.0
5030,Liikkuminen,2020-09-28 13:33:26.106870202,2020-09-28,2020-09-28,2020-09-28,5.0,-10.84,333.97,0.0,162.0,           ,1.0,1.0,121.0
5031,Lemmikit,2020-09-28 22:32:03.664122109,2020-09-28,2020-09-28,2020-09-28,5.0,-4.34,329.63,0.0,162.0,           ,1.0,1.0,109.0
5032,Saastot_sijoitukset,2020-09-29 09:31:36.183206078,2020-09-29,2020-09-29,2020-09-29,5.0,-1.69,327.94,0.0,162.0,           ,1.0,1.0,128.0
5033,Ruoka_paivittaistavarakauppa,2020-09-29 18:30:13.740457985,2020-09-29,2020-09-29,2020-09-29,5.0,-60.52,267.42,0.0,162.0,           ,1.0,1.0,162.0
5034,Hyvinvointijakauneus,2020-09-29 20:31:08.702290047,2020-09-29,2020-09-29,2020-09-29,5.0,-7.0,260.42,0.0,162.0,           ,1.0,1.0,48.0
5035,Hyvinvointi,2020-09-30 07:30:41.221374016,2020-09-30,2020-09-30,2020-09-30,5.0,-20.81,239.61,0.0,162.0,           ,1.0,1.0,84.0
5036,Ravintolat_kahvilat,2020-10-01 15:39:47.368421052,2020-10-01,2020-10-01,2020-10-01,5.0,-5.45,234.16,0.0,162.0,           ,1.0,1.0,58.0
5037,Ravintolat_kahvilat,2020-10-02 07:19:34.736842104,2020-10-02,2020-10-02,2020-10-02,5.0,-8.56,225.6,0.0,162.0,           ,1.0,1.0,139.0
5038,Ravintolat_kahvilat,2020-10-02 14:39:09.473684208,2020-10-02,2020-10-02,2020-10-02,5.0,-0.47,225.13,0.0,162.0,           ,1.0,1.0,178.0
5039,Ruoka_paivittaistavarakauppa,2020-10-02 22:59:22.105263156,2020-10-02,2020-10-02,2020-10-02,5.0,-82.87,142.26,0.0,162.0,           ,1.0,1.0,161.0
5040,Ruoka_paivittaistavarakauppa,2020-10-05 05:18:18.947368416,2020-10-05,2020-10-05,2020-10-05,5.0,-34.52,107.74,0.0,162.0,           ,1.0,1.0,154.0
5041,Muut,2020-10-05 06:18:56.842105260,2020-10-05,2020-10-05,2020-10-05,5.0,-14.89,92.85,0.0,105.0,OKOYFIHH   ,1.0,0.0,5.0
5042,Liikkuminen,2020-10-05 13:38:31.578947364,2020-10-05,2020-10-05,2020-10-05,5.0,-11.98,80.87,0.0,162.0,           ,1.0,1.0,133.0
5043,Ruoka_paivittaistavarakauppa,2020-10-05 20:58:06.315789468,2020-10-05,2020-10-05,2020-10-05,5.0,-10.01,70.86,0.0,162.0,           ,1.0,1.0,121.0
5044,Tulot,2020-10-06 21:58:44.210526312,2020-10-06,2020-10-06,2020-10-06,5.0,24.92,95.78,710.0,506.0,           ,1.0,1.0,264.0
5045,Ruoka_paivittaistavarakauppa,2020-10-07 12:37:53.684210520,2020-10-07,2020-10-07,2020-10-07,5.0,-5.18,90.6,0.0,162.0,           ,1.0,1.0,93.0
5046,Ruoka_paivittaistavarakauppa,2020-10-07 19:57:28.421052624,2020-10-07,2020-10-09,2020-10-07,5.0,-22.68,67.92,0.0,162.0,           ,1.0,1.0,46.0
5047,Muut,2020-10-08 04:17:41.052631572,2020-10-08,2020-10-08,2020-10-08,5.0,-54.66,13.26,0.0,162.0,           ,1.0,1.0,124.0
5048,Muut,2020-10-09 03:17:03.157894728,2020-10-09,2020-10-09,2020-10-09,5.0,-31.51,-18.25,0.0,163.0,           ,1.0,1.0,193.0
5049,Liikkuminen,2020-10-09 11:37:15.789473676,2020-10-09,2020-10-09,2020-10-09,5.0,-78.08,-96.33,0.0,162.0,           ,1.0,1.0,51.0
5050,Ruoka_paivittaistavarakauppa,2020-10-09 18:56:50.526315780,2020-10-09,2020-10-09,2020-10-09,5.0,-3.14,-99.47,0.0,162.0,           ,1.0,1.0,149.0
5051,Saastot_sijoitukset,2020-10-12 02:16:25.263157884,2020-10-12,2020-10-12,2020-10-12,5.0,-2.83,-102.3,0.0,162.0,           ,1.0,1.0,46.0
5052,Ravintolat_kahvilat,2020-10-12 09:35:59.999999988,2020-10-12,2020-10-12,2020-10-12,5.0,-12.05,-114.35,0.0,162.0,           ,1.0,1.0,101.0
5053,Ruoka_paivittaistavarakauppa,2020-10-12 10:36:37.894736832,2020-10-12,2020-10-12,2020-10-12,5.0,-7.72,-122.07,0.0,162.0,           ,1.0,1.0,56.0
5054,Ruoka_paivittaistavarakauppa,2020-10-12 17:56:12.631578936,2020-10-12,2020-10-12,2020-10-12,5.0,-1.66,-123.73,0.0,162.0,           ,1.0,1.0,131.0
5055,Ruoka_paivittaistavarakauppa,2020-10-13 01:15:47.368421040,2020-10-13,2020-10-13,2020-10-13,5.0,-29.97,-153.7,0.0,162.0,           ,1.0,1.0,97.0
5056,Ruoka_paivittaistavarakauppa,2020-10-15 07:34:44.210526300,2020-10-15,2020-10-19,2020-10-15,5.0,-14.69,-168.39,0.0,162.0,           ,1.0,1.0,105.0
5057,Hyvinvointijakauneus,2020-10-15 08:35:22.105263144,2020-10-15,2020-10-15,2020-10-15,5.0,-18.34,-186.73,0.0,106.0,OKOYFIHH   ,0.0,0.0,43.0
5058,Ruoka_paivittaistavarakauppa,2020-10-15 15:54:56.842105248,2020-10-15,2020-10-15,2020-10-15,5.0,-12.09,-198.82,0.0,162.0,           ,1.0,1.0,121.0
5059,Ruoka_paivittaistavarakauppa,2020-10-15 16:55:34.736842092,2020-10-15,2020-10-15,2020-10-15,5.0,-1.64,-200.46,0.0,162.0,           ,1.0,1.0,66.0
5060,Ravintolat_kahvilat,2020-10-16 00:15:09.473684196,2020-10-16,2020-10-16,2020-10-16,5.0,-10.91,-211.37,0.0,162.0,           ,1.0,1.0,84.0
5061,Luottojen_maksut,2020-10-19 06:34:06.315789456,2020-10-19,2020-10-19,2020-10-19,5.0,-43.41,-254.78,0.0,172.0,           ,1.0,1.0,203.0
5062,Harrastukset,2020-10-19 13:53:41.052631560,2020-10-19,2020-10-19,2020-10-19,5.0,-24.06,-278.84,0.0,172.0,           ,1.0,1.0,202.0
5063,Ravintolat_kahvilat,2020-10-19 14:54:18.947368404,2020-10-19,2020-10-19,2020-10-19,5.0,-3.68,-282.52,0.0,162.0,           ,1.0,1.0,173.0
5064,Matkailu,2020-10-19 22:13:53.684210508,2020-10-19,2020-10-19,2020-10-19,5.0,-5.58,-288.1,0.0,172.0,           ,1.0,1.0,202.0
5065,Ruoka_paivittaistavarakauppa,2020-10-19 23:14:31.578947352,2020-10-19,2020-10-19,2020-10-19,5.0,-11.72,-299.82,0.0,162.0,           ,1.0,1.0,54.0
5066,Luokittelemattomat,2020-10-21 05:33:28.421052612,2020-10-21,2020-10-21,2020-10-23,5.0,-7.01,-306.83,706.0,129.0,OKOYFIHH   ,1.0,0.0,249.0
5067,Ruoka_paivittaistavarakauppa,2020-10-21 21:13:15.789473664,2020-10-21,2020-10-21,2020-10-21,5.0,-3.98,-310.81,0.0,162.0,           ,1.0,1.0,121.0
5068,Ruoka_paivittaistavarakauppa,2020-10-22 04:32:50.526315768,2020-10-22,2020-10-22,2020-10-22,5.0,-2.52,-313.33,0.0,162.0,           ,1.0,1.0,124.0
5069,Ruoka_paivittaistavarakauppa,2020-10-22 20:12:37.894736820,2020-10-22,2020-10-22,2020-10-22,5.0,-4.24,-317.57,0.0,162.0,           ,1.0,1.0,182.0
5070,Ruoka_paivittaistavarakauppa,2020-10-23 12:53:03.157894716,2020-10-23,2020-10-23,2020-10-23,5.0,-3.84,-321.41,0.0,162.0,           ,1.0,1.0,114.0
5071,Ruoka_paivittaistavarakauppa,2020-10-26 03:32:12.631578924,2020-10-26,2020-10-26,2020-10-26,5.0,-2.28,-323.69,0.0,162.0,           ,1.0,1.0,164.0
5072,Tulot,2020-10-26 10:51:47.368421028,2020-10-26,2020-10-26,2020-10-26,5.0,-6.9,-330.59,0.0,162.0,           ,1.0,1.0,141.0
5073,Ruoka_paivittaistavarakauppa,2020-10-26 11:52:25.263157872,2020-10-26,2020-10-26,2020-10-26,5.0,-7.72,-338.31,0.0,162.0,           ,1.0,1.0,164.0
5074,Ruoka_paivittaistavarakauppa,2020-10-26 19:11:59.999999976,2020-10-26,2020-10-26,2020-10-26,5.0,-1.67,-339.98,0.0,162.0,           ,1.0,1.0,127.0
5075,Matkailu,2020-10-27 02:31:34.736842080,2020-10-27,2020-10-27,2020-10-27,5.0,-0.77,-340.75,0.0,162.0,           ,1.0,1.0,168.0
5076,Lapset,2020-10-27 18:11:22.105263132,2020-10-27,2020-10-27,2020-10-27,5.0,-1.44,-342.19,0.0,162.0,           ,1.0,1.0,77.0
5077,Tulot,2020-10-28 09:51:09.473684184,2020-10-28,2020-10-28,2020-10-28,5.0,-17.2,-359.39,706.0,129.0,OKOYFIHH   ,0.0,0.0,253.0
5078,Ruoka_paivittaistavarakauppa,2020-10-28 17:10:44.210526288,2020-10-28,2020-10-28,2020-10-28,5.0,-4.71,-364.1,0.0,162.0,           ,1.0,1.0,180.0
5079,Tulot,2020-10-30 00:30:18.947368392,2020-10-30,2020-10-30,2020-10-30,5.0,173.06,-191.04,710.0,506.0,           ,1.0,1.0,261.0
5080,Luokittelemattomat,2020-10-30 01:30:56.842105236,2020-10-30,2020-10-30,2020-10-30,5.0,-31.09,-222.13,0.0,106.0,OKOYFIHH   ,1.0,0.0,43.0
5081,Ruoka_paivittaistavarakauppa,2020-10-30 08:50:31.578947340,2020-10-30,2020-10-30,2020-10-30,5.0,-5.39,-227.52,0.0,162.0,           ,1.0,1.0,97.0
5082,Ruoka_paivittaistavarakauppa,2020-10-30 16:10:06.315789444,2020-10-30,2020-10-30,2020-10-30,5.0,-12.42,-239.94,0.0,162.0,           ,1.0,1.0,120.0
5083,Asuminen,2020-11-02 04:14:07.058823528,2020-11-02,2020-11-02,2020-11-02,5.0,-40.0,-279.94,706.0,129.0,OKOYFIHH   ,0.0,0.0,249.0
5084,Tulot,2020-11-02 09:24:42.352941176,2020-11-02,2020-11-02,2020-11-02,5.0,1454.09,1174.15,701.0,520.0,           ,1.0,1.0,237.0
5085,Ravintolat_kahvilat,2020-11-02 13:38:49.411764704,2020-11-02,2020-11-02,2020-11-04,5.0,-7.37,1166.78,0.0,162.0,           ,1.0,1.0,135.0
5086,Asuminen,2020-11-02 18:49:24.705882352,2020-11-02,2020-11-02,2020-11-02,5.0,-38.82,1127.96,706.0,129.0,OKOYFIHH   ,0.0,0.0,253.0
5087,Saastot_sijoitukset,2020-11-02 23:03:31.764705880,2020-11-02,2020-11-02,2020-11-02,5.0,-21.67,1106.29,0.0,162.0,           ,1.0,1.0,153.0
5088,Matkailu,2020-11-03 08:28:14.117647056,2020-11-03,2020-11-03,2020-11-03,5.0,-77.51,1028.78,0.0,162.0,           ,1.0,1.0,174.0
5089,Ravintolat_kahvilat,2020-11-03 17:52:56.470588232,2020-11-03,2020-11-03,2020-11-03,5.0,-149.87,878.91,0.0,163.0,           ,1.0,1.0,193.0
5090,Saastot_sijoitukset,2020-11-04 03:17:38.823529408,2020-11-04,2020-11-04,2020-11-04,5.0,-10.07,868.84,0.0,162.0,           ,1.0,1.0,174.0
5091,Liikkuminen,2020-11-04 12:42:21.176470584,2020-11-04,2020-11-04,2020-11-04,5.0,-51.83,817.01,0.0,162.0,           ,1.0,1.0,152.0
5092,Asuminen,2020-11-04 16:56:28.235294112,2020-11-04,2020-11-04,2020-11-04,5.0,-11.75,805.26,0.0,162.0,           ,1.0,1.0,188.0
5093,Ruoka_paivittaistavarakauppa,2020-11-04 22:07:03.529411760,2020-11-04,2020-11-04,2020-11-04,5.0,-16.52,788.74,0.0,162.0,           ,1.0,1.0,97.0
5094,Matkailu,2020-11-05 02:21:10.588235288,2020-11-05,2020-11-05,2020-11-05,5.0,-138.06,650.68,0.0,162.0,           ,1.0,1.0,72.0
5095,Muut,2020-11-05 06:35:17.647058816,2020-11-05,2020-11-05,2020-11-05,5.0,-13.01,637.67,0.0,162.0,           ,1.0,1.0,171.0
5096,Luottojen_maksut,2020-11-05 07:31:45.882352936,2020-11-05,2020-11-05,2020-11-05,5.0,-31.51,606.16,706.0,106.0,NDEAFIHH   ,0.0,0.0,245.0
5097,Ruoka_paivittaistavarakauppa,2020-11-05 11:45:52.941176464,2020-11-05,2020-11-05,2020-11-05,5.0,-27.95,578.21,0.0,162.0,           ,1.0,1.0,171.0
5098,Luokittelemattomat,2020-11-05 15:59:59.999999992,2020-11-05,2020-11-05,2020-11-05,5.0,-23.81,554.4,0.0,106.0,NDEAFIHH   ,0.0,0.0,40.0
5099,Ravintolat_kahvilat,2020-11-05 21:10:35.294117640,2020-11-05,2020-11-05,2020-11-05,5.0,-3.7,550.7,0.0,162.0,           ,1.0,1.0,120.0
5100,Luokittelemattomat,2020-11-09 01:24:42.352941168,2020-11-09,2020-11-09,2020-11-09,5.0,-19.57,531.13,706.0,106.0,OKOYFIHH   ,0.0,0.0,246.0
5101,Ruoka_paivittaistavarakauppa,2020-11-09 10:49:24.705882344,2020-11-09,2020-11-09,2020-11-09,5.0,-4.01,527.12,0.0,162.0,           ,1.0,1.0,87.0
5102,Terveys,2020-11-09 15:03:31.764705872,2020-11-09,2020-11-09,2020-11-09,5.0,-9.32,517.8,0.0,162.0,           ,1.0,1.0,74.0
5103,Tulot,2020-11-09 20:14:07.058823520,2020-11-09,2020-11-09,2020-11-09,5.0,-35.82,481.98,0.0,162.0,           ,1.0,1.0,174.0
5104,Ruoka_paivittaistavarakauppa,2020-11-10 00:28:14.117647048,2020-11-10,2020-11-10,2020-11-10,5.0,-10.38,471.6,0.0,162.0,           ,1.0,1.0,142.0
5105,Tulot,2020-11-10 05:38:49.411764696,2020-11-10,2020-11-10,2020-11-10,5.0,20.94,492.54,701.0,510.0,           ,1.0,1.0,234.0
5106,Ruoka_paivittaistavarakauppa,2020-11-10 09:52:56.470588224,2020-11-10,2020-11-13,2020-11-10,5.0,-3.7,488.84,0.0,162.0,           ,1.0,1.0,58.0
5107,Ruoka_paivittaistavarakauppa,2020-11-10 19:17:38.823529400,2020-11-10,2020-11-11,2020-11-10,5.0,-5.2,483.64,0.0,162.0,           ,1.0,1.0,120.0
5108,Luokittelemattomat,2020-11-11 04:42:21.176470576,2020-11-11,2020-11-11,2020-11-11,5.0,-296.89,186.75,0.0,106.0,DABAFIHH   ,1.0,0.0,33.0
5109,Luokittelemattomat,2020-11-12 14:07:03.529411752,2020-11-12,2020-11-12,2020-11-12,5.0,-62.5,124.25,0.0,106.0,OKOYFIHH   ,0.0,0.0,13.0
5110,Saastot_sijoitukset,2020-11-12 18:21:10.588235280,2020-11-12,2020-11-12,2020-11-12,5.0,-17.92,106.33,0.0,162.0,           ,1.0,1.0,170.0
5111,Luottojen_maksut,2020-11-12 23:31:45.882352928,2020-11-12,2020-11-13,2020-11-12,5.0,-55.89,50.44,0.0,106.0,OKOYFIHH   ,1.0,0.0,27.0
5112,Ruoka_paivittaistavarakauppa,2020-11-13 03:45:52.941176456,2020-11-13,2020-11-13,2020-11-13,5.0,-5.17,45.27,0.0,162.0,           ,1.0,1.0,114.0
5113,Ravintolat_kahvilat,2020-11-13 08:56:28.235294104,2020-11-13,2020-11-13,2020-11-13,5.0,-5.4,39.87,0.0,106.0,OKOYFIHH   ,0.0,0.0,33.0
5114,Ravintolat_kahvilat,2020-11-13 12:14:07.058823512,2020-11-13,2020-11-13,2020-11-13,5.0,-1.39,38.48,0.0,162.0,           ,1.0,1.0,104.0
5115,Ruoka_paivittaistavarakauppa,2020-11-13 13:10:35.294117632,2020-11-13,2020-11-13,2020-11-13,5.0,-2.56,35.92,0.0,162.0,           ,1.0,1.0,182.0
5116,Muut,2020-11-13 22:35:17.647058808,2020-11-13,2020-11-13,2020-11-13,5.0,-4.68,31.24,0.0,162.0,           ,1.0,1.0,188.0
5117,Muut,2020-11-15 17:24:42.352941160,2020-11-15,2020-11-15,2020-11-15,5.0,-10.97,20.27,0.0,163.0,           ,1.0,1.0,193.0
5118,Ruoka_paivittaistavarakauppa,2020-11-16 01:52:56.470588216,2020-11-16,2020-11-16,2020-11-16,5.0,-4.32,15.95,0.0,162.0,           ,1.0,1.0,163.0
5119,Asuminen,2020-11-16 02:49:24.705882336,2020-11-16,2020-11-16,2020-11-16,5.0,-36.03,-20.08,706.0,129.0,OKOYFIHH   ,0.0,0.0,250.0
5120,Ruoka_paivittaistavarakauppa,2020-11-16 07:03:31.764705864,2020-11-16,2020-11-16,2020-11-16,5.0,-3.58,-23.66,0.0,162.0,           ,1.0,1.0,57.0
5121,Ravintolat_kahvilat,2020-11-16 07:59:59.999999984,2020-11-16,2020-11-16,2020-11-16,5.0,-4.41,-28.07,0.0,162.0,           ,1.0,1.0,164.0
5122,Liikkuminen,2020-11-16 16:28:14.117647040,2020-11-16,2020-11-16,2020-11-16,5.0,-7.6,-35.67,0.0,162.0,           ,1.0,1.0,70.0
5123,Ruoka_paivittaistavarakauppa,2020-11-16 20:42:21.176470568,2020-11-16,2020-11-16,2020-11-16,5.0,-5.6,-41.27,0.0,162.0,           ,1.0,1.0,130.0
5124,Ruoka_paivittaistavarakauppa,2020-11-16 21:38:49.411764688,2020-11-16,2020-11-16,2020-11-16,5.0,-0.21,-41.48,0.0,162.0,           ,1.0,1.0,104.0
5125,Ruoka_paivittaistavarakauppa,2020-11-17 11:17:38.823529392,2020-11-17,2020-11-17,2020-11-17,5.0,-12.9,-54.38,0.0,162.0,           ,1.0,1.0,123.0
5126,Ruoka_paivittaistavarakauppa,2020-11-18 06:07:03.529411744,2020-11-18,2020-11-19,2020-11-18,5.0,-4.96,-59.34,0.0,162.0,           ,1.0,1.0,124.0
5127,Kulttuuri_viihde,2020-11-18 15:31:45.882352920,2020-11-18,2020-11-18,2020-11-18,5.0,-10.3,-69.64,0.0,162.0,           ,1.0,1.0,46.0
5128,Ruoka_paivittaistavarakauppa,2020-11-19 00:56:28.235294096,2020-11-19,2020-11-19,2020-11-19,5.0,-9.21,-78.85,0.0,162.0,           ,1.0,1.0,47.0
5129,Liikkuminen,2020-11-19 10:21:10.588235272,2020-11-19,2020-11-19,2020-11-19,5.0,-9.38,-88.23,0.0,162.0,           ,1.0,1.0,125.0
5130,Luokittelemattomat,2020-11-19 19:45:52.941176448,2020-11-19,2020-11-19,2020-11-19,5.0,-2.49,-90.72,0.0,162.0,           ,1.0,1.0,131.0
5131,Ruoka_paivittaistavarakauppa,2020-11-20 04:14:07.058823504,2020-11-20,2020-11-20,2020-11-20,5.0,-0.49,-91.21,0.0,162.0,           ,1.0,1.0,126.0
5132,Tulot,2020-11-20 05:10:35.294117624,2020-11-20,2020-11-20,2020-11-20,5.0,188.97,97.76,710.0,506.0,           ,1.0,1.0,263.0
5133,Liikkuminen,2020-11-20 09:24:42.352941152,2020-11-20,2020-11-20,2020-11-20,5.0,-1.47,96.29,0.0,162.0,           ,1.0,1.0,146.0
5134,Ravintolat_kahvilat,2020-11-20 14:35:17.647058800,2020-11-20,2020-11-20,2020-11-20,5.0,-12.64,83.65,0.0,162.0,           ,1.0,1.0,132.0
5135,Ruoka_paivittaistavarakauppa,2020-11-20 18:49:24.705882328,2020-11-20,2020-11-20,2020-11-20,5.0,-4.9,78.75,0.0,162.0,           ,1.0,1.0,55.0
5136,Muut,2020-11-20 23:59:59.999999976,2020-11-20,2020-11-20,2020-11-20,5.0,-50.04,28.71,0.0,163.0,           ,1.0,1.0,194.0
5137,Matkailu,2020-11-23 07:31:45.882352912,2020-11-23,2020-11-23,2020-11-23,5.0,-13.24,15.47,706.0,105.0,OKOYFIHH   ,1.0,0.0,242.0
5138,Ruoka_paivittaistavarakauppa,2020-11-23 08:28:14.117647032,2020-11-23,2020-11-23,2020-11-23,5.0,-15.44,0.03,0.0,162.0,           ,1.0,1.0,107.0
5139,Muut,2020-11-23 12:42:21.176470560,2020-11-23,2020-11-23,2020-11-23,5.0,-0.51,-0.48,0.0,162.0,           ,1.0,1.0,119.0
5140,Ruoka_paivittaistavarakauppa,2020-11-23 13:38:49.411764680,2020-11-23,2020-11-23,2020-11-23,5.0,-8.45,-8.93,0.0,162.0,           ,1.0,1.0,164.0
5141,Asuminen,2020-11-23 16:56:28.235294088,2020-11-23,2020-11-23,2020-11-23,5.0,-92.7,-101.63,706.0,129.0,DABAFIHH   ,0.0,0.0,249.0
5142,Ruoka_paivittaistavarakauppa,2020-11-23 17:52:56.470588208,2020-11-23,2020-11-23,2020-11-23,5.0,-1.62,-103.25,0.0,162.0,           ,1.0,1.0,101.0
5143,Kulttuuri_viihde,2020-11-23 23:03:31.764705856,2020-11-23,2020-11-23,2020-11-23,5.0,-5.4,-108.65,0.0,162.0,           ,1.0,1.0,136.0
5144,Ruoka_paivittaistavarakauppa,2020-11-24 03:17:38.823529384,2020-11-24,2020-11-24,2020-11-24,5.0,-9.98,-118.63,0.0,162.0,           ,1.0,1.0,162.0
5145,Ravintolat_kahvilat,2020-11-24 22:07:03.529411736,2020-11-24,2020-11-24,2020-11-23,5.0,-5.57,-124.2,0.0,162.0,           ,1.0,1.0,135.0
5146,Tulot,2020-11-25 11:45:52.941176440,2020-11-25,2020-11-25,2020-11-25,5.0,306.14,181.94,701.0,510.0,           ,1.0,1.0,234.0
5147,Ruoka_paivittaistavarakauppa,2020-11-26 01:24:42.352941144,2020-11-26,2020-11-26,2020-11-26,5.0,-6.61,175.33,0.0,162.0,           ,1.0,1.0,145.0
5148,Luokittelemattomat,2020-11-26 20:14:07.058823496,2020-11-26,2020-11-26,2020-11-26,5.0,-80.73,94.6,0.0,162.0,           ,1.0,1.0,47.0
5149,Luokittelemattomat,2020-11-26 21:10:35.294117616,2020-11-26,2020-11-26,2020-11-26,5.0,-10.31,84.29,0.0,162.0,           ,1.0,1.0,128.0
5150,Ruoka_paivittaistavarakauppa,2020-11-27 02:21:10.588235264,2020-11-27,2020-11-27,2020-11-27,5.0,-0.35,83.94,0.0,162.0,           ,1.0,1.0,66.0
5151,Ruoka_paivittaistavarakauppa,2020-11-27 06:35:17.647058792,2020-11-27,2020-11-27,2020-11-27,5.0,-10.63,73.31,0.0,162.0,           ,1.0,1.0,104.0
5152,Harrastukset,2020-11-27 10:49:24.705882320,2020-11-27,2020-11-27,2020-11-27,5.0,-22.32,50.99,0.0,162.0,           ,1.0,1.0,116.0
5153,Ravintolat_kahvilat,2020-11-27 15:59:59.999999968,2020-11-27,2020-11-27,2020-11-27,5.0,-2.59,48.4,0.0,162.0,           ,1.0,1.0,187.0
5154,Ruoka_paivittaistavarakauppa,2020-11-30 00:28:14.117647024,2020-11-30,2020-11-30,2020-12-02,5.0,-12.38,36.02,0.0,162.0,           ,1.0,1.0,160.0
5155,Shoppailu,2020-11-30 05:38:49.411764672,2020-11-30,2020-11-30,2020-11-30,5.0,-4.09,31.93,0.0,162.0,           ,1.0,1.0,127.0
5156,Liikkuminen,2020-11-30 09:52:56.470588200,2020-11-30,2020-11-30,2020-11-30,5.0,-2.64,29.29,0.0,162.0,           ,1.0,1.0,46.0
5157,Ruoka_paivittaistavarakauppa,2020-11-30 15:03:31.764705848,2020-11-30,2020-11-30,2020-12-01,5.0,-4.83,24.46,0.0,162.0,           ,1.0,1.0,58.0
5158,Lemmikit,2020-11-30 19:17:38.823529376,2020-11-30,2020-11-30,2020-11-30,5.0,-3.05,21.41,0.0,162.0,           ,1.0,1.0,120.0
5159,Ruoka_paivittaistavarakauppa,2020-12-01 11:32:05.581395348,2020-12-01,2020-12-01,2020-12-01,5.0,-18.01,3.4,0.0,162.0,           ,1.0,1.0,107.0
5160,Ruoka_paivittaistavarakauppa,2020-12-01 23:04:11.162790696,2020-12-01,2020-12-01,2020-12-01,5.0,-3.14,0.26,0.0,162.0,           ,1.0,1.0,56.0
5161,Luokittelemattomat,2020-12-02 10:36:16.744186044,2020-12-02,2020-12-04,2020-12-02,5.0,-9.0,-8.74,0.0,162.0,           ,1.0,1.0,174.0
5162,Lemmikit,2020-12-02 22:08:22.325581392,2020-12-02,2020-12-02,2020-12-02,5.0,-3.28,-12.02,0.0,162.0,           ,1.0,1.0,122.0
5163,Asuminen,2020-12-03 09:40:27.906976740,2020-12-03,2020-12-03,2020-12-03,5.0,-8.82,-20.84,0.0,162.0,           ,1.0,1.0,66.0
5164,Liikkuminen,2020-12-03 18:25:06.976744176,2020-12-03,2020-12-03,2020-12-03,5.0,-2.83,-23.67,0.0,162.0,           ,1.0,1.0,134.0
5165,Ravintolat_kahvilat,2020-12-03 21:12:33.488372088,2020-12-03,2020-12-03,2020-12-03,5.0,-2.14,-25.81,0.0,162.0,           ,1.0,1.0,104.0
5166,Ruoka_paivittaistavarakauppa,2020-12-04 08:44:39.069767436,2020-12-04,2020-12-04,2020-12-04,5.0,-2.12,-27.93,0.0,162.0,           ,1.0,1.0,177.0
5167,Lapset,2020-12-04 19:20:55.813953480,2020-12-04,2020-12-04,2020-12-04,5.0,-14.49,-42.42,0.0,162.0,           ,1.0,1.0,126.0
5168,Ruoka_paivittaistavarakauppa,2020-12-04 20:16:44.651162784,2020-12-04,2020-12-04,2020-12-04,5.0,-9.05,-51.47,0.0,162.0,           ,1.0,1.0,144.0
5169,Ruoka_paivittaistavarakauppa,2020-12-07 05:57:12.558139524,2020-12-03,2020-12-07,2020-12-07,5.0,-8.04,-59.51,0.0,162.0,           ,1.0,1.0,117.0
5170,Matkailu,2020-12-07 06:53:01.395348828,2020-12-07,2020-12-07,2020-12-07,5.0,-1.83,-61.34,0.0,162.0,           ,1.0,1.0,67.0
5171,Ruoka_paivittaistavarakauppa,2020-12-07 07:48:50.232558132,2020-12-07,2020-12-07,2020-12-07,5.0,-4.53,-65.87,0.0,162.0,           ,1.0,1.0,138.0
5172,Muut,2020-12-07 17:29:18.139534872,2020-12-07,2020-12-07,2020-12-07,5.0,-21.16,-87.03,0.0,162.0,           ,1.0,1.0,136.0
5173,Ruoka_paivittaistavarakauppa,2020-12-08 05:01:23.720930220,2020-12-08,2020-12-08,2020-12-08,5.0,-16.44,-103.47,0.0,162.0,           ,1.0,1.0,133.0
5174,Ruoka_paivittaistavarakauppa,2020-12-08 16:33:29.302325568,2020-12-08,2020-12-08,2020-12-08,5.0,-2.89,-106.36,0.0,162.0,           ,1.0,1.0,97.0
5175,Ruoka_paivittaistavarakauppa,2020-12-09 15:37:40.465116264,2020-12-09,2020-12-09,2020-12-09,5.0,-5.54,-111.9,0.0,162.0,           ,1.0,1.0,142.0
5176,Ravintolat_kahvilat,2020-12-10 03:09:46.046511612,2020-12-10,2020-12-10,2020-12-10,5.0,-26.96,-138.86,0.0,162.0,           ,1.0,1.0,70.0
5177,Ruoka_paivittaistavarakauppa,2020-12-10 14:41:51.627906960,2020-12-10,2020-12-10,2020-12-10,5.0,-0.6,-139.46,0.0,162.0,           ,1.0,1.0,142.0
5178,Ruoka_paivittaistavarakauppa,2020-12-11 01:18:08.372093004,2020-12-11,2020-12-11,2020-12-11,5.0,-2.73,-142.19,0.0,162.0,           ,1.0,1.0,121.0
5179,Ruoka_paivittaistavarakauppa,2020-12-11 02:13:57.209302308,2020-12-11,2020-12-11,2020-12-11,5.0,-6.05,-148.24,0.0,162.0,           ,1.0,1.0,147.0
5180,Ruoka_paivittaistavarakauppa,2020-12-11 04:05:34.883720916,2020-12-11,2020-12-11,2020-12-11,5.0,-6.32,-154.56,0.0,162.0,           ,1.0,1.0,122.0
5181,Ruoka_paivittaistavarakauppa,2020-12-11 11:54:25.116279048,2020-12-11,2020-12-11,2020-12-11,5.0,-3.25,-157.81,0.0,162.0,           ,1.0,1.0,167.0
5182,Ruoka_paivittaistavarakauppa,2020-12-11 12:50:13.953488352,2020-12-11,2020-12-11,2020-12-11,5.0,-4.48,-162.29,0.0,162.0,           ,1.0,1.0,154.0
5183,Ruoka_paivittaistavarakauppa,2020-12-11 13:46:02.790697656,2020-12-11,2020-12-11,2020-12-11,5.0,-8.65,-170.94,0.0,162.0,           ,1.0,1.0,133.0
5184,Liikkuminen,2020-12-14 00:22:19.534883700,2020-12-14,2020-12-14,2020-12-14,5.0,-16.15,-187.09,0.0,162.0,           ,1.0,1.0,128.0
5185,Matkailu,2020-12-14 10:58:36.279069744,2020-12-14,2020-12-14,2020-12-14,5.0,-4.13,-191.22,0.0,162.0,           ,1.0,1.0,121.0
5186,Ruoka_paivittaistavarakauppa,2020-12-14 20:39:04.186046484,2020-12-14,2020-12-15,2020-12-14,5.0,-16.88,-208.1,0.0,162.0,           ,1.0,1.0,129.0
5187,Ruoka_paivittaistavarakauppa,2020-12-14 22:30:41.860465092,2020-12-14,2020-12-14,2020-12-14,5.0,-12.62,-220.72,0.0,162.0,           ,1.0,1.0,141.0
5188,Ruoka_paivittaistavarakauppa,2020-12-14 23:26:30.697674396,2020-12-14,2020-12-14,2020-12-14,5.0,-14.74,-235.46,0.0,162.0,           ,1.0,1.0,187.0
5189,Muut,2020-12-15 09:06:58.604651136,2020-12-15,2020-12-15,2020-12-15,5.0,-1.26,-236.72,0.0,162.0,           ,1.0,1.0,135.0
5190,Ruoka_paivittaistavarakauppa,2020-12-15 10:02:47.441860440,2020-12-15,2020-12-15,2020-12-15,5.0,-4.08,-240.8,0.0,162.0,           ,1.0,1.0,121.0
5191,Ravintolat_kahvilat,2020-12-15 21:34:53.023255788,2020-12-15,2020-12-15,2020-12-15,5.0,-7.36,-248.16,0.0,162.0,           ,1.0,1.0,123.0
5192,Ruoka_paivittaistavarakauppa,2020-12-17 08:11:09.767441832,2020-12-17,2020-12-17,2020-12-17,5.0,-8.56,-256.72,0.0,162.0,           ,1.0,1.0,141.0
5193,Muut,2020-12-18 05:23:43.255813920,2020-12-18,2020-12-18,2020-12-18,5.0,-7.06,-263.78,0.0,162.0,           ,1.0,1.0,156.0
5194,Hyvinvointijakauneus,2020-12-18 07:15:20.930232528,2020-12-18,2020-12-18,2020-12-18,5.0,-2.23,-266.01,0.0,162.0,           ,1.0,1.0,84.0
5195,Ruoka_paivittaistavarakauppa,2020-12-18 17:51:37.674418572,2020-12-18,2020-12-18,2020-12-18,5.0,-2.84,-268.85,0.0,162.0,           ,1.0,1.0,109.0
5196,Ruoka_paivittaistavarakauppa,2020-12-18 18:47:26.511627876,2020-12-18,2020-12-18,2020-12-18,5.0,-5.69,-274.54,0.0,162.0,           ,1.0,1.0,47.0
5197,Ruoka_paivittaistavarakauppa,2020-12-18 19:43:15.348837180,2020-12-18,2020-12-18,2020-12-18,5.0,-2.07,-276.61,0.0,162.0,           ,1.0,1.0,114.0
5198,Ruoka_paivittaistavarakauppa,2020-12-21 03:32:05.581395312,2020-12-21,2020-12-21,2020-12-21,5.0,-4.2,-280.81,0.0,162.0,           ,1.0,1.0,125.0
5199,Shoppailu,2020-12-21 04:27:54.418604616,2020-12-21,2020-12-21,2020-12-21,5.0,-14.06,-294.87,0.0,162.0,           ,1.0,1.0,174.0
5200,Muut,2020-12-21 06:19:32.093023224,2020-12-21,2020-12-21,2020-12-21,5.0,-8.02,-302.89,0.0,162.0,           ,1.0,1.0,127.0
5201,Tulot,2020-12-21 15:04:11.162790660,2020-12-21,2020-12-21,2020-12-21,5.0,1475.33,1172.44,0.0,506.0,           ,1.0,1.0,217.0
5202,Ruoka_paivittaistavarakauppa,2020-12-21 15:59:59.999999964,2020-12-21,2020-12-21,2020-12-21,5.0,-6.49,1165.95,0.0,162.0,           ,1.0,1.0,61.0
5203,Ruoka_paivittaistavarakauppa,2020-12-21 16:55:48.837209268,2020-12-21,2020-12-21,2020-12-21,5.0,-41.27,1124.68,0.0,162.0,           ,1.0,1.0,174.0
5204,Ravintolat_kahvilat,2020-12-23 02:36:16.744186008,2020-12-23,2020-12-23,2020-12-23,5.0,-20.34,1104.34,0.0,162.0,           ,1.0,1.0,107.0
5205,Lapset,2020-12-23 14:08:22.325581356,2020-12-23,2020-12-23,2020-12-23,5.0,-113.52,990.82,0.0,162.0,           ,1.0,1.0,144.0
5206,Shoppailu,2020-12-24 00:44:39.069767400,2020-12-24,2020-12-24,2020-12-24,5.0,-14.51,976.31,0.0,162.0,           ,1.0,1.0,63.0
5207,Ravintolat_kahvilat,2020-12-24 11:20:55.813953444,2020-12-24,2020-12-24,2020-12-24,5.0,-21.18,955.13,0.0,162.0,           ,1.0,1.0,84.0
5208,Muut,2020-12-24 13:12:33.488372052,2020-12-24,2020-12-24,2020-12-24,5.0,-22.6,932.53,0.0,162.0,           ,1.0,1.0,146.0
5209,Ruoka_paivittaistavarakauppa,2020-12-25 01:40:27.906976704,2020-12-25,2020-12-25,2020-12-25,5.0,-5.85,926.68,0.0,162.0,           ,1.0,1.0,46.0
5210,Kulttuuri_viihde,2020-12-25 12:16:44.651162748,2020-12-25,2020-12-25,2020-12-25,5.0,-12.21,914.47,0.0,162.0,           ,1.0,1.0,101.0
5211,Tulot,2020-12-25 22:53:01.395348792,2020-12-25,2020-12-25,2020-12-25,5.0,355.67,1270.14,0.0,506.0,           ,1.0,1.0,219.0
5212,Liikkuminen,2020-12-25 23:48:50.232558096,2020-12-25,2020-12-25,2020-12-25,5.0,-74.18,1195.96,0.0,162.0,           ,1.0,1.0,46.0
5213,Ravintolat_kahvilat,2020-12-28 09:29:18.139534836,2020-12-28,2020-12-28,2020-12-28,5.0,-12.0,1183.96,0.0,162.0,           ,1.0,1.0,136.0
5214,Asuminen,2020-12-28 10:25:06.976744140,2020-12-28,2020-12-28,2020-12-28,5.0,-6.27,1177.69,0.0,162.0,           ,1.0,1.0,146.0
5215,Liikkuminen,2020-12-28 19:09:46.046511576,2020-12-28,2020-12-28,2020-12-28,5.0,-42.95,1134.74,0.0,162.0,           ,1.0,1.0,168.0
5216,Ruoka_paivittaistavarakauppa,2020-12-28 20:05:34.883720880,2020-12-28,2020-12-28,2020-12-28,5.0,-7.8,1126.94,0.0,162.0,           ,1.0,1.0,48.0
5217,Ravintolat_kahvilat,2020-12-28 21:01:23.720930184,2020-12-28,2020-12-28,2020-12-28,5.0,-3.98,1122.96,0.0,162.0,           ,1.0,1.0,131.0
5218,Liikkuminen,2020-12-28 21:57:12.558139488,2020-12-28,2020-12-28,2020-12-28,5.0,-10.74,1112.22,0.0,162.0,           ,1.0,1.0,178.0
5219,Ravintolat_kahvilat,2020-12-29 08:33:29.302325532,2020-12-29,2020-12-29,2020-12-29,5.0,-105.76,1006.46,0.0,164.0,           ,1.0,1.0,199.0
5220,Ruoka_paivittaistavarakauppa,2020-12-31 06:41:51.627906924,2020-12-31,2020-12-31,2020-12-31,5.0,-51.43,955.03,0.0,162.0,           ,1.0,1.0,153.0
5221,Muut,2020-12-31 07:37:40.465116228,2020-12-31,2020-12-31,2020-12-31,5.0,-938.97,16.06,0.0,164.0,           ,1.0,1.0,200.0
5222,Liikkuminen,2020-12-31 18:13:57.209302272,2020-12-31,2020-12-31,2020-12-31,5.0,-1.73,14.33,0.0,162.0,           ,1.0,1.0,160.0
5223,Luokittelemattomat,2019-01-01 00:00:00.000000000,2019-01-01,2019-01-01,2019-01-01,6.0,-170.18,425.82,706.0,106.0,ITELFIHH   ,0.0,0.0,220.0
5224,Luokittelemattomat,2019-01-01 08:30:10.285714285,2019-01-01,2019-01-01,2019-01-01,6.0,-90.83,334.99,0.0,106.0,OKOYFIHH   ,1.0,0.0,37.0
5225,Terveys,2019-01-02 01:30:30.857142855,2019-01-02,2019-01-02,2019-01-02,6.0,-4.67,330.32,0.0,162.0,           ,1.0,1.0,173.0
5226,Ruoka_paivittaistavarakauppa,2019-01-02 10:00:41.142857140,2019-01-02,2019-01-02,2019-01-02,6.0,-5.23,325.09,0.0,162.0,           ,1.0,1.0,91.0
5227,Liikkuminen,2019-01-02 17:00:20.571428570,2019-01-02,2019-01-02,2019-01-02,6.0,-6.38,318.71,0.0,162.0,           ,1.0,1.0,86.0
5228,Ravintolat_kahvilat,2019-01-02 18:30:51.428571425,2019-01-02,2019-01-02,2019-01-02,6.0,-21.3,297.41,0.0,162.0,           ,1.0,1.0,106.0
5229,Asuminen,2019-01-03 03:01:01.714285710,2019-01-03,2019-01-03,2019-01-03,6.0,-20.56,276.85,0.0,162.0,           ,1.0,1.0,113.0
5230,Harrastukset,2019-01-03 11:31:11.999999995,2019-01-03,2019-01-03,2019-01-03,6.0,-27.59,249.26,706.0,106.0,NDEAFIHH   ,0.0,0.0,222.0
5231,Luottojen_maksut,2019-01-03 20:01:22.285714280,2019-01-03,2019-01-03,2019-01-03,6.0,-66.9,182.36,706.0,106.0,OKOYFIHH   ,0.0,0.0,220.0
5232,Ruoka_paivittaistavarakauppa,2019-01-04 04:31:32.571428565,2019-01-04,2019-01-04,2019-01-04,6.0,-13.24,169.12,0.0,162.0,           ,1.0,1.0,124.0
5233,Luottojen_maksut,2019-01-04 13:01:42.857142850,2019-01-04,2019-01-04,2019-01-04,6.0,-162.2,6.92,0.0,106.0,DABAFIHH   ,0.0,0.0,16.0
5234,Ruoka_paivittaistavarakauppa,2019-01-04 21:31:53.142857135,2019-01-04,2019-01-04,2019-01-04,6.0,-3.77,3.15,0.0,162.0,           ,1.0,1.0,134.0
5235,Ravintolat_kahvilat,2019-01-04 23:02:23.999999990,2019-01-04,2019-01-04,2019-01-04,6.0,-1.53,1.62,0.0,162.0,           ,1.0,1.0,121.0
5236,Liikkuminen,2019-01-07 00:32:54.857142845,2019-01-07,2019-01-07,2019-01-07,6.0,-23.49,-21.87,0.0,162.0,           ,1.0,1.0,86.0
5237,Ruoka_paivittaistavarakauppa,2019-01-07 06:02:03.428571420,2019-01-07,2019-01-07,2019-01-07,6.0,-6.38,-28.25,0.0,162.0,           ,1.0,1.0,116.0
5238,Lemmikit,2019-01-07 07:32:34.285714275,2019-01-07,2019-01-07,2019-01-07,6.0,-3.6,-31.85,0.0,162.0,           ,1.0,1.0,123.0
5239,Ravintolat_kahvilat,2019-01-07 09:03:05.142857130,2019-01-07,2019-01-07,2019-01-07,6.0,-3.94,-35.79,0.0,162.0,           ,1.0,1.0,116.0
5240,Ruoka_paivittaistavarakauppa,2019-01-07 14:32:13.714285705,2019-01-07,2019-01-09,2019-01-07,6.0,-6.45,-42.24,0.0,162.0,           ,1.0,1.0,163.0
5241,Ruoka_paivittaistavarakauppa,2019-01-07 16:02:44.571428560,2019-01-07,2019-01-07,2019-01-07,6.0,-23.7,-65.94,0.0,162.0,           ,1.0,1.0,113.0
5242,Liikkuminen,2019-01-07 17:33:15.428571415,2019-01-07,2019-01-07,2019-01-07,6.0,-75.72,-141.66,706.0,106.0,NDEAFIHH   ,0.0,0.0,220.0
5243,Ruoka_paivittaistavarakauppa,2019-01-08 02:03:25.714285700,2019-01-08,2019-01-08,2019-01-08,6.0,-3.85,-145.51,0.0,162.0,           ,1.0,1.0,153.0
5244,Tulot,2019-01-08 10:33:35.999999985,2019-01-08,2019-01-08,2019-01-08,6.0,-2.51,-148.02,0.0,162.0,           ,1.0,1.0,121.0
5245,Ruoka_paivittaistavarakauppa,2019-01-08 19:03:46.285714270,2019-01-08,2019-01-08,2019-01-08,6.0,-1.07,-149.09,0.0,162.0,           ,1.0,1.0,104.0
5246,Ruoka_paivittaistavarakauppa,2019-01-09 05:04:27.428571410,2019-01-09,2019-01-09,2019-01-09,6.0,-5.96,-155.05,0.0,162.0,           ,1.0,1.0,102.0
5247,Ravintolat_kahvilat,2019-01-09 12:04:06.857142840,2019-01-09,2019-01-09,2019-01-09,6.0,-10.27,-165.32,0.0,162.0,           ,1.0,1.0,123.0
5248,Luokittelemattomat,2019-01-09 13:34:37.714285695,2019-01-09,2019-01-09,2019-01-09,6.0,-4.58,-169.9,0.0,162.0,           ,1.0,1.0,67.0
5249,Ravintolat_kahvilat,2019-01-09 20:34:17.142857125,2019-01-09,2019-01-09,2019-01-09,6.0,-0.56,-170.46,0.0,162.0,           ,1.0,1.0,104.0
5250,Luokittelemattomat,2019-01-10 22:04:47.999999980,2019-01-10,2019-01-10,2019-01-10,6.0,-24.19,-194.65,0.0,162.0,           ,1.0,1.0,82.0
5251,Lemmikit,2019-01-11 03:33:56.571428555,2019-01-11,2019-01-11,2019-01-11,6.0,-59.33,-253.98,0.0,162.0,           ,1.0,1.0,126.0
5252,Ruoka_paivittaistavarakauppa,2019-01-11 06:34:58.285714265,2019-01-11,2019-01-11,2019-01-11,6.0,-0.93,-254.91,0.0,162.0,           ,1.0,1.0,133.0
5253,Luokittelemattomat,2019-01-11 15:05:08.571428550,2019-01-11,2019-01-11,2019-01-11,6.0,-8.5,-263.41,0.0,162.0,           ,1.0,1.0,51.0
5254,Ruoka_paivittaistavarakauppa,2019-01-11 23:35:18.857142835,2019-01-11,2019-01-11,2019-01-11,6.0,-2.89,-266.3,0.0,162.0,           ,1.0,1.0,118.0
5255,Ruoka_paivittaistavarakauppa,2019-01-14 01:05:49.714285690,2019-01-14,2019-01-14,2019-01-14,6.0,-15.35,-281.65,0.0,162.0,           ,1.0,1.0,118.0
5256,Ravintolat_kahvilat,2019-01-14 02:36:20.571428545,2019-01-14,2019-01-14,2019-01-14,6.0,-0.48,-282.13,0.0,162.0,           ,1.0,1.0,82.0
5257,Ruoka_paivittaistavarakauppa,2019-01-14 08:05:29.142857120,2019-01-14,2019-01-14,2019-01-14,6.0,-11.74,-293.87,0.0,162.0,           ,1.0,1.0,143.0
5258,Ruoka_paivittaistavarakauppa,2019-01-14 09:35:59.999999975,2019-01-14,2019-01-14,2019-01-14,6.0,-28.09,-321.96,0.0,162.0,           ,1.0,1.0,96.0
5259,Ruoka_paivittaistavarakauppa,2019-01-14 11:06:30.857142830,2019-01-14,2019-01-14,2019-01-14,6.0,-1.76,-323.72,0.0,162.0,           ,1.0,1.0,48.0
5260,Ruoka_paivittaistavarakauppa,2019-01-14 12:37:01.714285685,2019-01-14,2019-01-14,2019-01-14,6.0,-5.25,-328.97,0.0,162.0,           ,1.0,1.0,94.0
5261,Ruoka_paivittaistavarakauppa,2019-01-14 16:35:39.428571405,2019-01-14,2019-01-14,2019-01-14,6.0,-3.65,-332.62,0.0,162.0,           ,1.0,1.0,129.0
5262,Ruoka_paivittaistavarakauppa,2019-01-14 18:06:10.285714260,2019-01-14,2019-01-14,2019-01-14,6.0,-14.63,-347.25,0.0,162.0,           ,1.0,1.0,108.0
5263,Ruoka_paivittaistavarakauppa,2019-01-14 19:36:41.142857115,2019-01-14,2019-01-14,2019-01-14,6.0,-3.36,-350.61,0.0,162.0,           ,1.0,1.0,96.0
5264,Ruoka_paivittaistavarakauppa,2019-01-14 21:07:11.999999970,2019-01-14,2019-01-14,2019-01-14,6.0,-8.62,-359.23,0.0,162.0,           ,1.0,1.0,172.0
5265,Hyvinvointi,2019-01-15 04:06:51.428571400,2019-01-15,2019-01-15,2019-01-15,6.0,-15.4,-374.63,0.0,162.0,           ,1.0,1.0,143.0
5266,Liikkuminen,2019-01-15 22:37:42.857142825,2019-01-15,2019-01-15,2019-01-15,6.0,-5.45,-380.08,0.0,162.0,           ,1.0,1.0,183.0
5267,Lemmikit,2019-01-16 05:37:22.285714255,2019-01-16,2019-01-16,2019-01-16,6.0,-8.33,-388.41,0.0,162.0,           ,1.0,1.0,69.0
5268,Ruoka_paivittaistavarakauppa,2019-01-16 07:07:53.142857110,2019-01-16,2019-01-16,2019-01-16,6.0,-4.47,-392.88,0.0,162.0,           ,1.0,1.0,47.0
5269,Ruoka_paivittaistavarakauppa,2019-01-16 14:07:32.571428540,2019-01-16,2019-01-16,2019-01-16,6.0,-25.63,-418.51,0.0,162.0,           ,1.0,1.0,158.0
5270,Luokittelemattomat,2019-01-17 01:38:44.571428535,2019-01-17,2019-01-17,2019-01-17,6.0,-9.5,-428.01,0.0,162.0,           ,1.0,1.0,89.0
5271,Kulttuuri_viihde,2019-01-17 15:38:03.428571395,2019-01-17,2019-01-17,2019-01-17,6.0,-1.47,-429.48,0.0,162.0,           ,1.0,1.0,151.0
5272,Ruoka_paivittaistavarakauppa,2019-01-17 20:09:35.999999960,2019-01-17,2019-01-17,2019-01-17,6.0,-1.24,-430.72,0.0,162.0,           ,1.0,1.0,110.0
5273,Ravintolat_kahvilat,2019-01-18 00:08:13.714285680,2019-01-18,2019-01-18,2019-01-18,6.0,-2.6,-433.32,0.0,162.0,           ,1.0,1.0,121.0
5274,Ravintolat_kahvilat,2019-01-18 08:38:23.999999965,2019-01-18,2019-01-18,2019-01-18,6.0,-1.85,-435.17,0.0,162.0,           ,1.0,1.0,102.0
5275,Ruoka_paivittaistavarakauppa,2019-01-18 10:08:54.857142820,2019-01-18,2019-01-18,2019-01-18,6.0,-3.67,-438.84,0.0,162.0,           ,1.0,1.0,125.0
5276,Ruoka_paivittaistavarakauppa,2019-01-18 17:08:34.285714250,2019-01-18,2019-01-18,2019-01-18,6.0,-1.46,-440.3,0.0,162.0,           ,1.0,1.0,77.0
5277,Ruoka_paivittaistavarakauppa,2019-01-18 18:39:05.142857105,2019-01-18,2019-01-18,2019-01-18,6.0,-0.56,-440.86,0.0,162.0,           ,1.0,1.0,75.0
5278,Ravintolat_kahvilat,2019-01-21 03:09:15.428571390,2019-01-21,2019-01-21,2019-01-21,6.0,-2.91,-443.77,0.0,162.0,           ,1.0,1.0,65.0
5279,Ruoka_paivittaistavarakauppa,2019-01-21 04:39:46.285714245,2019-01-21,2019-01-21,2019-01-21,6.0,-0.54,-444.31,0.0,162.0,           ,1.0,1.0,61.0
5280,Ruoka_paivittaistavarakauppa,2019-01-21 06:10:17.142857100,2019-01-21,2019-01-21,2019-01-21,6.0,-18.33,-462.64,0.0,162.0,           ,1.0,1.0,164.0
5281,Ruoka_paivittaistavarakauppa,2019-01-21 13:09:56.571428530,2019-01-21,2019-01-21,2019-01-21,6.0,-11.28,-473.92,0.0,162.0,           ,1.0,1.0,86.0
5282,Ruoka_paivittaistavarakauppa,2019-01-21 14:40:27.428571385,2019-01-21,2019-01-21,2019-01-21,6.0,-1.66,-475.58,0.0,162.0,           ,1.0,1.0,95.0
5283,Ruoka_paivittaistavarakauppa,2019-01-21 21:40:06.857142815,2019-01-21,2019-01-21,2019-01-21,6.0,-2.65,-478.23,0.0,162.0,           ,1.0,1.0,119.0
5284,Ruoka_paivittaistavarakauppa,2019-01-21 23:10:37.714285670,2019-01-21,2019-01-21,2019-01-21,6.0,-22.81,-501.04,0.0,162.0,           ,1.0,1.0,110.0
5285,Ruoka_paivittaistavarakauppa,2019-01-22 09:11:18.857142810,2019-01-22,2019-01-22,2019-01-22,6.0,-2.78,-503.82,0.0,162.0,           ,1.0,1.0,152.0
5286,Lapset,2019-01-22 11:39:25.714285675,2019-01-22,2019-01-22,2019-01-22,6.0,-10.46,-514.28,0.0,162.0,           ,1.0,1.0,55.0
5287,Ruoka_paivittaistavarakauppa,2019-01-23 07:40:47.999999955,2019-01-23,2019-01-23,2019-01-23,6.0,-3.41,-517.69,0.0,162.0,           ,1.0,1.0,140.0
5288,Ravintolat_kahvilat,2019-01-24 02:11:39.428571380,2019-01-24,2019-01-24,2019-01-24,6.0,-16.35,-534.04,0.0,162.0,           ,1.0,1.0,113.0
5289,Ruoka_paivittaistavarakauppa,2019-01-24 10:41:49.714285665,2019-01-24,2019-01-24,2019-01-24,6.0,-7.61,-541.65,0.0,162.0,           ,1.0,1.0,96.0
5290,Ruoka_paivittaistavarakauppa,2019-01-24 16:10:58.285714240,2019-01-24,2019-01-24,2019-01-24,6.0,-1.75,-543.4,0.0,162.0,           ,1.0,1.0,130.0
5291,Ruoka_paivittaistavarakauppa,2019-01-25 00:41:08.571428525,2019-01-25,2019-01-25,2019-01-25,6.0,-2.0,-545.4,0.0,162.0,           ,1.0,1.0,108.0
5292,Ruoka_paivittaistavarakauppa,2019-01-25 03:42:10.285714235,2019-01-25,2019-01-25,2019-01-25,6.0,-3.32,-548.72,0.0,162.0,           ,1.0,1.0,94.0
5293,Liikkuminen,2019-01-25 12:12:20.571428520,2019-01-25,2019-01-25,2019-01-25,6.0,-32.79,-581.51,0.0,162.0,           ,1.0,1.0,55.0
5294,Ruoka_paivittaistavarakauppa,2019-01-25 17:41:29.142857095,2019-01-25,2019-01-25,2019-01-25,6.0,-5.41,-586.92,0.0,162.0,           ,1.0,1.0,51.0
5295,Ruoka_paivittaistavarakauppa,2019-01-25 19:11:59.999999950,2019-01-25,2019-01-25,2019-01-25,6.0,-6.31,-593.23,0.0,162.0,           ,1.0,1.0,120.0
5296,Tulot,2019-01-27 20:42:30.857142805,2019-01-27,2019-01-27,2019-01-27,6.0,695.98,102.75,0.0,505.0,           ,1.0,1.0,201.0
5297,Liikkuminen,2019-01-28 05:12:41.142857090,2019-01-28,2019-01-28,2019-01-28,6.0,-20.42,82.33,0.0,162.0,           ,1.0,1.0,166.0
5298,Ruoka_paivittaistavarakauppa,2019-01-28 06:43:11.999999945,2019-01-28,2019-01-28,2019-01-28,6.0,-11.37,70.96,0.0,162.0,           ,1.0,1.0,78.0
5299,Luokittelemattomat,2019-01-28 13:42:51.428571375,2019-01-28,2019-01-28,2019-01-28,6.0,-56.18,14.78,0.0,162.0,           ,1.0,1.0,113.0
5300,Ruoka_paivittaistavarakauppa,2019-01-28 15:13:22.285714230,2019-01-28,2019-01-28,2019-01-28,6.0,-1.15,13.63,0.0,162.0,           ,1.0,1.0,110.0
5301,Ruoka_paivittaistavarakauppa,2019-01-28 22:13:01.714285660,2019-01-28,2019-01-28,2019-01-28,6.0,-1.92,11.71,0.0,162.0,           ,1.0,1.0,130.0
5302,Tulot,2019-01-28 23:43:32.571428515,2019-01-28,2019-01-28,2019-01-28,6.0,-4.99,6.72,0.0,162.0,           ,1.0,1.0,46.0
5303,Ruoka_paivittaistavarakauppa,2019-01-29 01:14:03.428571370,2019-01-29,2019-01-29,2019-01-29,6.0,-3.44,3.28,0.0,162.0,           ,1.0,1.0,121.0
5304,Tulot,2019-01-29 11:14:44.571428510,2019-01-29,2019-01-29,2019-01-29,6.0,6.79,10.07,0.0,505.0,           ,1.0,1.0,202.0
5305,Kulttuuri_viihde,2019-01-29 16:43:53.142857085,2019-01-29,2019-01-29,2019-01-29,6.0,-5.31,4.76,0.0,162.0,           ,1.0,1.0,105.0
5306,Liikkuminen,2019-01-29 18:14:23.999999940,2019-01-29,2019-01-29,2019-01-29,6.0,-1.88,2.88,0.0,162.0,           ,1.0,1.0,46.0
5307,Ruoka_paivittaistavarakauppa,2019-01-30 08:13:42.857142800,2019-01-30,2019-01-30,2019-01-30,6.0,-2.19,0.69,0.0,162.0,           ,1.0,1.0,46.0
5308,Liikkuminen,2019-01-30 09:44:13.714285655,2019-01-30,2019-01-30,2019-01-30,6.0,-3.53,-2.84,0.0,162.0,           ,1.0,1.0,122.0
5309,Luokittelemattomat,2019-01-30 19:44:54.857142795,2019-01-30,2019-01-30,2019-01-30,6.0,-19.62,-22.46,0.0,162.0,           ,1.0,1.0,114.0
5310,Hyvinvointi,2019-01-31 02:44:34.285714225,2019-01-31,2019-01-31,2019-01-31,6.0,-5.19,-27.65,0.0,162.0,           ,1.0,1.0,101.0
5311,Liikkuminen,2019-02-01 12:33:38.691588785,2019-02-01,2019-02-01,2019-02-01,6.0,-1.13,-28.78,0.0,151.0,           ,1.0,1.0,45.0
5312,Liikkuminen,2019-02-04 01:07:17.383177570,2019-02-04,2019-02-04,2019-02-04,6.0,-1.18,-29.96,0.0,162.0,           ,1.0,1.0,135.0
5313,Ruoka_paivittaistavarakauppa,2019-02-04 02:14:34.766355140,2019-02-04,2019-02-04,2019-02-04,6.0,-13.19,-43.15,0.0,162.0,           ,1.0,1.0,69.0
5314,Ruoka_paivittaistavarakauppa,2019-02-04 03:21:52.149532710,2019-02-04,2019-02-04,2019-02-04,6.0,-5.88,-49.03,0.0,162.0,           ,1.0,1.0,82.0
5315,Ruoka_paivittaistavarakauppa,2019-02-04 05:36:26.915887850,2019-02-04,2019-02-04,2019-02-04,6.0,-0.91,-49.94,0.0,162.0,           ,1.0,1.0,149.0
5316,Lemmikit,2019-02-04 13:40:56.074766355,2019-02-04,2019-02-04,2019-02-04,6.0,-24.56,-74.5,0.0,162.0,           ,1.0,1.0,132.0
5317,Liikkuminen,2019-02-04 14:48:13.457943925,2019-02-04,2019-02-04,2019-02-04,6.0,-6.13,-80.63,0.0,162.0,           ,1.0,1.0,108.0
5318,Ruoka_paivittaistavarakauppa,2019-02-04 15:55:30.841121495,2019-02-04,2019-02-04,2019-02-04,6.0,-9.1,-89.73,0.0,162.0,           ,1.0,1.0,102.0
5319,Ruoka_paivittaistavarakauppa,2019-02-05 04:29:09.532710280,2019-02-05,2019-02-05,2019-02-05,6.0,-12.33,-102.06,0.0,162.0,           ,1.0,1.0,114.0
5320,Liikkuminen,2019-02-05 17:02:48.224299065,2019-02-05,2019-02-05,2019-02-05,6.0,-1.51,-103.57,0.0,162.0,           ,1.0,1.0,96.0
5321,Ruoka_paivittaistavarakauppa,2019-02-05 18:10:05.607476635,2019-02-05,2019-02-05,2019-02-05,6.0,-14.24,-117.81,0.0,162.0,           ,1.0,1.0,95.0
5322,Liikkuminen,2019-02-07 06:43:44.299065420,2019-02-07,2019-02-07,2019-02-07,6.0,-23.24,-141.05,0.0,106.0,OKOYFIHH   ,1.0,0.0,31.0
5323,Lemmikit,2019-02-07 19:17:22.990654205,2019-02-07,2019-02-07,2019-02-07,6.0,-13.28,-154.33,0.0,106.0,OKOYFIHH   ,0.0,0.0,7.0
5324,Ruoka_paivittaistavarakauppa,2019-02-08 07:51:01.682242990,2019-02-08,2019-02-08,2019-02-08,6.0,-3.4,-157.73,0.0,162.0,           ,1.0,1.0,128.0
5325,Ruoka_paivittaistavarakauppa,2019-02-11 08:58:19.065420560,2019-02-11,2019-02-11,2019-02-11,6.0,-0.95,-158.68,0.0,162.0,           ,1.0,1.0,63.0
5326,Ruoka_paivittaistavarakauppa,2019-02-11 10:05:36.448598130,2019-02-11,2019-02-11,2019-02-11,6.0,-3.16,-161.84,0.0,162.0,           ,1.0,1.0,110.0
5327,Ravintolat_kahvilat,2019-02-11 11:12:53.831775700,2019-02-11,2019-02-11,2019-02-11,6.0,-0.49,-162.33,0.0,162.0,           ,1.0,1.0,164.0
5328,Ruoka_paivittaistavarakauppa,2019-02-11 20:24:40.373831775,2019-02-11,2019-02-11,2019-02-11,6.0,-1.74,-164.07,0.0,162.0,           ,1.0,1.0,99.0
5329,Ruoka_paivittaistavarakauppa,2019-02-11 21:31:57.757009345,2019-02-11,2019-02-11,2019-02-11,6.0,-5.27,-169.34,0.0,162.0,           ,1.0,1.0,143.0
5330,Liikkuminen,2019-02-11 22:39:15.140186915,2019-02-11,2019-02-11,2019-02-11,6.0,-4.52,-173.86,0.0,162.0,           ,1.0,1.0,69.0
5331,Ruoka_paivittaistavarakauppa,2019-02-11 23:46:32.523364485,2019-02-11,2019-02-11,2019-02-11,6.0,-9.43,-183.29,0.0,162.0,           ,1.0,1.0,126.0
5332,Tulot,2019-02-12 00:53:49.906542055,2019-02-12,2019-02-12,2019-02-08,6.0,175.77,-7.52,0.0,551.0,           ,1.0,1.0,208.0
5333,Ravintolat_kahvilat,2019-02-12 12:20:11.214953270,2019-02-12,2019-02-12,2019-02-12,6.0,-15.24,-22.76,0.0,162.0,           ,1.0,1.0,127.0
5334,Ruoka_paivittaistavarakauppa,2019-02-13 14:34:45.981308410,2019-02-13,2019-02-13,2019-02-13,6.0,-2.29,-25.05,0.0,162.0,           ,1.0,1.0,79.0
5335,Ruoka_paivittaistavarakauppa,2019-02-14 02:01:07.289719625,2019-02-14,2019-02-14,2019-02-14,6.0,-14.37,-39.42,0.0,162.0,           ,1.0,1.0,133.0
5336,Luokittelemattomat,2019-02-14 03:08:24.672897195,2019-02-14,2019-02-14,2019-02-14,6.0,-13.92,-53.34,0.0,162.0,           ,1.0,1.0,134.0
5337,Ruoka_paivittaistavarakauppa,2019-02-14 04:15:42.056074765,2019-02-14,2019-02-14,2019-02-14,6.0,-2.36,-55.7,0.0,162.0,           ,1.0,1.0,109.0
5338,Luottojen_maksut,2019-02-14 13:27:28.598130840,2019-02-14,2019-02-14,2019-02-14,6.0,-1.15,-56.85,0.0,151.0,           ,1.0,1.0,44.0
5339,Ruoka_paivittaistavarakauppa,2019-02-14 15:42:03.364485980,2019-02-14,2019-02-14,2019-02-14,6.0,-18.34,-75.19,0.0,162.0,           ,1.0,1.0,91.0
5340,Ruoka_paivittaistavarakauppa,2019-02-15 16:49:20.747663550,2019-02-15,2019-02-15,2019-02-15,6.0,-18.76,-93.95,0.0,162.0,           ,1.0,1.0,176.0
5341,Vakuutukset,2019-02-16 17:56:38.130841120,2019-02-16,2019-02-16,2019-02-16,6.0,-12.02,-105.97,0.0,106.0,OKOYFIHH   ,0.0,0.0,8.0
5342,Liikkuminen,2019-02-17 05:22:59.439252335,2019-02-17,2019-02-17,2019-02-17,6.0,-9.14,-115.11,0.0,106.0,OKOYFIHH   ,1.0,0.0,28.0
5343,Luokittelemattomat,2019-02-18 06:30:16.822429905,2019-02-18,2019-02-19,2019-02-18,6.0,-7.88,-122.99,0.0,162.0,           ,1.0,1.0,179.0
5344,Ruoka_paivittaistavarakauppa,2019-02-18 19:03:55.514018690,2019-02-18,2019-02-18,2019-02-18,6.0,-1.53,-124.52,0.0,162.0,           ,1.0,1.0,141.0
5345,Ruoka_paivittaistavarakauppa,2019-02-19 07:37:34.205607475,2019-02-19,2019-02-19,2019-02-19,6.0,-4.58,-129.1,0.0,162.0,           ,1.0,1.0,145.0
5346,Kulttuuri_viihde,2019-02-19 20:11:12.897196260,2019-02-19,2019-02-19,2019-02-19,6.0,-8.4,-137.5,0.0,162.0,           ,1.0,1.0,148.0
5347,Ruoka_paivittaistavarakauppa,2019-02-20 09:52:08.971962615,2019-02-20,2019-02-20,2019-02-20,6.0,-12.35,-149.85,0.0,162.0,           ,1.0,1.0,101.0
5348,Luokittelemattomat,2019-02-20 21:18:30.280373830,2019-02-20,2019-02-20,2019-02-20,6.0,-2.19,-152.04,0.0,162.0,           ,1.0,1.0,48.0
5349,Shoppailu,2019-02-20 23:33:05.046728970,2019-02-20,2019-02-20,2019-02-20,6.0,-1.4,-153.44,0.0,162.0,           ,1.0,1.0,95.0
5350,Ruoka_paivittaistavarakauppa,2019-02-21 08:44:51.588785045,2019-02-21,2019-02-21,2019-02-21,6.0,-0.93,-154.37,0.0,162.0,           ,1.0,1.0,143.0
5351,Muut,2019-02-21 10:59:26.355140185,2019-02-21,2019-02-21,2019-02-21,6.0,-3.71,-158.08,0.0,162.0,           ,1.0,1.0,113.0
5352,Ruoka_paivittaistavarakauppa,2019-02-21 22:25:47.663551400,2019-02-21,2019-02-21,2019-02-21,6.0,-1.71,-159.79,0.0,162.0,           ,1.0,1.0,121.0
5353,Ruoka_paivittaistavarakauppa,2019-02-22 00:40:22.429906540,2019-02-22,2019-02-22,2019-02-22,6.0,-11.77,-171.56,0.0,162.0,           ,1.0,1.0,140.0
5354,Lemmikit,2019-02-22 12:06:43.738317755,2019-02-22,2019-02-22,2019-02-22,6.0,-1.97,-173.53,0.0,162.0,           ,1.0,1.0,63.0
5355,Harrastukset,2019-02-25 01:47:39.813084110,2019-02-25,2019-02-25,2019-02-25,6.0,-5.64,-179.17,0.0,162.0,           ,1.0,1.0,105.0
5356,Ruoka_paivittaistavarakauppa,2019-02-25 13:14:01.121495325,2019-02-25,2019-02-25,2019-02-25,6.0,-5.57,-184.74,0.0,162.0,           ,1.0,1.0,119.0
5357,Ruoka_paivittaistavarakauppa,2019-02-25 14:21:18.504672895,2019-02-25,2019-02-25,2019-02-25,6.0,-7.77,-192.51,0.0,162.0,           ,1.0,1.0,95.0
5358,Luottojen_maksut,2019-02-25 16:35:53.271028035,2019-02-25,2019-02-25,2019-02-25,6.0,-33.64,-226.15,0.0,172.0,           ,1.0,1.0,191.0
5359,Hyvinvointi,2019-02-26 02:54:57.196261680,2019-02-26,2019-02-26,2019-02-26,6.0,-4.36,-230.51,0.0,162.0,           ,1.0,1.0,155.0
5360,Luottojen_maksut,2019-02-27 04:02:14.579439250,2019-02-27,2019-02-28,2019-02-27,6.0,-470.48,-700.99,0.0,172.0,           ,1.0,1.0,192.0
5361,Muut,2019-02-28 05:09:31.962616820,2019-02-28,2019-02-28,2019-02-28,6.0,-8.26,-709.25,0.0,163.0,           ,1.0,1.0,184.0
5362,Tulot,2019-02-28 15:28:35.887850465,2019-02-28,2019-02-28,2019-02-28,6.0,1527.93,818.68,701.0,506.0,           ,1.0,1.0,210.0
5363,Liikkuminen,2019-02-28 17:43:10.654205605,2019-02-28,2019-02-28,2019-02-28,6.0,-14.7,803.98,0.0,106.0,OKOYFIHH   ,0.0,0.0,4.0
5364,Kulttuuri_viihde,2019-03-01 17:24:12.631578946,2019-03-01,2019-03-01,2019-03-01,6.0,-56.58,747.4,0.0,162.0,           ,1.0,1.0,173.0
5365,Ruoka_paivittaistavarakauppa,2019-03-01 21:36:50.526315784,2019-03-01,2019-03-01,2019-03-01,6.0,-28.16,719.24,0.0,162.0,           ,1.0,1.0,60.0
5366,Luottojen_maksut,2019-03-04 02:06:18.947368419,2019-03-04,2019-03-05,2019-03-04,6.0,-26.69,692.55,0.0,162.0,           ,1.0,1.0,135.0
5367,Tulot,2019-03-04 04:12:37.894736838,2019-03-04,2019-03-04,2019-03-04,6.0,61.2,753.75,710.0,506.0,           ,1.0,1.0,235.0
5368,Ruoka_paivittaistavarakauppa,2019-03-04 06:18:56.842105257,2019-03-04,2019-03-04,2019-03-04,6.0,-5.41,748.34,0.0,162.0,           ,1.0,1.0,170.0
5369,Tulot,2019-03-04 08:25:15.789473676,2019-03-04,2019-03-04,2019-03-04,6.0,13.05,761.39,0.0,505.0,           ,1.0,1.0,199.0
5370,Ruoka_paivittaistavarakauppa,2019-03-04 08:42:06.315789473,2019-03-04,2019-03-05,2019-03-04,6.0,-6.48,754.91,0.0,162.0,           ,1.0,1.0,66.0
5371,Liikkuminen,2019-03-04 10:48:25.263157892,2019-03-04,2019-03-04,2019-03-04,6.0,-49.96,704.95,0.0,162.0,           ,1.0,1.0,89.0
5372,Asuminen,2019-03-04 12:54:44.210526311,2019-03-04,2019-03-04,2019-03-04,6.0,-60.12,644.83,706.0,129.0,NDEAFIHH   ,0.0,0.0,223.0
5373,Ruoka_paivittaistavarakauppa,2019-03-04 15:01:03.157894730,2019-03-04,2019-03-04,2019-03-04,6.0,-49.65,595.18,0.0,162.0,           ,1.0,1.0,122.0
5374,Ruoka_paivittaistavarakauppa,2019-03-04 19:30:31.578947365,2019-03-04,2019-03-04,2019-03-04,6.0,-31.08,564.1,0.0,162.0,           ,1.0,1.0,48.0
5375,Luokittelemattomat,2019-03-04 23:43:09.473684203,2019-03-04,2019-03-04,2019-03-04,6.0,-47.22,516.88,0.0,106.0,OKOYFIHH   ,1.0,0.0,37.0
5376,Liikkuminen,2019-03-05 10:31:34.736842095,2019-03-05,2019-03-05,2019-03-05,6.0,-3.5,513.38,0.0,162.0,           ,1.0,1.0,48.0
5377,Kulttuuri_viihde,2019-03-05 17:07:22.105263149,2019-03-05,2019-03-05,2019-03-05,6.0,-120.13,393.25,0.0,162.0,           ,1.0,1.0,174.0
5378,Lapset,2019-03-06 19:13:41.052631568,2019-03-06,2019-03-06,2019-03-06,6.0,-12.73,380.52,0.0,162.0,           ,1.0,1.0,173.0
5379,Shoppailu,2019-03-07 03:55:47.368421041,2019-03-07,2019-03-07,2019-03-07,6.0,-15.96,364.56,0.0,162.0,           ,1.0,1.0,104.0
5380,Ruoka_paivittaistavarakauppa,2019-03-07 12:37:53.684210514,2019-03-07,2019-03-07,2019-03-07,6.0,-37.98,326.58,0.0,162.0,           ,1.0,1.0,154.0
5381,Ruoka_paivittaistavarakauppa,2019-03-07 21:19:59.999999987,2019-03-07,2019-03-07,2019-03-07,6.0,-43.26,283.32,0.0,162.0,           ,1.0,1.0,113.0
5382,Liikkuminen,2019-03-08 01:49:28.421052622,2019-03-08,2019-03-08,2019-03-08,6.0,-287.79,-4.47,0.0,162.0,           ,1.0,1.0,125.0
5383,Ruoka_paivittaistavarakauppa,2019-03-08 06:02:06.315789460,2019-03-08,2019-03-08,2019-03-08,6.0,-2.26,-6.73,0.0,162.0,           ,1.0,1.0,46.0
5384,Lemmikit,2019-03-08 08:08:25.263157879,2019-03-08,2019-03-08,2019-03-08,6.0,-11.66,-18.39,0.0,162.0,           ,1.0,1.0,74.0
5385,Ruoka_paivittaistavarakauppa,2019-03-08 14:44:12.631578933,2019-03-08,2019-03-08,2019-03-08,6.0,-22.99,-41.38,0.0,162.0,           ,1.0,1.0,155.0
5386,Ruoka_paivittaistavarakauppa,2019-03-08 23:26:18.947368406,2019-03-08,2019-03-08,2019-03-08,6.0,-2.11,-43.49,0.0,162.0,           ,1.0,1.0,69.0
5387,Lemmikit,2019-03-10 23:09:28.421052609,2019-03-10,2019-03-10,2019-03-10,6.0,-24.12,-67.61,0.0,106.0,OKOYFIHH   ,0.0,0.0,4.0
5388,Ruoka_paivittaistavarakauppa,2019-03-11 01:32:37.894736825,2019-03-11,2019-03-11,2019-03-11,6.0,-1.1,-68.71,0.0,162.0,           ,1.0,1.0,106.0
5389,Liikkuminen,2019-03-11 03:38:56.842105244,2019-03-11,2019-03-11,2019-03-11,6.0,-2.98,-71.69,0.0,162.0,           ,1.0,1.0,48.0
5390,Ruoka_paivittaistavarakauppa,2019-03-11 10:14:44.210526298,2019-03-11,2019-03-11,2019-03-11,6.0,-3.93,-75.62,0.0,162.0,           ,1.0,1.0,126.0
5391,Luottojen_maksut,2019-03-11 12:21:03.157894717,2019-03-11,2019-03-11,2019-03-11,6.0,-14.75,-90.37,0.0,162.0,           ,1.0,1.0,148.0
5392,Ruoka_paivittaistavarakauppa,2019-03-11 16:50:31.578947352,2019-03-11,2019-03-14,2019-03-11,6.0,-0.83,-91.2,0.0,162.0,           ,1.0,1.0,126.0
5393,Harrastukset,2019-03-11 18:56:50.526315771,2019-03-11,2019-03-11,2019-03-11,6.0,-9.11,-100.31,0.0,162.0,           ,1.0,1.0,86.0
5394,Ruoka_paivittaistavarakauppa,2019-03-11 21:03:09.473684190,2019-03-11,2019-03-11,2019-03-11,6.0,-1.98,-102.29,0.0,162.0,           ,1.0,1.0,55.0
5395,Matkailu,2019-03-12 05:45:15.789473663,2019-03-12,2019-03-12,2019-03-12,6.0,-22.29,-124.58,0.0,106.0,OKOYFIHH   ,0.0,0.0,39.0
5396,Liikkuminen,2019-03-12 14:27:22.105263136,2019-03-15,2019-03-13,2019-03-12,6.0,-6.97,-131.55,0.0,106.0,OKOYFIHH   ,0.0,0.0,23.0
5397,Luokittelemattomat,2019-03-13 07:51:34.736842082,2019-03-13,2019-03-13,2019-03-13,6.0,-25.13,-156.68,0.0,106.0,OKOYFIHH   ,1.0,0.0,11.0
5398,Lapset,2019-03-13 09:57:53.684210501,2019-03-13,2019-03-13,2019-03-13,6.0,-6.18,-162.86,0.0,106.0,OKOYFIHH   ,0.0,0.0,29.0
5399,Lapset,2019-03-14 16:33:41.052631555,2019-03-14,2019-03-14,2019-03-14,6.0,-14.03,-176.89,0.0,106.0,OKOYFIHH   ,0.0,0.0,35.0
5400,Ravintolat_kahvilat,2019-03-15 01:15:47.368421028,2019-03-15,2019-03-15,2019-03-15,6.0,-19.75,-196.64,0.0,106.0,DABAFIHH   ,0.0,0.0,19.0
5401,Asuminen,2019-03-15 03:22:06.315789447,2019-03-15,2019-03-15,2019-03-14,6.0,-26.45,-223.09,706.0,129.0,DABAFIHH   ,0.0,0.0,224.0
5402,Ravintolat_kahvilat,2019-03-15 12:04:12.631578920,2019-03-15,2019-03-15,2019-03-15,6.0,-2.9,-225.99,0.0,162.0,           ,1.0,1.0,101.0
5403,Ravintolat_kahvilat,2019-03-15 14:10:31.578947339,2019-03-15,2019-03-15,2019-03-15,6.0,-9.25,-235.24,0.0,162.0,           ,1.0,1.0,120.0
5404,Lemmikit,2019-03-15 18:39:59.999999974,2019-03-15,2019-03-15,2019-03-15,6.0,-14.41,-249.65,0.0,106.0,OKOYFIHH   ,0.0,0.0,35.0
5405,Luokittelemattomat,2019-03-15 20:46:18.947368393,2019-03-15,2019-03-15,2019-03-15,6.0,-4.89,-254.54,0.0,106.0,NDEAFIHH   ,1.0,0.0,4.0
5406,Ruoka_paivittaistavarakauppa,2019-03-15 22:52:37.894736812,2019-03-15,2019-03-15,2019-03-15,6.0,-5.93,-260.47,0.0,162.0,           ,1.0,1.0,143.0
5407,Luottojen_maksut,2019-03-18 00:58:56.842105231,2019-03-18,2019-03-18,2019-03-18,6.0,-7.86,-268.33,706.0,147.0,NDEAFIHH   ,0.0,0.0,229.0
5408,Shoppailu,2019-03-18 05:28:25.263157866,2019-03-18,2019-03-18,2019-03-18,6.0,-41.68,-310.01,0.0,162.0,           ,1.0,1.0,102.0
5409,Ruoka_paivittaistavarakauppa,2019-03-18 07:34:44.210526285,2019-03-18,2019-03-18,2019-03-18,6.0,-3.24,-313.25,0.0,162.0,           ,1.0,1.0,86.0
5410,Ruoka_paivittaistavarakauppa,2019-03-18 09:41:03.157894704,2019-03-18,2019-03-18,2019-03-18,6.0,-7.11,-320.36,0.0,162.0,           ,1.0,1.0,47.0
5411,Saastot_sijoitukset,2019-03-18 16:16:50.526315758,2019-03-18,2019-03-18,2019-03-18,6.0,-2.34,-322.7,0.0,162.0,           ,1.0,1.0,121.0
5412,Ruoka_paivittaistavarakauppa,2019-03-18 18:23:09.473684177,2019-03-18,2019-03-18,2019-03-18,6.0,-6.29,-328.99,0.0,162.0,           ,1.0,1.0,102.0
5413,Ruoka_paivittaistavarakauppa,2019-03-19 03:05:15.789473650,2019-03-19,2019-03-19,2019-03-19,6.0,-21.11,-350.1,0.0,162.0,           ,1.0,1.0,143.0
5414,Ruoka_paivittaistavarakauppa,2019-03-19 11:47:22.105263123,2019-03-19,2019-03-19,2019-03-19,6.0,-0.45,-350.55,0.0,162.0,           ,1.0,1.0,171.0
5415,Ruoka_paivittaistavarakauppa,2019-03-19 13:53:41.052631542,2019-03-19,2019-03-19,2019-03-19,6.0,-4.0,-354.55,0.0,162.0,           ,1.0,1.0,145.0
5416,Ruoka_paivittaistavarakauppa,2019-03-19 20:29:28.421052596,2019-03-19,2019-03-19,2019-03-19,6.0,-4.21,-358.76,0.0,162.0,           ,1.0,1.0,94.0
5417,Ruoka_paivittaistavarakauppa,2019-03-19 22:35:47.368421015,2019-03-19,2019-03-19,2019-03-19,6.0,-8.16,-366.92,0.0,162.0,           ,1.0,1.0,167.0
5418,Liikkuminen,2019-03-20 05:11:34.736842069,2019-03-20,2019-03-20,2019-03-20,6.0,-1.14,-368.06,0.0,162.0,           ,1.0,1.0,108.0
5419,Ruoka_paivittaistavarakauppa,2019-03-21 00:42:06.315789434,2019-03-21,2019-03-21,2019-03-21,6.0,-1.75,-369.81,0.0,162.0,           ,1.0,1.0,123.0
5420,Muut,2019-03-21 15:59:59.999999961,2019-03-21,2019-03-21,2019-03-21,6.0,-10.9,-380.71,0.0,162.0,           ,1.0,1.0,63.0
5421,Liikkuminen,2019-03-22 02:48:25.263157853,2019-03-22,2019-03-22,2019-03-22,6.0,-3.33,-384.04,0.0,162.0,           ,1.0,1.0,142.0
5422,Ruoka_paivittaistavarakauppa,2019-03-22 07:17:53.684210488,2019-03-22,2019-03-22,2019-03-22,6.0,-0.34,-384.38,0.0,162.0,           ,1.0,1.0,164.0
5423,Ravintolat_kahvilat,2019-03-22 09:24:12.631578907,2019-03-22,2019-03-22,2019-03-22,6.0,-5.86,-390.24,0.0,162.0,           ,1.0,1.0,96.0
5424,Asuminen,2019-03-22 11:30:31.578947326,2019-03-22,2019-03-22,2019-03-22,6.0,-83.35,-473.59,0.0,106.0,DABAFIHH   ,0.0,0.0,18.0
5425,Ruoka_paivittaistavarakauppa,2019-03-22 18:06:18.947368380,2019-03-22,2019-03-22,2019-03-22,6.0,-3.62,-477.21,0.0,162.0,           ,1.0,1.0,134.0
5426,Luokittelemattomat,2019-03-22 20:12:37.894736799,2019-03-22,2019-03-22,2019-03-22,6.0,-4.96,-482.17,0.0,106.0,SBANFIHH   ,1.0,0.0,35.0
5427,Ravintolat_kahvilat,2019-03-25 07:01:03.157894691,2019-03-25,2019-03-25,2019-03-25,6.0,-2.01,-484.18,0.0,162.0,           ,1.0,1.0,142.0
5428,Ruoka_paivittaistavarakauppa,2019-03-25 13:36:50.526315745,2019-03-25,2019-03-25,2019-03-25,6.0,-12.94,-497.12,0.0,162.0,           ,1.0,1.0,52.0
5429,Ruoka_paivittaistavarakauppa,2019-03-25 15:43:09.473684164,2019-03-25,2019-03-25,2019-03-25,6.0,-5.51,-502.63,0.0,162.0,           ,1.0,1.0,145.0
5430,Liikkuminen,2019-03-25 22:18:56.842105218,2019-03-25,2019-03-25,2019-03-25,6.0,-7.14,-509.77,0.0,162.0,           ,1.0,1.0,124.0
5431,Ruoka_paivittaistavarakauppa,2019-03-26 00:25:15.789473637,2019-03-26,2019-03-26,2019-03-26,6.0,-2.91,-512.68,0.0,162.0,           ,1.0,1.0,173.0
5432,Ruoka_paivittaistavarakauppa,2019-03-26 04:54:44.210526272,2019-03-26,2019-03-26,2019-03-26,6.0,-0.33,-513.01,0.0,162.0,           ,1.0,1.0,143.0
5433,Ruoka_paivittaistavarakauppa,2019-03-26 09:07:22.105263110,2019-03-26,2019-03-26,2019-03-26,6.0,-4.59,-517.6,0.0,162.0,           ,1.0,1.0,154.0
5434,Ravintolat_kahvilat,2019-03-26 17:49:28.421052583,2019-03-26,2019-03-26,2019-03-26,6.0,-2.45,-520.05,0.0,162.0,           ,1.0,1.0,91.0
5435,Ravintolat_kahvilat,2019-03-27 02:31:34.736842056,2019-03-27,2019-03-27,2019-03-27,6.0,-3.74,-523.79,0.0,162.0,           ,1.0,1.0,103.0
5436,Muut,2019-03-27 11:13:41.052631529,2019-03-27,2019-03-27,2019-03-27,6.0,-4.91,-528.7,0.0,162.0,           ,1.0,1.0,52.0
5437,Saastot_sijoitukset,2019-03-27 15:26:18.947368367,2019-03-27,2019-03-27,2019-03-27,6.0,-5.88,-534.58,0.0,162.0,           ,1.0,1.0,94.0
5438,Ruoka_paivittaistavarakauppa,2019-03-27 19:55:47.368421002,2019-03-27,2019-03-28,2019-03-27,6.0,-9.62,-544.2,0.0,162.0,           ,1.0,1.0,119.0
5439,Liikkuminen,2019-03-28 04:37:53.684210475,2019-03-28,2019-03-28,2019-03-28,6.0,-50.66,-594.86,0.0,162.0,           ,1.0,1.0,110.0
5440,Ruoka_paivittaistavarakauppa,2019-03-28 08:50:31.578947313,2019-03-28,2019-03-28,2019-03-28,6.0,-19.76,-614.62,0.0,162.0,           ,1.0,1.0,115.0
5441,Muut,2019-03-28 22:02:06.315789421,2019-03-28,2019-03-28,2019-03-28,6.0,-3.0,-617.62,0.0,162.0,           ,1.0,1.0,146.0
5442,Muut,2019-03-29 00:08:25.263157840,2019-03-29,2019-03-29,2019-03-29,6.0,-3.32,-620.94,0.0,162.0,           ,1.0,1.0,47.0
5443,Ravintolat_kahvilat,2019-03-29 02:14:44.210526259,2019-03-29,2019-03-29,2019-03-28,6.0,-14.17,-635.11,0.0,162.0,           ,1.0,1.0,87.0
5444,Terveys,2019-03-29 06:44:12.631578894,2019-03-29,2019-03-29,2019-03-29,6.0,-1.47,-636.58,0.0,162.0,           ,1.0,1.0,91.0
5445,Ruoka_paivittaistavarakauppa,2019-03-29 10:56:50.526315732,2019-03-29,2019-03-29,2019-03-29,6.0,-2.03,-638.61,0.0,162.0,           ,1.0,1.0,47.0
5446,Ruoka_paivittaistavarakauppa,2019-03-29 13:19:59.999999948,2019-03-29,2019-03-29,2019-03-29,6.0,-1.6,-640.21,0.0,162.0,           ,1.0,1.0,142.0
5447,Liikkuminen,2019-03-29 17:32:37.894736786,2019-03-29,2019-03-29,2019-03-29,6.0,-2.7,-642.91,0.0,162.0,           ,1.0,1.0,59.0
5448,Ravintolat_kahvilat,2019-03-29 19:38:56.842105205,2019-03-29,2019-03-29,2019-03-29,6.0,-1.92,-644.83,0.0,162.0,           ,1.0,1.0,48.0
5449,Ruoka_paivittaistavarakauppa,2019-04-01 12:58:22.702702702,2019-04-01,2019-04-01,2019-04-01,6.0,-0.45,-645.28,0.0,162.0,           ,1.0,1.0,157.0
5450,Ruoka_paivittaistavarakauppa,2019-04-02 01:56:45.405405404,2019-04-02,2019-04-02,2019-04-02,6.0,-1.83,-647.11,0.0,162.0,           ,1.0,1.0,95.0
5451,Ruoka_paivittaistavarakauppa,2019-04-02 14:55:08.108108106,2019-04-02,2019-04-02,2019-04-02,6.0,-6.5,-653.61,0.0,162.0,           ,1.0,1.0,95.0
5452,Ruoka_paivittaistavarakauppa,2019-04-03 03:53:30.810810808,2019-04-03,2019-04-03,2019-04-03,6.0,-20.45,-674.06,0.0,162.0,           ,1.0,1.0,158.0
5453,Ruoka_paivittaistavarakauppa,2019-04-03 16:51:53.513513510,2019-04-03,2019-04-03,2019-04-03,6.0,-5.31,-679.37,0.0,162.0,           ,1.0,1.0,53.0
5454,Liikkuminen,2019-04-04 05:50:16.216216212,2019-04-04,2019-04-04,2019-04-04,6.0,-4.92,-684.29,0.0,162.0,           ,1.0,1.0,108.0
5455,Ruoka_paivittaistavarakauppa,2019-04-04 18:48:38.918918914,2019-04-04,2019-04-04,2019-04-04,6.0,-7.72,-692.01,0.0,162.0,           ,1.0,1.0,154.0
5456,Asuminen,2019-04-05 07:47:01.621621616,2019-04-05,2019-04-05,2019-04-05,6.0,-6.03,-698.04,0.0,162.0,           ,1.0,1.0,115.0
5457,Liikkuminen,2019-04-05 09:43:47.027027020,2019-04-05,2019-04-05,2019-04-05,6.0,-11.09,-709.13,0.0,162.0,           ,1.0,1.0,124.0
5458,Ruoka_paivittaistavarakauppa,2019-04-05 20:45:24.324324318,2019-04-05,2019-04-05,2019-04-05,6.0,-13.74,-722.87,0.0,162.0,           ,1.0,1.0,47.0
5459,Ruoka_paivittaistavarakauppa,2019-04-05 22:42:09.729729722,2019-04-05,2019-04-05,2019-04-05,6.0,-5.39,-728.26,0.0,162.0,           ,1.0,1.0,88.0
5460,Ravintolat_kahvilat,2019-04-08 00:38:55.135135126,2019-04-08,2019-04-08,2019-04-08,6.0,-5.65,-733.91,0.0,162.0,           ,1.0,1.0,173.0
5461,Ruoka_paivittaistavarakauppa,2019-04-08 11:40:32.432432424,2019-04-08,2019-04-08,2019-04-08,6.0,-17.11,-751.02,0.0,162.0,           ,1.0,1.0,161.0
5462,Tulot,2019-04-08 13:37:17.837837828,2019-04-08,2019-04-08,2019-04-08,6.0,1068.03,317.01,701.0,506.0,           ,1.0,1.0,213.0
5463,Tulot,2019-04-09 02:35:40.540540530,2019-04-09,2019-04-09,2019-04-09,6.0,2.77,319.78,710.0,588.0,           ,0.0,1.0,240.0
5464,Harrastukset,2019-04-10 04:32:25.945945934,2019-04-10,2019-04-10,2019-04-10,6.0,-18.95,300.83,0.0,106.0,OKOYFIHH   ,0.0,0.0,5.0
5465,Kulttuuri_viihde,2019-04-11 06:29:11.351351338,2019-04-11,2019-04-11,2019-04-11,6.0,-5.37,295.46,0.0,106.0,OKOYFIHH   ,0.0,0.0,14.0
5466,Matkailu,2019-04-11 15:34:03.243243232,2019-04-11,2019-04-11,2019-04-11,6.0,-78.21,217.25,0.0,106.0,NDEAFIHH   ,0.0,0.0,6.0
5467,Hyvinvointi,2019-04-11 17:30:48.648648636,2019-04-11,2019-04-11,2019-04-11,6.0,-61.54,155.71,0.0,106.0,OKOYFIHH   ,0.0,0.0,12.0
5468,Tulot,2019-04-12 10:22:42.162162146,2019-04-12,2019-04-12,2019-04-12,6.0,1.35,157.06,710.0,588.0,           ,0.0,1.0,239.0
5469,Luottojen_maksut,2019-04-12 19:27:34.054054040,2019-04-12,2019-04-12,2019-04-12,6.0,-136.76,20.3,0.0,172.0,           ,1.0,1.0,196.0
5470,Muut,2019-04-12 21:24:19.459459444,2019-04-12,2019-04-12,2019-04-12,6.0,-18.88,1.42,0.0,106.0,OKOYFIHH   ,0.0,0.0,33.0
5471,Ruoka_paivittaistavarakauppa,2019-04-12 23:21:04.864864848,2019-04-12,2019-04-12,2019-04-12,6.0,-2.01,-0.59,0.0,162.0,           ,1.0,1.0,170.0
5472,Lemmikit,2019-04-13 08:25:56.756756742,2019-04-13,2019-04-13,2019-04-13,6.0,-26.5,-27.09,0.0,106.0,OKOYFIHH   ,0.0,0.0,4.0
5473,Lemmikit,2019-04-15 01:17:50.270270252,2019-04-15,2019-04-15,2019-04-15,6.0,-9.71,-36.8,0.0,162.0,           ,1.0,1.0,132.0
5474,Ruoka_paivittaistavarakauppa,2019-04-15 12:19:27.567567550,2019-04-15,2019-04-15,2019-04-15,6.0,-4.87,-41.67,0.0,162.0,           ,1.0,1.0,52.0
5475,Ruoka_paivittaistavarakauppa,2019-04-15 14:16:12.972972954,2019-04-15,2019-04-15,2019-04-15,6.0,-13.3,-54.97,0.0,162.0,           ,1.0,1.0,101.0
5476,Ruoka_paivittaistavarakauppa,2019-04-16 03:14:35.675675656,2019-04-16,2019-04-16,2019-04-16,6.0,-37.82,-92.79,0.0,162.0,           ,1.0,1.0,120.0
5477,Asuminen,2019-04-16 16:12:58.378378358,2019-04-16,2019-04-16,2019-04-16,6.0,-4.8,-97.59,0.0,162.0,           ,1.0,1.0,130.0
5478,Ruoka_paivittaistavarakauppa,2019-04-17 05:11:21.081081060,2019-04-17,2019-04-17,2019-04-17,6.0,-4.27,-101.86,0.0,192.0,           ,0.0,1.0,197.0
5479,Ruoka_paivittaistavarakauppa,2019-04-18 07:08:06.486486464,2019-04-18,2019-04-18,2019-04-18,6.0,-0.38,-102.24,0.0,162.0,           ,1.0,1.0,121.0
5480,Hyvinvointi,2019-04-18 18:09:43.783783762,2019-04-18,2019-04-18,2019-04-18,6.0,-7.12,-109.36,0.0,162.0,           ,1.0,1.0,82.0
5481,Ruoka_paivittaistavarakauppa,2019-04-18 20:06:29.189189166,2019-04-18,2019-04-18,2019-04-18,6.0,-6.11,-115.47,0.0,162.0,           ,1.0,1.0,122.0
5482,Tulot,2019-04-18 22:03:14.594594570,2019-04-18,2019-04-18,2019-04-18,6.0,-50.03,-165.5,0.0,106.0,SBANFIHH   ,0.0,0.0,8.0
5483,Luokittelemattomat,2019-04-19 09:04:51.891891868,2019-04-19,2019-04-19,2019-04-19,6.0,-10.32,-175.82,0.0,106.0,OKOYFIHH   ,0.0,0.0,28.0
5484,Tulot,2019-04-19 11:01:37.297297272,2019-04-19,2019-04-19,2019-04-19,6.0,488.3,312.48,701.0,506.0,           ,1.0,1.0,211.0
5485,Lemmikit,2019-04-19 23:59:59.999999974,2019-04-19,2019-04-19,2019-04-18,6.0,-4.56,307.92,0.0,162.0,           ,1.0,1.0,62.0
5486,Ruoka_paivittaistavarakauppa,2019-04-22 01:56:45.405405378,2019-04-22,2019-04-22,2019-04-22,6.0,-47.62,260.3,0.0,162.0,           ,1.0,1.0,119.0
5487,Ruoka_paivittaistavarakauppa,2019-04-22 05:50:16.216216186,2019-04-22,2019-04-22,2019-04-22,6.0,-1.66,258.64,0.0,162.0,           ,1.0,1.0,145.0
5488,Lemmikit,2019-04-22 12:58:22.702702676,2019-04-22,2019-04-22,2019-04-22,6.0,-20.84,237.8,0.0,162.0,           ,1.0,1.0,102.0
5489,Ruoka_paivittaistavarakauppa,2019-04-22 14:55:08.108108080,2019-04-22,2019-04-22,2019-04-22,6.0,-21.5,216.3,0.0,162.0,           ,1.0,1.0,179.0
5490,Ruoka_paivittaistavarakauppa,2019-04-23 03:53:30.810810782,2019-04-23,2019-04-23,2019-04-23,6.0,-32.09,184.21,0.0,162.0,           ,1.0,1.0,112.0
5491,Hyvinvointijakauneus,2019-04-23 16:51:53.513513484,2019-04-23,2019-04-23,2019-04-23,6.0,-45.74,138.47,0.0,162.0,           ,1.0,1.0,145.0
5492,Tulot,2019-04-25 18:48:38.918918888,2019-04-25,2019-04-25,2019-04-25,6.0,27.31,165.78,710.0,506.0,           ,1.0,1.0,230.0
5493,Ruoka_paivittaistavarakauppa,2019-04-25 22:42:09.729729696,2019-04-25,2019-04-25,2019-04-25,6.0,-2.05,163.73,0.0,162.0,           ,1.0,1.0,82.0
5494,Matkailu,2019-04-26 07:47:01.621621590,2019-04-26,2019-04-26,2019-04-26,6.0,-25.17,138.56,0.0,106.0,DABAFIHH   ,0.0,0.0,5.0
5495,Ravintolat_kahvilat,2019-04-26 11:40:32.432432398,2019-04-26,2019-04-26,2019-04-26,6.0,-0.43,138.13,0.0,162.0,           ,1.0,1.0,154.0
5496,Ruoka_paivittaistavarakauppa,2019-04-26 20:45:24.324324292,2019-04-26,2019-04-26,2019-04-26,6.0,-12.22,125.91,0.0,162.0,           ,1.0,1.0,77.0
5497,Ruoka_paivittaistavarakauppa,2019-04-29 00:38:55.135135100,2019-04-29,2019-04-29,2019-04-29,6.0,-10.14,115.77,0.0,162.0,           ,1.0,1.0,63.0
5498,Tulot,2019-04-29 02:35:40.540540504,2019-04-29,2019-04-29,2019-04-29,6.0,87.88,203.65,701.0,506.0,           ,1.0,1.0,210.0
5499,Ruoka_paivittaistavarakauppa,2019-04-29 04:32:25.945945908,2019-04-29,2019-04-29,2019-04-29,6.0,-2.25,201.4,0.0,162.0,           ,1.0,1.0,91.0
5500,Ruoka_paivittaistavarakauppa,2019-04-29 09:43:47.027026994,2019-04-29,2019-04-30,2019-04-29,6.0,-20.48,180.92,0.0,162.0,           ,1.0,1.0,121.0
5501,Ruoka_paivittaistavarakauppa,2019-04-29 13:37:17.837837802,2019-04-29,2019-04-29,2019-04-29,6.0,-3.83,177.09,0.0,162.0,           ,1.0,1.0,102.0
5502,Luottojen_maksut,2019-04-29 15:34:03.243243206,2019-04-29,2019-04-29,2019-04-29,6.0,-13.19,163.9,0.0,106.0,OKOYFIHH   ,1.0,0.0,31.0
5503,Matkailu,2019-04-30 17:30:48.648648610,2019-04-30,2019-04-30,2019-04-29,6.0,-16.22,147.68,0.0,149.0,           ,1.0,1.0,43.0
5504,Shoppailu,2019-05-01 09:51:15.496688741,2019-05-01,2019-05-01,2019-05-01,6.0,-8.07,139.61,0.0,162.0,           ,1.0,1.0,145.0
5505,Terveys,2019-05-02 05:33:46.490066223,2019-05-02,2019-05-02,2019-05-02,6.0,-26.04,113.57,0.0,162.0,           ,1.0,1.0,77.0
5506,Ruoka_paivittaistavarakauppa,2019-05-02 15:25:01.986754964,2019-05-02,2019-05-02,2019-05-02,6.0,-14.58,98.99,0.0,162.0,           ,1.0,1.0,81.0
5507,Ruoka_paivittaistavarakauppa,2019-05-02 19:42:30.993377482,2019-05-02,2019-05-02,2019-05-02,6.0,-3.15,95.84,0.0,162.0,           ,1.0,1.0,95.0
5508,Ruoka_paivittaistavarakauppa,2019-05-03 01:16:17.483443705,2019-05-03,2019-05-03,2019-05-03,6.0,-4.3,91.54,0.0,162.0,           ,1.0,1.0,46.0
5509,Muut,2019-05-03 11:07:32.980132446,2019-05-03,2019-05-03,2019-05-03,6.0,-45.97,45.57,0.0,163.0,           ,1.0,1.0,184.0
5510,Ravintolat_kahvilat,2019-05-03 16:41:19.470198669,2019-05-03,2019-05-03,2019-05-03,6.0,-1.39,44.18,0.0,162.0,           ,1.0,1.0,94.0
5511,Lapset,2019-05-03 20:58:48.476821187,2019-05-03,2019-05-03,2019-05-03,6.0,-8.65,35.53,0.0,162.0,           ,1.0,1.0,138.0
5512,Ravintolat_kahvilat,2019-05-06 02:32:34.966887410,2019-05-06,2019-05-06,2019-05-06,6.0,-1.24,34.29,0.0,162.0,           ,1.0,1.0,156.0
5513,Kulttuuri_viihde,2019-05-06 08:06:21.456953633,2019-05-06,2019-05-06,2019-05-06,6.0,-7.36,26.93,0.0,162.0,           ,1.0,1.0,154.0
5514,Liikkuminen,2019-05-06 17:57:36.953642374,2019-05-06,2019-05-06,2019-05-06,6.0,-3.57,23.36,0.0,162.0,           ,1.0,1.0,132.0
5515,Tulot,2019-05-06 22:15:05.960264892,2019-05-06,2019-05-06,2019-05-06,6.0,36.16,59.52,710.0,588.0,           ,0.0,1.0,239.0
5516,Ruoka_paivittaistavarakauppa,2019-05-07 03:48:52.450331115,2019-05-07,2019-05-07,2019-05-07,6.0,-25.38,34.14,0.0,162.0,           ,1.0,1.0,111.0
5517,Luokittelemattomat,2019-05-07 06:50:03.973509928,2019-05-07,2019-05-07,2019-05-06,6.0,-8.01,26.13,0.0,162.0,           ,1.0,1.0,78.0
5518,Lapset,2019-05-07 12:23:50.463576151,2019-05-07,2019-05-07,2019-05-07,6.0,-4.02,22.11,0.0,162.0,           ,1.0,1.0,80.0
5519,Ruoka_paivittaistavarakauppa,2019-05-07 13:40:07.947019856,2019-05-07,2019-05-07,2019-05-07,6.0,-7.47,14.64,0.0,162.0,           ,1.0,1.0,77.0
5520,Ruoka_paivittaistavarakauppa,2019-05-07 23:31:23.443708597,2019-05-07,2019-05-07,2019-05-07,6.0,-6.29,8.35,0.0,162.0,           ,1.0,1.0,55.0
5521,Asuminen,2019-05-08 05:05:09.933774820,2019-05-08,2019-05-08,2019-05-08,6.0,-11.51,-3.16,0.0,106.0,OKOYFIHH   ,0.0,0.0,9.0
5522,Matkailu,2019-05-08 09:22:38.940397338,2019-05-08,2019-05-08,2019-05-08,6.0,-7.4,-10.56,0.0,162.0,           ,1.0,1.0,96.0
5523,Liikkuminen,2019-05-08 10:38:56.423841043,2019-05-08,2019-05-08,2019-05-08,6.0,-16.75,-27.31,0.0,162.0,           ,1.0,1.0,121.0
5524,Lemmikit,2019-05-08 19:13:54.437086079,2019-05-08,2019-05-08,2019-05-08,6.0,-20.21,-47.52,0.0,162.0,           ,1.0,1.0,154.0
5525,Ruoka_paivittaistavarakauppa,2019-05-09 14:56:25.430463561,2019-05-09,2019-05-09,2019-05-09,6.0,-0.91,-48.43,0.0,162.0,           ,1.0,1.0,164.0
5526,Ravintolat_kahvilat,2019-05-10 00:47:40.927152302,2019-05-10,2019-05-10,2019-05-10,6.0,-20.26,-68.69,0.0,162.0,           ,1.0,1.0,57.0
5527,Ravintolat_kahvilat,2019-05-10 06:21:27.417218525,2019-05-10,2019-05-10,2019-05-10,6.0,-5.97,-74.66,0.0,162.0,           ,1.0,1.0,111.0
5528,Ruoka_paivittaistavarakauppa,2019-05-10 20:30:11.920529784,2019-05-10,2019-05-10,2019-05-10,6.0,-5.08,-79.74,0.0,162.0,           ,1.0,1.0,91.0
5529,Muut,2019-05-12 21:46:29.403973489,2019-05-12,2019-05-12,2019-05-12,6.0,-32.53,-112.27,0.0,163.0,           ,1.0,1.0,184.0
5530,Ravintolat_kahvilat,2019-05-13 02:03:58.410596007,2019-05-13,2019-05-13,2019-05-13,6.0,-0.25,-112.52,0.0,162.0,           ,1.0,1.0,154.0
5531,Liikkuminen,2019-05-13 03:20:15.894039712,2019-05-13,2019-05-13,2019-05-13,6.0,-25.45,-137.97,0.0,162.0,           ,1.0,1.0,132.0
5532,Ravintolat_kahvilat,2019-05-13 07:37:44.900662230,2019-05-13,2019-05-13,2019-05-13,6.0,-6.23,-144.2,0.0,162.0,           ,1.0,1.0,91.0
5533,Liikkuminen,2019-05-13 11:55:13.907284748,2019-05-13,2019-05-13,2019-05-13,6.0,-1.05,-145.25,0.0,162.0,           ,1.0,1.0,169.0
5534,Ravintolat_kahvilat,2019-05-13 16:12:42.913907266,2019-05-13,2019-05-13,2019-05-13,6.0,-70.58,-215.83,0.0,162.0,           ,1.0,1.0,121.0
5535,Ruoka_paivittaistavarakauppa,2019-05-13 17:29:00.397350971,2019-05-13,2019-05-13,2019-05-13,6.0,-8.63,-224.46,0.0,162.0,           ,1.0,1.0,143.0
5536,Ruoka_paivittaistavarakauppa,2019-05-14 10:10:19.867549640,2019-05-14,2019-05-14,2019-05-14,6.0,-1.57,-226.03,0.0,162.0,           ,1.0,1.0,96.0
5537,Lemmikit,2019-05-14 13:11:31.390728453,2019-05-14,2019-05-14,2019-05-14,6.0,-33.98,-260.01,0.0,106.0,OKOYFIHH   ,0.0,0.0,26.0
5538,Liikkuminen,2019-05-14 23:02:46.887417194,2019-05-14,2019-05-14,2019-05-14,6.0,-25.49,-285.5,0.0,106.0,OKOYFIHH   ,1.0,0.0,5.0
5539,Muut,2019-05-15 04:36:33.377483417,2019-05-15,2019-05-15,2019-05-15,6.0,-0.72,-286.22,0.0,162.0,           ,1.0,1.0,113.0
5540,Lemmikit,2019-05-15 08:54:02.384105935,2019-05-15,2019-05-15,2019-05-15,6.0,-24.26,-310.48,0.0,106.0,OKOYFIHH   ,1.0,0.0,15.0
5541,Lemmikit,2019-05-15 14:27:48.874172158,2019-05-15,2019-05-15,2019-05-15,6.0,-4.59,-315.07,0.0,162.0,           ,1.0,1.0,63.0
5542,Ravintolat_kahvilat,2019-05-15 18:45:17.880794676,2019-05-15,2019-05-15,2019-05-15,6.0,-9.62,-324.69,0.0,162.0,           ,1.0,1.0,117.0
5543,Ravintolat_kahvilat,2019-05-17 00:19:04.370860899,2019-05-17,2019-05-17,2019-05-17,6.0,-3.37,-328.06,0.0,162.0,           ,1.0,1.0,55.0
5544,Tulot,2019-05-17 20:01:35.364238381,2019-05-17,2019-05-17,2019-05-17,6.0,28.94,-299.12,710.0,506.0,           ,1.0,1.0,231.0
5545,Luokittelemattomat,2019-05-19 01:35:21.854304604,2019-05-19,2019-05-19,2019-05-19,6.0,-36.96,-336.08,0.0,106.0,OKOYFIHH   ,1.0,0.0,4.0
5546,Liikkuminen,2019-05-19 11:26:37.350993345,2019-05-19,2019-05-19,2019-05-19,6.0,-23.01,-359.09,0.0,106.0,OKOYFIHH   ,0.0,0.0,27.0
5547,Luokittelemattomat,2019-05-19 21:17:52.847682086,2019-05-19,2019-05-19,2019-05-19,6.0,-17.94,-377.03,0.0,106.0,ITELFIHH   ,0.0,0.0,5.0
5548,Liikkuminen,2019-05-20 02:51:39.337748309,2019-05-20,2019-05-20,2019-05-20,6.0,-8.34,-385.37,0.0,162.0,           ,1.0,1.0,131.0
5549,Luokittelemattomat,2019-05-20 05:52:50.860927122,2019-05-20,2019-05-20,2019-05-20,6.0,-10.28,-395.65,0.0,162.0,           ,1.0,1.0,103.0
5550,Vakuutukset,2019-05-20 07:09:08.344370827,2019-05-20,2019-05-20,2019-05-20,6.0,-18.18,-413.83,0.0,106.0,OKOYFIHH   ,0.0,0.0,30.0
5551,Liikkuminen,2019-05-20 12:42:54.834437050,2019-05-20,2019-05-20,2019-05-20,6.0,-3.56,-417.39,0.0,162.0,           ,1.0,1.0,110.0
5552,Ravintolat_kahvilat,2019-05-20 15:44:06.357615863,2019-05-20,2019-05-20,2019-05-20,6.0,-3.8,-421.19,0.0,162.0,           ,1.0,1.0,115.0
5553,Muut,2019-05-20 17:00:23.841059568,2019-05-20,2019-05-20,2019-05-20,6.0,-13.33,-434.52,0.0,162.0,           ,1.0,1.0,110.0
5554,Ruoka_paivittaistavarakauppa,2019-05-20 22:34:10.331125791,2019-05-20,2019-05-20,2019-05-20,6.0,-9.11,-443.63,0.0,162.0,           ,1.0,1.0,158.0
5555,Muut,2019-05-21 08:25:25.827814532,2019-05-21,2019-05-21,2019-05-21,6.0,-0.79,-444.42,0.0,162.0,           ,1.0,1.0,143.0
5556,Asuminen,2019-05-22 18:16:41.324503273,2019-05-22,2019-05-22,2019-05-22,6.0,-8.24,-452.66,706.0,129.0,NDEAFIHH   ,0.0,0.0,224.0
5557,Ruoka_paivittaistavarakauppa,2019-05-23 04:07:56.821192014,2019-05-23,2019-05-23,2019-05-23,6.0,-2.67,-455.33,0.0,162.0,           ,1.0,1.0,128.0
5558,Ruoka_paivittaistavarakauppa,2019-05-23 09:41:43.311258237,2019-05-23,2019-05-23,2019-05-22,6.0,-5.44,-460.77,0.0,162.0,           ,1.0,1.0,101.0
5559,Asuminen,2019-05-23 23:50:27.814569496,2019-05-23,2019-05-23,2019-05-23,6.0,-60.44,-521.21,706.0,106.0,NDEAFIHH   ,0.0,0.0,221.0
5560,Ruoka_paivittaistavarakauppa,2019-05-24 05:24:14.304635719,2019-05-24,2019-05-24,2019-05-24,6.0,-2.91,-524.12,0.0,162.0,           ,1.0,1.0,110.0
5561,Tulot,2019-05-24 13:59:12.317880755,2019-05-24,2019-05-27,2019-05-24,6.0,534.6,10.48,701.0,506.0,           ,1.0,1.0,211.0
5562,Lemmikit,2019-05-24 19:32:58.807946978,2019-05-24,2019-05-24,2019-05-24,6.0,-18.77,-8.29,0.0,162.0,           ,1.0,1.0,91.0
5563,Lemmikit,2019-05-27 02:23:02.781456906,2019-05-27,2019-05-27,2019-05-27,6.0,-23.08,-31.37,0.0,106.0,OKOYFIHH   ,0.0,0.0,16.0
5564,Tulot,2019-05-27 06:40:31.788079424,2019-05-27,2019-05-27,2019-05-27,6.0,87.64,56.27,0.0,506.0,           ,1.0,1.0,205.0
5565,Luokittelemattomat,2019-05-27 10:58:00.794701942,2019-05-27,2019-05-27,2019-05-27,6.0,-30.93,25.34,0.0,162.0,           ,1.0,1.0,123.0
5566,Liikkuminen,2019-05-27 15:15:29.801324460,2019-05-27,2019-05-28,2019-05-27,6.0,-17.41,7.93,0.0,162.0,           ,1.0,1.0,77.0
5567,Asuminen,2019-05-27 16:31:47.284768165,2019-05-27,2019-05-27,2019-05-27,6.0,-23.98,-16.05,0.0,162.0,           ,1.0,1.0,168.0
5568,Tulot,2019-05-27 20:49:16.291390683,2019-05-27,2019-05-28,2019-05-27,6.0,30.81,14.76,710.0,506.0,           ,1.0,1.0,233.0
5569,Ruoka_paivittaistavarakauppa,2019-05-28 01:06:45.298013201,2019-05-28,2019-05-28,2019-05-28,6.0,-9.61,5.15,0.0,162.0,           ,1.0,1.0,143.0
5570,Tulot,2019-05-28 12:14:18.278145647,2019-05-28,2019-05-28,2019-05-28,6.0,9.51,14.66,710.0,506.0,           ,1.0,1.0,234.0
5571,Tulot,2019-05-28 17:48:04.768211870,2019-05-28,2019-05-29,2019-05-28,6.0,16.26,30.92,710.0,506.0,           ,1.0,1.0,235.0
5572,Asuminen,2019-05-28 22:05:33.774834388,2019-05-28,2019-05-28,2019-05-28,6.0,-6.61,24.31,706.0,129.0,NDEAFIHH   ,0.0,0.0,228.0
5573,Tulot,2019-05-29 07:56:49.271523129,2019-05-29,2019-05-29,2019-05-29,6.0,3.93,28.24,710.0,506.0,           ,1.0,1.0,230.0
5574,Tulot,2019-05-30 09:13:06.754966834,2019-05-30,2019-05-30,2019-05-30,6.0,73.22,101.46,710.0,506.0,           ,1.0,1.0,233.0
5575,Ruoka_paivittaistavarakauppa,2019-05-30 13:30:35.761589352,2019-05-30,2019-05-30,2019-05-30,6.0,-35.62,65.84,0.0,162.0,           ,1.0,1.0,50.0
5576,Tulot,2019-05-30 23:21:51.258278093,2019-05-30,2019-05-30,2019-05-30,6.0,45.74,111.58,710.0,506.0,           ,1.0,1.0,234.0
5577,Ravintolat_kahvilat,2019-05-31 03:39:20.264900611,2019-05-31,2019-05-31,2019-05-31,6.0,-3.39,108.19,0.0,162.0,           ,1.0,1.0,167.0
5578,Ruoka_paivittaistavarakauppa,2019-05-31 19:04:22.251655575,2019-05-31,2019-05-31,2019-05-31,6.0,-15.18,93.01,0.0,162.0,           ,1.0,1.0,111.0
5579,Asuminen,2019-06-03 05:20:00.000000000,2019-06-03,2019-06-03,2019-06-03,6.0,-31.78,61.23,706.0,129.0,OKOYFIHH   ,0.0,0.0,227.0
5580,Tulot,2019-06-03 11:33:20.000000000,2019-06-03,2019-06-03,2019-06-03,6.0,39.67,100.9,710.0,506.0,           ,1.0,1.0,231.0
5581,Luottojen_maksut,2019-06-03 17:46:40.000000000,2019-06-03,2019-06-03,2019-06-03,6.0,-26.11,74.79,0.0,172.0,           ,1.0,1.0,195.0
5582,Luokittelemattomat,2019-06-03 23:06:40.000000000,2019-06-03,2019-06-03,2019-06-03,6.0,-37.52,37.27,706.0,106.0,NDEAFIHH   ,1.0,0.0,220.0
5583,Ruoka_paivittaistavarakauppa,2019-06-04 10:40:00.000000000,2019-06-04,2019-06-04,2019-06-04,6.0,-3.0,34.27,0.0,162.0,           ,1.0,1.0,143.0
5584,Lapset,2019-06-04 16:53:20.000000000,2019-06-04,2019-06-05,2019-06-04,6.0,-10.84,23.43,0.0,162.0,           ,1.0,1.0,46.0
5585,Luottojen_maksut,2019-06-05 04:26:40.000000000,2019-06-05,2019-06-05,2019-06-05,6.0,-66.67,-43.24,0.0,106.0,OKOYFIHH   ,0.0,0.0,38.0
5586,Tulot,2019-06-06 22:13:20.000000000,2019-06-06,2019-06-06,2019-06-06,6.0,56.42,13.18,710.0,506.0,           ,1.0,1.0,233.0
5587,Tulot,2019-06-07 09:46:40.000000000,2019-06-07,2019-06-07,2019-06-07,6.0,24.36,37.54,710.0,506.0,           ,1.0,1.0,230.0
5588,Tulot,2019-06-07 16:00:00.000000000,2019-06-07,2019-06-07,2019-06-07,6.0,8.37,45.91,710.0,506.0,           ,1.0,1.0,231.0
5589,Tulot,2019-06-10 03:33:20.000000000,2019-06-10,2019-06-10,2019-06-10,6.0,26.42,72.33,710.0,506.0,           ,1.0,1.0,230.0
5590,Liikkuminen,2019-06-10 15:06:40.000000000,2019-06-10,2019-06-10,2019-06-10,6.0,-2.81,69.52,0.0,162.0,           ,1.0,1.0,102.0
5591,Luokittelemattomat,2019-06-10 20:26:40.000000000,2019-06-10,2019-06-10,2019-06-10,6.0,-6.12,63.4,0.0,162.0,           ,1.0,1.0,99.0
5592,Saastot_sijoitukset,2019-06-10 21:20:00.000000000,2019-06-10,2019-06-10,2019-06-10,6.0,-0.88,62.52,0.0,162.0,           ,1.0,1.0,130.0
5593,Ravintolat_kahvilat,2019-06-12 02:40:00.000000000,2019-06-12,2019-06-12,2019-06-12,6.0,-18.8,43.72,0.0,162.0,           ,1.0,1.0,152.0
5594,Luokittelemattomat,2019-06-12 08:53:20.000000000,2019-06-12,2019-06-12,2019-06-12,6.0,-10.87,32.85,0.0,106.0,NDEAFIHH   ,1.0,0.0,4.0
5595,Lapset,2019-06-13 01:46:40.000000000,2019-06-13,2019-06-13,2019-06-13,6.0,-8.69,24.16,0.0,106.0,OKOYFIHH   ,0.0,0.0,19.0
5596,Ruoka_paivittaistavarakauppa,2019-06-13 14:13:20.000000000,2019-06-13,2019-06-13,2019-06-13,6.0,-10.75,13.41,0.0,162.0,           ,1.0,1.0,132.0
5597,Asuminen,2019-06-14 08:00:00.000000000,2019-06-14,2019-06-14,2019-06-14,6.0,-29.43,-16.02,706.0,129.0,NDEAFIHH   ,0.0,0.0,225.0
5598,Kulttuuri_viihde,2019-06-16 13:20:00.000000000,2019-06-16,2019-06-16,2019-06-16,6.0,-5.97,-21.99,0.0,106.0,OKOYFIHH   ,0.0,0.0,21.0
5599,Liikkuminen,2019-06-16 19:33:20.000000000,2019-06-16,2019-06-16,2019-06-16,6.0,-30.42,-52.41,0.0,106.0,OKOYFIHH   ,0.0,0.0,4.0
5600,Luottojen_maksut,2019-06-17 07:06:40.000000000,2019-06-17,2019-06-17,2019-06-17,6.0,-29.75,-82.16,0.0,172.0,           ,1.0,1.0,192.0
5601,Tulot,2019-06-18 00:53:20.000000000,2019-06-18,2019-06-19,2019-06-18,6.0,43.05,-39.11,710.0,506.0,           ,1.0,1.0,236.0
5602,Matkailu,2019-06-18 18:40:00.000000000,2019-06-18,2019-06-18,2019-06-18,6.0,-6.3,-45.41,0.0,162.0,           ,1.0,1.0,144.0
5603,Ruoka_paivittaistavarakauppa,2019-06-19 12:26:40.000000000,2019-06-19,2019-06-19,2019-06-19,6.0,-9.38,-54.79,0.0,162.0,           ,1.0,1.0,60.0
5604,Luokittelemattomat,2019-06-20 00:00:00.000000000,2019-06-20,2019-06-20,2019-06-20,6.0,-7.26,-62.05,0.0,162.0,           ,1.0,1.0,132.0
5605,Lapset,2019-06-20 06:13:20.000000000,2019-06-20,2019-06-20,2019-06-20,6.0,-14.1,-76.15,0.0,162.0,           ,1.0,1.0,103.0
5606,Ruoka_paivittaistavarakauppa,2019-06-20 17:46:40.000000000,2019-06-20,2019-06-20,2019-06-20,6.0,-2.59,-78.74,0.0,162.0,           ,1.0,1.0,56.0
5607,Kulttuuri_viihde,2019-06-24 05:20:00.000000000,2019-06-24,2019-06-24,2019-06-24,6.0,-6.67,-85.41,0.0,162.0,           ,1.0,1.0,126.0
5608,Ruoka_paivittaistavarakauppa,2019-06-24 11:33:20.000000000,2019-06-24,2019-06-24,2019-06-24,6.0,-4.25,-89.66,0.0,162.0,           ,1.0,1.0,123.0
5609,Ruoka_paivittaistavarakauppa,2019-06-24 16:53:20.000000000,2019-06-24,2019-06-24,2019-06-24,6.0,-25.86,-115.52,0.0,162.0,           ,1.0,1.0,77.0
5610,Ruoka_paivittaistavarakauppa,2019-06-24 23:06:40.000000000,2019-06-24,2019-06-24,2019-06-24,6.0,-21.68,-137.2,0.0,162.0,           ,1.0,1.0,76.0
5611,Tulot,2019-06-25 04:26:40.000000000,2019-06-25,2019-06-25,2019-06-25,6.0,279.24,142.04,710.0,506.0,           ,1.0,1.0,235.0
5612,Tulot,2019-06-25 10:40:00.000000000,2019-06-25,2019-06-27,2019-06-25,6.0,912.26,1054.3,701.0,506.0,           ,1.0,1.0,212.0
5613,Ruoka_paivittaistavarakauppa,2019-06-26 22:13:20.000000000,2019-06-26,2019-06-26,2019-06-26,6.0,-22.44,1031.86,0.0,162.0,           ,1.0,1.0,84.0
5614,Ruoka_paivittaistavarakauppa,2019-06-27 09:46:40.000000000,2019-06-27,2019-06-27,2019-06-27,6.0,-3.43,1028.43,0.0,162.0,           ,1.0,1.0,91.0
5615,Ruoka_paivittaistavarakauppa,2019-06-27 15:06:40.000000000,2019-06-27,2019-06-27,2019-06-27,6.0,-4.42,1024.01,0.0,162.0,           ,1.0,1.0,92.0
5616,Ruoka_paivittaistavarakauppa,2019-06-27 16:00:00.000000000,2019-06-27,2019-06-27,2019-06-27,6.0,-12.73,1011.28,0.0,162.0,           ,1.0,1.0,132.0
5617,Ravintolat_kahvilat,2019-06-27 21:20:00.000000000,2019-06-27,2019-06-27,2019-06-27,6.0,-1.65,1009.63,0.0,162.0,           ,1.0,1.0,111.0
5618,Ruoka_paivittaistavarakauppa,2019-06-28 03:33:20.000000000,2019-06-28,2019-06-28,2019-06-28,6.0,-8.37,1001.26,0.0,162.0,           ,1.0,1.0,55.0
5619,Asuminen,2019-07-01 21:33:54.782608695,2019-07-01,2019-07-01,2019-07-01,6.0,-12.09,989.17,706.0,129.0,OKOYFIHH   ,0.0,0.0,226.0
5620,Ravintolat_kahvilat,2019-07-02 19:07:49.565217390,2019-07-02,2019-07-02,2019-07-02,6.0,-74.56,914.61,0.0,162.0,           ,1.0,1.0,63.0
5621,Liikkuminen,2019-07-03 16:41:44.347826085,2019-07-03,2019-07-03,2019-07-03,6.0,-23.4,891.21,0.0,162.0,           ,1.0,1.0,110.0
5622,Tulot,2019-07-04 14:15:39.130434780,2019-07-04,2019-07-04,2019-07-04,6.0,34.42,925.63,710.0,506.0,           ,1.0,1.0,231.0
5623,Ruoka_paivittaistavarakauppa,2019-07-05 11:49:33.913043475,2019-07-05,2019-07-05,2019-07-05,6.0,-3.28,922.35,0.0,162.0,           ,1.0,1.0,124.0
5624,Ruoka_paivittaistavarakauppa,2019-07-08 04:31:18.260869560,2019-07-08,2019-07-08,2019-07-08,6.0,-3.76,918.59,0.0,162.0,           ,1.0,1.0,164.0
5625,Ravintolat_kahvilat,2019-07-08 06:57:23.478260865,2019-07-08,2019-07-08,2019-07-08,6.0,-2.29,916.3,0.0,162.0,           ,1.0,1.0,94.0
5626,Ruoka_paivittaistavarakauppa,2019-07-08 09:23:28.695652170,2019-07-08,2019-07-08,2019-07-08,6.0,-1.92,914.38,0.0,162.0,           ,1.0,1.0,160.0
5627,Lemmikit,2019-07-09 02:05:13.043478255,2019-07-09,2019-07-09,2019-07-09,6.0,-10.12,904.26,0.0,162.0,           ,1.0,1.0,55.0
5628,Lapset,2019-07-09 21:13:02.608695645,2019-07-09,2019-07-09,2019-07-09,6.0,-84.24,820.02,0.0,106.0,NDEAFIHH   ,0.0,0.0,31.0
5629,Ravintolat_kahvilat,2019-07-09 23:39:07.826086950,2019-07-09,2019-07-09,2019-07-09,6.0,-6.49,813.53,0.0,162.0,           ,1.0,1.0,173.0
5630,Ruoka_paivittaistavarakauppa,2019-07-11 18:46:57.391304340,2019-07-11,2019-07-11,2019-07-11,6.0,-11.34,802.19,0.0,162.0,           ,1.0,1.0,110.0
5631,Ruoka_paivittaistavarakauppa,2019-07-12 13:54:46.956521730,2019-07-12,2019-07-12,2019-07-12,6.0,-21.12,781.07,0.0,162.0,           ,1.0,1.0,104.0
5632,Ruoka_paivittaistavarakauppa,2019-07-12 16:20:52.173913035,2019-07-12,2019-07-12,2019-07-12,6.0,-0.76,780.31,0.0,162.0,           ,1.0,1.0,153.0
5633,Vakuutukset,2019-07-15 09:02:36.521739120,2019-07-15,2019-07-15,2019-07-15,6.0,-13.11,767.2,706.0,129.0,NDEAFIHH   ,0.0,0.0,228.0
5634,Tulot,2019-07-15 11:28:41.739130425,2019-07-15,2019-07-15,2019-07-15,6.0,-9.73,757.47,706.0,129.0,OKOYFIHH   ,0.0,0.0,223.0
5635,Tulot,2019-07-16 06:36:31.304347815,2019-07-16,2019-07-16,2019-07-16,6.0,199.75,957.22,0.0,506.0,           ,1.0,1.0,206.0
5636,Matkailu,2019-07-17 04:10:26.086956510,2019-07-17,2019-07-17,2019-07-17,6.0,-33.89,923.33,0.0,162.0,           ,1.0,1.0,108.0
5637,Ravintolat_kahvilat,2019-07-18 01:44:20.869565205,2019-07-18,2019-07-18,2019-07-18,6.0,-3.27,920.06,0.0,162.0,           ,1.0,1.0,55.0
5638,Ravintolat_kahvilat,2019-07-18 23:18:15.652173900,2019-07-18,2019-07-18,2019-07-18,6.0,-5.63,914.43,0.0,162.0,           ,1.0,1.0,108.0
5639,Ravintolat_kahvilat,2019-07-19 18:26:05.217391290,2019-07-19,2019-07-19,2019-07-19,6.0,-7.3,907.13,0.0,162.0,           ,1.0,1.0,132.0
5640,Ruoka_paivittaistavarakauppa,2019-07-19 20:52:10.434782595,2019-07-19,2019-07-19,2019-07-19,6.0,-4.86,902.27,0.0,162.0,           ,1.0,1.0,160.0
5641,Tulot,2019-07-22 13:33:54.782608680,2019-07-22,2019-07-22,2019-07-22,6.0,272.96,1175.23,710.0,506.0,           ,1.0,1.0,230.0
5642,Luottojen_maksut,2019-07-22 15:59:59.999999985,2019-07-22,2019-07-22,2019-07-22,6.0,-769.08,406.15,702.0,106.0,           ,1.0,1.0,219.0
5643,Tulot,2019-07-23 08:41:44.347826070,2019-07-23,2019-07-23,2019-07-23,6.0,3.37,409.52,710.0,506.0,           ,1.0,1.0,232.0
5644,Tulot,2019-07-23 11:07:49.565217375,2019-07-23,2019-07-23,2019-07-23,6.0,131.32,540.84,710.0,506.0,           ,1.0,1.0,231.0
5645,Shoppailu,2019-07-26 03:49:33.913043460,2019-07-26,2019-07-26,2019-07-26,6.0,-39.59,501.25,0.0,162.0,           ,1.0,1.0,47.0
5646,Luokittelemattomat,2019-07-26 06:15:39.130434765,2019-07-26,2019-07-26,2019-07-23,6.0,-30.37,470.88,0.0,162.0,           ,1.0,1.0,112.0
5647,Ruoka_paivittaistavarakauppa,2019-07-26 22:57:23.478260850,2019-07-26,2019-07-26,2019-07-26,6.0,-4.23,466.65,0.0,162.0,           ,1.0,1.0,101.0
5648,Luokittelemattomat,2019-07-29 01:23:28.695652155,2019-07-29,2019-07-29,2019-07-29,6.0,-68.72,397.93,0.0,162.0,           ,1.0,1.0,162.0
5649,Asuminen,2019-07-29 20:31:18.260869545,2019-07-29,2019-07-29,2019-07-29,6.0,-19.5,378.43,0.0,162.0,           ,1.0,1.0,55.0
5650,Muut,2019-07-30 13:13:02.608695630,2019-07-30,2019-07-30,2019-07-30,6.0,-0.36,378.07,0.0,103.0,           ,0.0,1.0,2.0
5651,Ravintolat_kahvilat,2019-07-30 15:39:07.826086935,2019-07-30,2019-07-30,2019-07-30,6.0,-4.84,373.23,0.0,162.0,           ,1.0,1.0,110.0
5652,Luottojen_maksut,2019-07-30 18:05:13.043478240,2019-07-30,2019-07-30,2019-07-30,6.0,-15.83,357.4,0.0,172.0,           ,1.0,1.0,191.0
5653,Ruoka_paivittaistavarakauppa,2019-08-01 10:55:50.495049504,2019-08-01,2019-08-01,2019-08-01,6.0,-38.31,319.09,0.0,162.0,           ,1.0,1.0,148.0
5654,Ruoka_paivittaistavarakauppa,2019-08-01 14:43:57.623762376,2019-08-01,2019-08-01,2019-08-01,6.0,-21.16,297.93,0.0,162.0,           ,1.0,1.0,135.0
5655,Ruoka_paivittaistavarakauppa,2019-08-02 05:27:55.247524752,2019-08-02,2019-08-02,2019-08-02,6.0,-8.07,289.86,0.0,162.0,           ,1.0,1.0,100.0
5656,Liikkuminen,2019-08-02 20:11:52.871287128,2019-08-02,2019-08-02,2019-08-02,6.0,-4.13,285.73,0.0,162.0,           ,1.0,1.0,55.0
5657,Ravintolat_kahvilat,2019-08-05 01:39:48.118811880,2019-08-05,2019-08-05,2019-08-05,6.0,-7.89,277.84,0.0,162.0,           ,1.0,1.0,46.0
5658,Ruoka_paivittaistavarakauppa,2019-08-05 07:07:43.366336632,2019-08-05,2019-08-05,2019-08-05,6.0,-3.25,274.59,0.0,162.0,           ,1.0,1.0,113.0
5659,Saastot_sijoitukset,2019-08-05 12:35:38.613861384,2019-08-05,2019-08-05,2019-08-05,6.0,-21.91,252.68,0.0,162.0,           ,1.0,1.0,169.0
5660,Lapset,2019-08-05 16:23:45.742574256,2019-08-05,2019-08-05,2019-08-05,6.0,-16.41,236.27,0.0,162.0,           ,1.0,1.0,128.0
5661,Ruoka_paivittaistavarakauppa,2019-08-05 21:51:40.990099008,2019-08-05,2019-08-05,2019-08-05,6.0,-7.64,228.63,0.0,162.0,           ,1.0,1.0,154.0
5662,Ruoka_paivittaistavarakauppa,2019-08-06 03:19:36.237623760,2019-08-06,2019-08-06,2019-08-06,6.0,-16.24,212.39,0.0,162.0,           ,1.0,1.0,77.0
5663,Ruoka_paivittaistavarakauppa,2019-08-07 18:03:33.861386136,2019-08-07,2019-08-07,2019-08-07,6.0,-90.11,122.28,0.0,162.0,           ,1.0,1.0,143.0
5664,Ruoka_paivittaistavarakauppa,2019-08-08 08:47:31.485148512,2019-08-08,2019-08-08,2019-08-08,6.0,-15.13,107.15,0.0,162.0,           ,1.0,1.0,102.0
5665,Liikkuminen,2019-08-08 23:31:29.108910888,2019-08-08,2019-08-12,2019-08-08,6.0,-7.61,99.54,0.0,162.0,           ,1.0,1.0,164.0
5666,Ruoka_paivittaistavarakauppa,2019-08-09 04:59:24.356435640,2019-08-09,2019-08-09,2019-08-09,6.0,-7.68,91.86,0.0,162.0,           ,1.0,1.0,95.0
5667,Ruoka_paivittaistavarakauppa,2019-08-09 14:15:26.732673264,2019-08-09,2019-08-09,2019-08-09,6.0,-0.35,91.51,0.0,162.0,           ,1.0,1.0,86.0
5668,Muut,2019-08-09 19:43:21.980198016,2019-08-09,2019-08-09,2019-08-09,6.0,-17.28,74.23,0.0,162.0,           ,1.0,1.0,143.0
5669,Harrastukset,2019-08-12 01:11:17.227722768,2019-08-12,2019-08-12,2019-08-12,6.0,-21.6,52.63,0.0,162.0,           ,1.0,1.0,124.0
5670,Luokittelemattomat,2019-08-12 06:39:12.475247520,2019-08-12,2019-08-12,2019-08-12,6.0,-14.88,37.75,0.0,162.0,           ,1.0,1.0,118.0
5671,Ruoka_paivittaistavarakauppa,2019-08-12 15:55:14.851485144,2019-08-12,2019-08-12,2019-08-12,6.0,-2.57,35.18,0.0,162.0,           ,1.0,1.0,55.0
5672,Ruoka_paivittaistavarakauppa,2019-08-13 21:23:10.099009896,2019-08-13,2019-08-13,2019-08-13,6.0,-0.85,34.33,0.0,162.0,           ,1.0,1.0,149.0
5673,Ruoka_paivittaistavarakauppa,2019-08-15 02:51:05.346534648,2019-08-15,2019-08-15,2019-08-15,6.0,-3.27,31.06,0.0,162.0,           ,1.0,1.0,48.0
5674,Ruoka_paivittaistavarakauppa,2019-08-15 08:19:00.594059400,2019-08-15,2019-08-15,2019-08-15,6.0,-6.35,24.71,0.0,162.0,           ,1.0,1.0,96.0
5675,Muut,2019-08-15 10:27:19.603960392,2019-08-15,2019-08-15,2019-08-15,6.0,-1.97,22.74,0.0,103.0,           ,0.0,1.0,2.0
5676,Ruoka_paivittaistavarakauppa,2019-08-15 12:07:07.722772272,2019-08-15,2019-08-15,2019-08-15,6.0,-17.28,5.46,0.0,162.0,           ,1.0,1.0,145.0
5677,Lemmikit,2019-08-16 17:35:02.970297024,2019-08-16,2019-08-16,2019-08-16,6.0,-7.4,-1.94,0.0,162.0,           ,1.0,1.0,72.0
5678,Tulot,2019-08-18 13:46:55.841584152,2019-08-18,2019-08-18,2019-08-18,6.0,177.09,175.15,0.0,505.0,           ,1.0,1.0,202.0
5679,Ruoka_paivittaistavarakauppa,2019-08-19 04:30:53.465346528,2019-08-19,2019-08-19,2019-08-19,6.0,-18.72,156.43,0.0,162.0,           ,1.0,1.0,154.0
5680,Asuminen,2019-08-19 09:58:48.712871280,2019-08-19,2019-08-19,2019-08-19,6.0,-27.18,129.25,0.0,162.0,           ,1.0,1.0,178.0
5681,Ruoka_paivittaistavarakauppa,2019-08-19 19:14:51.089108904,2019-08-19,2019-08-19,2019-08-19,6.0,-22.57,106.68,0.0,162.0,           ,1.0,1.0,89.0
5682,Ruoka_paivittaistavarakauppa,2019-08-19 20:54:39.207920784,2019-08-19,2019-08-19,2019-08-19,6.0,-13.74,92.94,0.0,162.0,           ,1.0,1.0,143.0
5683,Ruoka_paivittaistavarakauppa,2019-08-19 23:02:58.217821776,2019-08-19,2019-08-19,2019-08-19,6.0,-6.11,86.83,0.0,162.0,           ,1.0,1.0,121.0
5684,Ruoka_paivittaistavarakauppa,2019-08-20 00:42:46.336633656,2019-08-20,2019-08-20,2019-08-20,6.0,-29.98,56.85,0.0,162.0,           ,1.0,1.0,108.0
5685,Hyvinvointijakauneus,2019-08-20 15:26:43.960396032,2019-08-20,2019-08-20,2019-08-20,6.0,-13.72,43.13,0.0,162.0,           ,1.0,1.0,96.0
5686,Liikkuminen,2019-08-21 06:10:41.584158408,2019-08-21,2019-08-21,2019-08-21,6.0,-5.01,38.12,0.0,162.0,           ,1.0,1.0,99.0
5687,Ravintolat_kahvilat,2019-08-22 02:22:34.455445536,2019-08-22,2019-08-23,2019-08-22,6.0,-6.66,31.46,0.0,162.0,           ,1.0,1.0,111.0
5688,Tulot,2019-08-22 11:38:36.831683160,2019-08-22,2019-08-22,2019-08-22,6.0,56.92,88.38,0.0,505.0,           ,1.0,1.0,199.0
5689,Tulot,2019-08-23 17:06:32.079207912,2019-08-23,2019-08-23,2019-08-23,6.0,62.33,150.71,0.0,505.0,           ,1.0,1.0,199.0
5690,Ruoka_paivittaistavarakauppa,2019-08-26 04:02:22.574257416,2019-08-26,2019-08-26,2019-08-26,6.0,-25.2,125.51,0.0,162.0,           ,1.0,1.0,165.0
5691,Muut,2019-08-26 07:50:29.702970288,2019-08-26,2019-08-26,2019-08-26,6.0,-19.94,105.57,0.0,162.0,           ,1.0,1.0,53.0
5692,Muut,2019-08-26 13:18:24.950495040,2019-08-26,2019-08-26,2019-08-26,6.0,-5.61,99.96,0.0,162.0,           ,1.0,1.0,54.0
5693,Ruoka_paivittaistavarakauppa,2019-08-26 14:58:13.069306920,2019-08-26,2019-08-26,2019-08-26,6.0,-28.04,71.92,0.0,162.0,           ,1.0,1.0,141.0
5694,Terveys,2019-08-26 18:46:20.198019792,2019-08-26,2019-08-26,2019-08-26,6.0,-12.74,59.18,0.0,162.0,           ,1.0,1.0,73.0
5695,Tulot,2019-08-26 22:34:27.326732664,2019-08-26,2019-08-26,2019-08-26,6.0,19.45,78.63,710.0,506.0,           ,1.0,1.0,230.0
5696,Ruoka_paivittaistavarakauppa,2019-08-27 00:14:15.445544544,2019-08-27,2019-08-27,2019-08-27,6.0,-4.22,74.41,0.0,162.0,           ,1.0,1.0,112.0
5697,Ruoka_paivittaistavarakauppa,2019-08-27 09:30:17.821782168,2019-08-27,2019-08-27,2019-08-27,6.0,-13.73,60.68,0.0,162.0,           ,1.0,1.0,143.0
5698,Luokittelemattomat,2019-08-29 16:38:01.188118800,2019-08-29,2019-08-29,2019-08-29,6.0,-17.71,42.97,0.0,162.0,           ,1.0,1.0,89.0
5699,Ruoka_paivittaistavarakauppa,2019-08-30 01:54:03.564356424,2019-08-30,2019-08-30,2019-08-30,6.0,-5.72,37.25,0.0,162.0,           ,1.0,1.0,104.0
5700,Tulot,2019-08-30 05:42:10.693069296,2019-08-30,2019-08-30,2019-08-30,6.0,18.02,55.27,0.0,505.0,           ,1.0,1.0,199.0
5701,Muut,2019-08-30 11:10:05.940594048,2019-08-30,2019-08-30,2019-08-30,6.0,-27.8,27.47,0.0,105.0,OKOYFIHH   ,1.0,0.0,3.0
5702,Vakuutukset,2019-08-31 20:26:08.316831672,2019-08-31,2019-08-31,2019-08-31,6.0,-9.45,18.02,0.0,106.0,OKOYFIHH   ,0.0,0.0,10.0
5703,Matkailu,2019-09-23 00:00:00.000000000,2019-09-23,2019-09-23,2019-09-23,6.0,-6.5,11.52,0.0,162.0,           ,1.0,1.0,169.0
5704,Tulot,2019-10-02 01:26:09.230769230,2019-10-02,2019-10-02,2019-10-01,6.0,16.78,28.3,0.0,505.0,           ,1.0,1.0,200.0
5705,Ruoka_paivittaistavarakauppa,2019-10-02 14:09:13.846153845,2019-10-02,2019-10-02,2019-10-02,6.0,-8.11,20.19,0.0,106.0,NDEAFIHH   ,0.0,0.0,26.0
5706,Luottojen_maksut,2019-10-03 02:52:18.461538460,2019-10-03,2019-10-03,2019-10-02,6.0,-117.27,-97.08,0.0,106.0,OKOYFIHH   ,1.0,0.0,41.0
5707,Matkailu,2019-10-03 15:35:23.076923075,2019-10-03,2019-10-03,2019-10-03,6.0,-11.16,-108.24,0.0,106.0,NDEAFIHH   ,0.0,0.0,8.0
5708,Asuminen,2019-10-04 04:18:27.692307690,2019-10-04,2019-10-04,2019-10-04,6.0,-30.57,-138.81,0.0,106.0,OKOYFIHH   ,0.0,0.0,16.0
5709,Muut,2019-10-04 05:44:36.923076920,2019-10-04,2019-10-04,2019-10-04,6.0,-7.61,-146.42,0.0,106.0,OKOYFIHH   ,0.0,0.0,38.0
5710,Luottojen_maksut,2019-10-04 12:43:04.615384615,2019-10-04,2019-10-04,2019-10-04,6.0,-0.17,-146.59,0.0,103.0,           ,0.0,1.0,1.0
5711,Ruoka_paivittaistavarakauppa,2019-10-04 17:01:32.307692305,2019-10-04,2019-10-04,2019-10-04,6.0,-8.96,-155.55,0.0,162.0,           ,1.0,1.0,48.0
5712,Matkailu,2019-10-05 18:27:41.538461535,2019-10-05,2019-10-05,2019-10-05,6.0,-35.57,-191.12,0.0,106.0,NDEAFIHH   ,0.0,0.0,16.0
5713,Liikkuminen,2019-10-07 07:10:46.153846150,2019-10-07,2019-10-07,2019-10-07,6.0,-7.73,-198.85,0.0,162.0,           ,1.0,1.0,157.0
5714,Matkailu,2019-10-07 08:36:55.384615380,2019-10-07,2019-10-08,2019-10-07,6.0,-18.67,-217.52,0.0,162.0,           ,1.0,1.0,116.0
5715,Hyvinvointi,2019-10-07 19:53:50.769230765,2019-10-07,2019-10-07,2019-10-07,6.0,-14.39,-231.91,0.0,162.0,           ,1.0,1.0,132.0
5716,Ruoka_paivittaistavarakauppa,2019-10-07 21:19:59.999999995,2019-10-07,2019-10-07,2019-10-07,6.0,-3.04,-234.95,0.0,162.0,           ,1.0,1.0,157.0
5717,Ruoka_paivittaistavarakauppa,2019-10-08 10:03:04.615384610,2019-10-08,2019-10-08,2019-10-08,6.0,-0.54,-235.49,0.0,162.0,           ,1.0,1.0,106.0
5718,Ravintolat_kahvilat,2019-10-08 22:46:09.230769225,2019-10-08,2019-10-08,2019-10-08,6.0,-2.18,-237.67,0.0,162.0,           ,1.0,1.0,128.0
5719,Ruoka_paivittaistavarakauppa,2019-10-09 00:12:18.461538455,2019-10-09,2019-10-09,2019-10-09,6.0,-6.06,-243.73,0.0,162.0,           ,1.0,1.0,82.0
5720,Ravintolat_kahvilat,2019-10-09 11:29:13.846153840,2019-10-09,2019-10-09,2019-10-09,6.0,-9.71,-253.44,0.0,162.0,           ,1.0,1.0,95.0
5721,Lemmikit,2019-10-10 12:55:23.076923070,2019-10-10,2019-10-10,2019-10-10,6.0,-3.06,-256.5,0.0,162.0,           ,1.0,1.0,47.0
5722,Ruoka_paivittaistavarakauppa,2019-10-11 01:38:27.692307685,2019-10-11,2019-10-11,2019-10-11,6.0,-15.01,-271.51,0.0,162.0,           ,1.0,1.0,47.0
5723,Ravintolat_kahvilat,2019-10-11 14:21:32.307692300,2019-10-11,2019-10-11,2019-10-11,6.0,-2.26,-273.77,0.0,162.0,           ,1.0,1.0,102.0
5724,Ruoka_paivittaistavarakauppa,2019-10-11 15:47:41.538461530,2019-10-11,2019-10-11,2019-10-11,6.0,-1.91,-275.68,0.0,162.0,           ,1.0,1.0,86.0
5725,Kulttuuri_viihde,2019-10-14 03:04:36.923076915,2019-10-14,2019-10-14,2019-10-14,6.0,-14.18,-289.86,0.0,162.0,           ,1.0,1.0,106.0
5726,Hyvinvointijakauneus,2019-10-14 04:30:46.153846145,2019-10-14,2019-10-14,2019-10-14,6.0,-10.99,-300.85,0.0,162.0,           ,1.0,1.0,69.0
5727,Tulot,2019-10-14 05:56:55.384615375,2019-10-14,2019-10-14,2019-10-14,6.0,45.26,-255.59,0.0,505.0,           ,1.0,1.0,199.0
5728,Ravintolat_kahvilat,2019-10-14 08:49:13.846153835,2019-10-14,2019-10-14,2019-10-14,6.0,-3.91,-259.5,0.0,162.0,           ,1.0,1.0,113.0
5729,Ravintolat_kahvilat,2019-10-14 17:13:50.769230760,2019-10-14,2019-10-14,2019-10-14,6.0,-10.1,-269.6,0.0,162.0,           ,1.0,1.0,136.0
5730,Ravintolat_kahvilat,2019-10-14 18:39:59.999999990,2019-10-14,2019-10-14,2019-10-14,6.0,-4.43,-274.03,0.0,162.0,           ,1.0,1.0,101.0
5731,Liikkuminen,2019-10-15 07:23:04.615384605,2019-10-15,2019-10-15,2019-10-15,6.0,-29.11,-303.14,0.0,106.0,OKOYFIHH   ,1.0,0.0,37.0
5732,Muut,2019-10-15 20:06:09.230769220,2019-10-16,2019-10-15,2019-10-15,6.0,-4.11,-307.25,0.0,103.0,           ,0.0,1.0,0.0
5733,Tulot,2019-10-16 21:32:18.461538450,2019-10-16,2019-10-16,2019-10-16,6.0,617.22,309.97,0.0,505.0,           ,1.0,1.0,200.0
5734,Muut,2019-10-16 22:58:27.692307680,2019-10-16,2019-10-16,2019-10-16,6.0,-26.73,283.24,0.0,162.0,           ,1.0,1.0,121.0
5735,Ruoka_paivittaistavarakauppa,2019-10-17 00:24:36.923076910,2019-10-17,2019-10-17,2019-10-17,6.0,-11.63,271.61,0.0,162.0,           ,1.0,1.0,95.0
5736,Luokittelemattomat,2019-10-17 10:15:23.076923065,2019-10-17,2019-10-17,2019-10-17,6.0,-8.8,262.81,0.0,106.0,OKOYFIHH   ,1.0,0.0,5.0
5737,Shoppailu,2019-10-18 11:41:32.307692295,2019-10-18,2019-10-18,2019-10-18,6.0,-7.31,255.5,0.0,162.0,           ,1.0,1.0,154.0
5738,Ravintolat_kahvilat,2019-10-18 13:07:41.538461525,2019-10-18,2019-10-18,2019-10-18,6.0,-7.62,247.88,0.0,162.0,           ,1.0,1.0,56.0
5739,Vakuutukset,2019-10-20 18:52:18.461538445,2019-10-20,2019-10-20,2019-10-20,6.0,-202.63,45.25,0.0,106.0,OKOYFIHH   ,0.0,0.0,31.0
5740,Luokittelemattomat,2019-10-21 03:16:55.384615370,2019-10-21,2019-10-21,2019-10-21,6.0,-26.02,19.23,706.0,106.0,NDEAFIHH   ,1.0,0.0,220.0
5741,Muut,2019-10-21 04:43:04.615384600,2019-10-21,2019-10-21,2019-10-23,6.0,-7.97,11.26,0.0,106.0,OKOYFIHH   ,0.0,0.0,35.0
5742,Luokittelemattomat,2019-10-21 14:33:50.769230755,2019-10-21,2019-10-21,2019-10-21,6.0,-8.64,2.62,0.0,162.0,           ,1.0,1.0,122.0
5743,Ravintolat_kahvilat,2019-10-22 01:50:46.153846140,2019-10-22,2019-10-22,2019-10-22,6.0,-4.62,-2.0,0.0,162.0,           ,1.0,1.0,164.0
5744,Shoppailu,2019-10-22 06:09:13.846153830,2019-10-22,2019-10-22,2019-10-22,6.0,239.0,237.0,0.0,508.0,OKOYFIHH   ,1.0,0.0,207.0
5745,Tulot,2019-10-22 17:26:09.230769215,2019-10-22,2019-10-22,2019-10-22,6.0,4.77,241.77,710.0,506.0,           ,1.0,1.0,237.0
5746,Tulot,2019-10-23 15:59:59.999999985,2019-10-23,2019-10-23,2019-10-23,6.0,212.87,454.64,0.0,505.0,           ,1.0,1.0,199.0
5747,Luottojen_maksut,2019-10-25 07:35:23.076923060,2019-10-25,2019-10-25,2019-10-25,6.0,-90.74,363.9,0.0,172.0,           ,1.0,1.0,192.0
5748,Matkailu,2019-10-25 09:01:32.307692290,2019-10-25,2019-10-25,2019-10-25,6.0,-26.95,336.95,0.0,106.0,DABAFIHH   ,0.0,0.0,8.0
5749,Tulot,2019-10-25 20:18:27.692307675,2019-10-25,2019-10-25,2019-10-25,6.0,615.93,952.88,0.0,505.0,           ,1.0,1.0,200.0
5750,Kulttuuri_viihde,2019-10-25 23:10:46.153846135,2019-10-25,2019-10-25,2019-10-25,6.0,-7.42,945.46,0.0,106.0,OKOYFIHH   ,0.0,0.0,40.0
5751,Liikkuminen,2019-10-27 11:53:50.769230750,2019-10-27,2019-10-30,2019-10-27,6.0,-61.95,883.51,0.0,106.0,OKOYFIHH   ,0.0,0.0,29.0
5752,Asuminen,2019-10-27 21:44:36.923076905,2019-10-27,2019-10-27,2019-10-27,6.0,-122.63,760.88,0.0,106.0,OKOYFIHH   ,0.0,0.0,22.0
5753,Luokittelemattomat,2019-10-28 00:36:55.384615365,2019-10-28,2019-10-28,2019-10-28,6.0,-33.18,727.7,0.0,106.0,OKOYFIHH   ,1.0,0.0,23.0
5754,Asuminen,2019-10-28 02:03:04.615384595,2019-10-28,2019-10-28,2019-10-28,6.0,-13.86,713.84,0.0,106.0,OKOYFIHH   ,0.0,0.0,9.0
5755,Asuminen,2019-10-28 10:27:41.538461520,2019-10-28,2019-10-28,2019-10-28,6.0,-477.12,236.72,0.0,106.0,OKOYFIHH   ,0.0,0.0,30.0
5756,Hyvinvointijakauneus,2019-10-28 13:19:59.999999980,2019-10-28,2019-10-28,2019-10-28,6.0,-106.27,130.45,0.0,106.0,OKOYFIHH   ,0.0,0.0,17.0
5757,Luokittelemattomat,2019-10-28 14:46:09.230769210,2019-10-28,2019-10-28,2019-10-28,6.0,-39.98,90.47,0.0,106.0,OKOYFIHH   ,1.0,0.0,11.0
5758,Liikkuminen,2019-10-30 04:55:23.076923055,2019-10-30,2019-10-30,2019-10-30,6.0,-261.16,-170.69,0.0,106.0,OKOYFIHH   ,0.0,0.0,25.0
5759,Vakuutukset,2019-10-30 17:38:27.692307670,2019-10-30,2019-10-30,2019-10-30,6.0,-43.8,-214.49,0.0,106.0,SBANFIHH   ,0.0,0.0,7.0
5760,Lapset,2019-10-31 03:29:13.846153825,2019-10-31,2019-10-31,2019-10-31,6.0,-46.55,-261.04,0.0,106.0,OKOYFIHH   ,0.0,0.0,38.0
5761,Luokittelemattomat,2019-10-31 16:12:18.461538440,2019-10-31,2019-10-31,2019-10-31,6.0,-48.66,-309.7,0.0,106.0,OKOYFIHH   ,1.0,0.0,37.0
5762,Hyvinvointijakauneus,2019-11-01 18:59:06.268656716,2019-11-01,2019-11-01,2019-11-01,6.0,-5.95,-315.65,0.0,162.0,           ,1.0,1.0,94.0
5763,Tulot,2019-11-04 13:58:12.537313432,2019-11-04,2019-11-04,2019-11-04,6.0,329.93,14.28,710.0,506.0,           ,1.0,1.0,235.0
5764,Ruoka_paivittaistavarakauppa,2019-11-04 16:28:39.402985074,2019-11-04,2019-11-04,2019-11-04,6.0,-1.13,13.15,0.0,162.0,           ,1.0,1.0,149.0
5765,Ruoka_paivittaistavarakauppa,2019-11-05 08:57:18.805970148,2019-11-05,2019-11-05,2019-11-05,6.0,-1.67,11.48,0.0,162.0,           ,1.0,1.0,123.0
5766,Kulttuuri_viihde,2019-11-05 11:27:45.671641790,2019-11-05,2019-11-05,2019-11-05,6.0,-18.46,-6.98,0.0,162.0,           ,1.0,1.0,65.0
5767,Matkailu,2019-11-05 21:29:33.134328358,2019-11-05,2019-11-05,2019-11-05,6.0,-0.48,-7.46,0.0,103.0,           ,0.0,1.0,2.0
5768,Lapset,2019-11-07 03:56:25.074626864,2019-11-07,2019-11-07,2019-11-07,6.0,-18.63,-26.09,0.0,162.0,           ,1.0,1.0,132.0
5769,Luokittelemattomat,2019-11-07 06:26:51.940298506,2019-11-07,2019-11-08,2019-11-07,6.0,-57.82,-83.91,0.0,106.0,OKOYFIHH   ,1.0,0.0,14.0
5770,Luokittelemattomat,2019-11-08 01:25:58.208955222,2019-11-08,2019-11-08,2019-11-08,6.0,-19.77,-103.68,0.0,162.0,           ,1.0,1.0,126.0
5771,Ruoka_paivittaistavarakauppa,2019-11-08 22:55:31.343283580,2019-11-08,2019-11-08,2019-11-08,6.0,-15.96,-119.64,0.0,162.0,           ,1.0,1.0,107.0
5772,Liikkuminen,2019-11-11 12:53:43.880597012,2019-11-11,2019-11-12,2019-11-11,6.0,-41.24,-160.88,0.0,162.0,           ,1.0,1.0,77.0
5773,Lemmikit,2019-11-11 17:54:37.611940296,2019-11-11,2019-11-11,2019-11-11,6.0,-41.95,-202.83,0.0,162.0,           ,1.0,1.0,106.0
5774,Ruoka_paivittaistavarakauppa,2019-11-11 20:25:04.477611938,2019-11-11,2019-11-11,2019-11-11,6.0,-1.45,-204.28,0.0,162.0,           ,1.0,1.0,126.0
5775,Ruoka_paivittaistavarakauppa,2019-11-12 15:24:10.746268654,2019-11-12,2019-11-12,2019-11-12,6.0,-4.84,-209.12,0.0,162.0,           ,1.0,1.0,130.0
5776,Luottojen_maksut,2019-11-14 10:23:17.014925370,2019-11-14,2019-11-14,2019-11-14,6.0,-56.34,-265.46,0.0,162.0,           ,1.0,1.0,162.0
5777,Ruoka_paivittaistavarakauppa,2019-11-15 05:22:23.283582086,2019-11-15,2019-11-15,2019-11-15,6.0,-3.06,-268.52,0.0,162.0,           ,1.0,1.0,142.0
5778,Lemmikit,2019-11-15 07:52:50.149253728,2019-11-15,2019-11-15,2019-11-15,6.0,-2.4,-270.92,0.0,162.0,           ,1.0,1.0,161.0
5779,Muut,2019-11-18 00:21:29.552238802,2019-11-18,2019-11-18,2019-11-18,6.0,-1.48,-272.4,0.0,162.0,           ,1.0,1.0,129.0
5780,Ruoka_paivittaistavarakauppa,2019-11-18 21:51:02.686567160,2019-11-18,2019-11-18,2019-11-18,6.0,-12.15,-284.55,0.0,162.0,           ,1.0,1.0,47.0
5781,Ravintolat_kahvilat,2019-11-19 02:51:56.417910444,2019-11-19,2019-11-19,2019-11-19,6.0,-15.54,-300.09,0.0,162.0,           ,1.0,1.0,58.0
5782,Luottojen_maksut,2019-11-19 16:50:08.955223876,2019-11-19,2019-11-19,2019-11-19,6.0,-6.16,-306.25,0.0,162.0,           ,1.0,1.0,63.0
5783,Ravintolat_kahvilat,2019-11-19 19:20:35.820895518,2019-11-19,2019-11-19,2019-11-19,6.0,-9.32,-315.57,0.0,162.0,           ,1.0,1.0,112.0
5784,Matkailu,2019-11-21 11:49:15.223880592,2019-11-21,2019-11-21,2019-11-21,6.0,-58.91,-374.48,0.0,106.0,OKOYFIHH   ,0.0,0.0,31.0
5785,Liikkuminen,2019-11-22 14:19:42.089552234,2019-11-22,2019-11-22,2019-11-22,6.0,-11.0,-385.48,0.0,106.0,OKOYFIHH   ,1.0,0.0,10.0
5786,Muut,2019-11-24 09:18:48.358208950,2019-11-24,2019-11-24,2019-11-24,6.0,-13.12,-398.6,0.0,106.0,NDEAFIHH   ,0.0,0.0,38.0
5787,Liikkuminen,2019-11-25 04:17:54.626865666,2019-11-25,2019-11-25,2019-11-25,6.0,-8.56,-407.16,0.0,106.0,OKOYFIHH   ,1.0,0.0,23.0
5788,Lapset,2019-11-25 06:48:21.492537308,2019-11-25,2019-11-25,2019-11-25,6.0,-6.8,-413.96,0.0,106.0,OKOYFIHH   ,0.0,0.0,31.0
5789,Matkailu,2019-11-26 23:17:00.895522382,2019-11-26,2019-11-26,2019-11-26,6.0,-6.72,-420.68,0.0,106.0,DABAFIHH   ,0.0,0.0,4.0
5790,Asuminen,2019-11-27 01:47:27.761194024,2019-11-27,2019-11-27,2019-11-27,6.0,-43.6,-464.28,0.0,106.0,OKOYFIHH   ,0.0,0.0,11.0
5791,Ruoka_paivittaistavarakauppa,2019-11-27 13:15:13.432835814,2019-11-27,2019-11-27,2019-11-27,6.0,-4.55,-468.83,0.0,162.0,           ,1.0,1.0,46.0
5792,Ruoka_paivittaistavarakauppa,2019-11-27 20:46:34.029850740,2019-11-27,2019-11-27,2019-11-27,6.0,-5.77,-474.6,0.0,162.0,           ,1.0,1.0,151.0
5793,Asuminen,2019-11-28 18:16:07.164179098,2019-11-28,2019-11-28,2019-11-28,6.0,-29.69,-504.29,0.0,106.0,OKOYFIHH   ,0.0,0.0,26.0
5794,Kulttuuri_viihde,2019-11-29 15:45:40.298507456,2019-11-29,2019-11-29,2019-11-29,6.0,-11.0,-515.29,0.0,106.0,OKOYFIHH   ,0.0,0.0,35.0
5795,Tulot,2019-12-02 02:43:49.940119758,2019-12-02,2019-12-02,2019-12-02,6.0,253.59,-261.7,710.0,506.0,           ,1.0,1.0,230.0
5796,Tulot,2019-12-02 08:54:36.646706586,2019-12-02,2019-12-02,2019-12-02,6.0,12.55,-249.15,710.0,506.0,           ,1.0,1.0,230.0
5797,Matkailu,2019-12-02 11:38:26.586826344,2019-12-02,2019-12-02,2019-12-02,6.0,-35.7,-284.85,0.0,106.0,NDEAFIHH   ,0.0,0.0,10.0
5798,Ruoka_paivittaistavarakauppa,2019-12-02 17:49:13.293413172,2019-12-02,2019-12-02,2019-12-02,6.0,-6.11,-290.96,0.0,162.0,           ,1.0,1.0,156.0
5799,Matkailu,2019-12-02 20:33:03.233532930,2019-12-02,2019-12-02,2019-12-02,6.0,-11.55,-302.51,0.0,106.0,OKOYFIHH   ,0.0,0.0,5.0
5800,Hyvinvointijakauneus,2019-12-03 05:27:39.880239516,2019-12-03,2019-12-03,2019-12-03,6.0,-72.28,-374.79,0.0,129.0,OKOYFIHH   ,0.0,0.0,42.0
5801,Ruoka_paivittaistavarakauppa,2019-12-03 14:22:16.526946102,2019-12-03,2019-12-03,2019-12-03,6.0,-12.27,-387.06,0.0,162.0,           ,1.0,1.0,181.0
5802,Muut,2019-12-03 23:16:53.173652688,2019-12-03,2019-12-03,2019-12-03,6.0,-0.85,-387.91,0.0,162.0,           ,1.0,1.0,123.0
5803,Ruoka_paivittaistavarakauppa,2019-12-04 02:00:43.113772446,2019-12-04,2019-12-04,2019-12-04,6.0,-5.75,-393.66,0.0,162.0,           ,1.0,1.0,86.0
5804,Liikkuminen,2019-12-04 08:11:29.820359274,2019-12-04,2019-12-04,2019-12-04,6.0,-10.61,-404.27,0.0,106.0,OKOYFIHH   ,0.0,0.0,20.0
5805,Ruoka_paivittaistavarakauppa,2019-12-04 17:06:06.467065860,2019-12-04,2019-12-04,2019-12-04,6.0,-2.45,-406.72,0.0,162.0,           ,1.0,1.0,94.0
5806,Luottojen_maksut,2019-12-05 13:39:09.700598790,2019-12-05,2019-12-05,2019-12-05,6.0,-26.9,-433.62,0.0,162.0,           ,1.0,1.0,156.0
5807,Saastot_sijoitukset,2019-12-05 19:49:56.407185618,2019-12-05,2019-12-05,2019-12-05,6.0,-13.95,-447.57,0.0,162.0,           ,1.0,1.0,55.0
5808,Lapset,2019-12-06 04:44:33.053892204,2019-12-06,2019-12-06,2019-12-06,6.0,-10.96,-458.53,0.0,162.0,           ,1.0,1.0,130.0
5809,Ruoka_paivittaistavarakauppa,2019-12-06 07:28:22.994011962,2019-12-06,2019-12-06,2019-12-06,6.0,-2.53,-461.06,0.0,162.0,           ,1.0,1.0,136.0
5810,Liikkuminen,2019-12-06 10:55:19.760479032,2019-12-06,2019-12-06,2019-12-06,6.0,-7.25,-468.31,0.0,162.0,           ,1.0,1.0,154.0
5811,Ravintolat_kahvilat,2019-12-06 16:22:59.640718548,2019-12-06,2019-12-06,2019-12-06,6.0,-6.11,-474.42,0.0,162.0,           ,1.0,1.0,102.0
5812,Ravintolat_kahvilat,2019-12-06 21:50:39.520958064,2019-12-06,2019-12-06,2019-12-06,6.0,-3.28,-477.7,0.0,103.0,           ,0.0,1.0,0.0
5813,Ruoka_paivittaistavarakauppa,2019-12-06 22:33:46.347305376,2019-12-06,2019-12-06,2019-12-06,6.0,-94.05,-571.75,0.0,162.0,           ,1.0,1.0,164.0
5814,Ruoka_paivittaistavarakauppa,2019-12-09 01:17:36.287425134,2019-12-09,2019-12-09,2019-12-09,6.0,-16.13,-587.88,0.0,162.0,           ,1.0,1.0,123.0
5815,Liikkuminen,2019-12-09 04:01:26.227544892,2019-12-09,2019-12-09,2019-12-09,6.0,-2.08,-589.96,0.0,162.0,           ,1.0,1.0,116.0
5816,Liikkuminen,2019-12-09 10:12:12.934131720,2019-12-09,2019-12-09,2019-12-09,6.0,-2.71,-592.67,0.0,162.0,           ,1.0,1.0,48.0
5817,Muut,2019-12-09 19:06:49.580838306,2019-12-09,2019-12-09,2019-12-09,6.0,-14.15,-606.82,0.0,106.0,NDEAFIHH   ,0.0,0.0,37.0
5818,Terveys,2019-12-10 06:45:16.167664650,2019-12-10,2019-12-10,2019-12-10,6.0,-6.14,-612.96,0.0,162.0,           ,1.0,1.0,77.0
5819,Tulot,2019-12-10 12:56:02.874251478,2019-12-10,2019-12-10,2019-12-10,6.0,1159.27,546.31,701.0,506.0,           ,1.0,1.0,210.0
5820,Asuminen,2019-12-10 15:39:52.814371236,2019-12-10,2019-12-10,2019-12-10,6.0,-34.0,512.31,0.0,162.0,           ,1.0,1.0,63.0
5821,Ruoka_paivittaistavarakauppa,2019-12-11 18:23:42.754490994,2019-12-11,2019-12-11,2019-12-11,6.0,-3.35,508.96,0.0,162.0,           ,1.0,1.0,130.0
5822,Ruoka_paivittaistavarakauppa,2019-12-12 03:18:19.401197580,2019-12-12,2019-12-12,2019-12-12,6.0,-47.52,461.44,0.0,162.0,           ,1.0,1.0,163.0
5823,Liikkuminen,2019-12-12 09:29:06.107784408,2019-12-12,2019-12-12,2019-12-12,6.0,-37.25,424.19,0.0,162.0,           ,1.0,1.0,128.0
5824,Ravintolat_kahvilat,2019-12-12 12:12:56.047904166,2019-12-12,2019-12-12,2019-12-12,6.0,-2.3,421.89,0.0,162.0,           ,1.0,1.0,83.0
5825,Luokittelemattomat,2019-12-12 21:07:32.694610752,2019-12-12,2019-12-12,2019-12-12,6.0,-17.56,404.33,0.0,162.0,           ,1.0,1.0,136.0
5826,Luottojen_maksut,2019-12-13 00:34:29.461077822,2019-12-13,2019-12-13,2019-12-13,6.0,-3.68,400.65,0.0,162.0,           ,1.0,1.0,94.0
5827,Asuminen,2019-12-13 14:56:45.988023924,2019-12-13,2019-12-13,2019-12-13,6.0,-25.68,374.97,0.0,162.0,           ,1.0,1.0,151.0
5828,Luokittelemattomat,2019-12-13 23:51:22.634730510,2019-12-13,2019-12-13,2019-12-13,6.0,-33.36,341.61,0.0,106.0,ITELFIHH   ,1.0,0.0,35.0
5829,Hyvinvointijakauneus,2019-12-14 08:45:59.281437096,2019-12-14,2019-12-14,2019-12-14,6.0,-4.78,336.83,0.0,106.0,OKOYFIHH   ,0.0,0.0,12.0
5830,Luokittelemattomat,2019-12-14 17:40:35.928143682,2019-12-14,2019-12-14,2019-12-14,6.0,-65.18,271.65,0.0,106.0,OKOYFIHH   ,1.0,0.0,31.0
5831,Luokittelemattomat,2019-12-15 11:29:49.221556854,2019-12-15,2019-12-15,2019-12-15,6.0,-37.39,234.26,0.0,106.0,NDEAFIHH   ,1.0,0.0,4.0
5832,Luokittelemattomat,2019-12-15 20:24:25.868263440,2019-12-15,2019-12-15,2019-12-15,6.0,-248.21,-13.95,0.0,106.0,SBANFIHH   ,1.0,0.0,17.0
5833,Liikkuminen,2019-12-16 02:35:12.574850268,2019-12-16,2019-12-16,2019-12-16,6.0,-9.87,-23.82,0.0,106.0,OKOYFIHH   ,1.0,0.0,5.0
5834,Luokittelemattomat,2019-12-16 05:19:02.514970026,2019-12-16,2019-12-16,2019-12-16,6.0,-4.56,-28.38,0.0,106.0,OKOYFIHH   ,0.0,0.0,40.0
5835,Matkailu,2019-12-16 06:02:09.341317338,2019-12-16,2019-12-16,2019-12-16,6.0,-0.11,-28.49,0.0,103.0,           ,0.0,1.0,0.0
5836,Liikkuminen,2019-12-16 14:13:39.161676612,2019-12-16,2019-12-17,2019-12-16,6.0,-16.85,-45.34,0.0,106.0,OKOYFIHH   ,0.0,0.0,23.0
5837,Luottojen_maksut,2019-12-16 23:08:15.808383198,2019-12-16,2019-12-16,2019-12-16,6.0,-7.07,-52.41,0.0,106.0,SBANFIHH   ,1.0,0.0,13.0
5838,Lemmikit,2019-12-17 08:02:52.455089784,2019-12-17,2019-12-17,2019-12-17,6.0,-12.0,-64.41,0.0,106.0,OKOYFIHH   ,0.0,0.0,37.0
5839,Ruoka_paivittaistavarakauppa,2019-12-18 01:52:05.748502956,2019-12-18,2019-12-18,2019-12-18,6.0,-8.09,-72.5,0.0,162.0,           ,1.0,1.0,116.0
5840,Ruoka_paivittaistavarakauppa,2019-12-18 10:46:42.395209542,2019-12-18,2019-12-18,2019-12-18,6.0,-3.26,-75.76,0.0,162.0,           ,1.0,1.0,183.0
5841,Ruoka_paivittaistavarakauppa,2019-12-18 16:57:29.101796370,2019-12-18,2019-12-18,2019-12-18,6.0,-2.27,-78.03,0.0,162.0,           ,1.0,1.0,143.0
5842,Ruoka_paivittaistavarakauppa,2019-12-18 19:41:19.041916128,2019-12-18,2019-12-18,2019-12-18,6.0,-4.89,-82.92,0.0,162.0,           ,1.0,1.0,148.0
5843,Vakuutukset,2019-12-19 04:35:55.688622714,2019-12-19,2019-12-19,2019-12-19,6.0,-13.66,-96.58,0.0,106.0,SBANFIHH   ,0.0,0.0,11.0
5844,Ravintolat_kahvilat,2019-12-19 13:30:32.335329300,2019-12-19,2019-12-19,2019-12-19,6.0,-6.08,-102.66,0.0,162.0,           ,1.0,1.0,157.0
5845,Ruoka_paivittaistavarakauppa,2019-12-19 22:25:08.982035886,2019-12-19,2019-12-19,2019-12-19,6.0,-12.54,-115.2,0.0,162.0,           ,1.0,1.0,110.0
5846,Ruoka_paivittaistavarakauppa,2019-12-20 07:19:45.628742472,2019-12-20,2019-12-20,2019-12-20,6.0,-1.79,-116.99,0.0,162.0,           ,1.0,1.0,119.0
5847,Liikkuminen,2019-12-20 10:03:35.568862230,2019-12-20,2019-12-20,2019-12-20,6.0,-5.87,-122.86,0.0,162.0,           ,1.0,1.0,55.0
5848,Lemmikit,2019-12-20 16:14:22.275449058,2019-12-20,2019-12-20,2019-12-20,6.0,-1.35,-124.21,0.0,162.0,           ,1.0,1.0,82.0
5849,Ruoka_paivittaistavarakauppa,2019-12-20 18:58:12.215568816,2019-12-20,2019-12-20,2019-12-20,6.0,-4.62,-128.83,0.0,162.0,           ,1.0,1.0,173.0
5850,Ravintolat_kahvilat,2019-12-23 00:25:52.095808332,2019-12-23,2019-12-23,2019-12-23,6.0,-4.7,-133.53,0.0,162.0,           ,1.0,1.0,180.0
5851,Lemmikit,2019-12-23 01:08:58.922155644,2019-12-23,2019-12-24,2019-12-23,6.0,-5.44,-138.97,0.0,162.0,           ,1.0,1.0,120.0
5852,Ruoka_paivittaistavarakauppa,2019-12-23 03:52:48.862275402,2019-12-23,2019-12-23,2019-12-23,6.0,-3.71,-142.68,0.0,162.0,           ,1.0,1.0,144.0
5853,Ruoka_paivittaistavarakauppa,2019-12-23 06:36:38.802395160,2019-12-23,2019-12-23,2019-12-23,6.0,-22.73,-165.41,0.0,162.0,           ,1.0,1.0,119.0
5854,Kulttuuri_viihde,2019-12-23 09:20:28.742514918,2019-12-23,2019-12-23,2019-12-23,6.0,-15.17,-180.58,0.0,162.0,           ,1.0,1.0,90.0
5855,Ruoka_paivittaistavarakauppa,2019-12-23 12:47:25.508981988,2019-12-23,2019-12-23,2019-12-23,6.0,-0.93,-181.51,0.0,162.0,           ,1.0,1.0,115.0
5856,Hyvinvointijakauneus,2019-12-23 15:31:15.449101746,2019-12-23,2019-12-23,2019-12-23,6.0,-7.47,-188.98,0.0,106.0,OKOYFIHH   ,0.0,0.0,40.0
5857,Luokittelemattomat,2019-12-23 21:42:02.155688574,2019-12-23,2019-12-23,2019-12-23,6.0,-2.08,-191.06,0.0,162.0,           ,1.0,1.0,46.0
5858,Luokittelemattomat,2019-12-25 03:09:42.035928090,2019-12-25,2019-12-25,2019-12-25,6.0,-4.24,-195.3,0.0,162.0,           ,1.0,1.0,156.0
5859,Ruoka_paivittaistavarakauppa,2019-12-25 12:04:18.682634676,2019-12-25,2019-12-27,2019-12-25,6.0,-9.63,-204.93,0.0,162.0,           ,1.0,1.0,70.0
5860,Saastot_sijoitukset,2019-12-25 14:48:08.622754434,2019-12-25,2019-12-25,2019-12-25,6.0,-1.45,-206.38,0.0,162.0,           ,1.0,1.0,156.0
5861,Ruoka_paivittaistavarakauppa,2019-12-25 18:15:05.389221504,2019-12-25,2019-12-25,2019-12-25,6.0,-12.33,-218.71,0.0,162.0,           ,1.0,1.0,55.0
5862,Matkailu,2019-12-26 20:58:55.329341262,2019-12-26,2019-12-26,2019-12-26,6.0,-12.14,-230.85,0.0,162.0,           ,1.0,1.0,157.0
5863,Ruoka_paivittaistavarakauppa,2019-12-27 02:26:35.209580778,2019-12-27,2019-12-27,2019-12-27,6.0,-1.79,-232.64,0.0,162.0,           ,1.0,1.0,110.0
5864,Ruoka_paivittaistavarakauppa,2019-12-27 05:53:31.976047848,2019-12-27,2019-12-27,2019-12-27,6.0,-4.78,-237.42,0.0,162.0,           ,1.0,1.0,124.0
5865,Ruoka_paivittaistavarakauppa,2019-12-27 08:37:21.916167606,2019-12-27,2019-12-27,2019-12-27,6.0,-7.03,-244.45,0.0,162.0,           ,1.0,1.0,63.0
5866,Lapset,2019-12-27 11:21:11.856287364,2019-12-27,2019-12-27,2019-12-27,6.0,-12.98,-257.43,0.0,162.0,           ,1.0,1.0,63.0
5867,Ruoka_paivittaistavarakauppa,2019-12-27 17:31:58.562874192,2019-12-27,2019-12-27,2019-12-27,6.0,-5.66,-263.09,0.0,162.0,           ,1.0,1.0,103.0
5868,Ruoka_paivittaistavarakauppa,2019-12-27 22:59:38.443113708,2019-12-27,2019-12-27,2019-12-27,6.0,-9.35,-272.44,0.0,162.0,           ,1.0,1.0,47.0
5869,Ruoka_paivittaistavarakauppa,2019-12-27 23:42:45.269461020,2019-12-27,2019-12-27,2019-12-27,6.0,-10.49,-282.93,0.0,162.0,           ,1.0,1.0,47.0
5870,Ruoka_paivittaistavarakauppa,2019-12-30 01:43:28.383233466,2019-12-30,2020-01-01,2019-12-30,6.0,-0.58,-283.51,0.0,162.0,           ,1.0,1.0,137.0
5871,Ruoka_paivittaistavarakauppa,2019-12-30 05:10:25.149700536,2019-12-30,2019-12-30,2019-12-30,6.0,-2.28,-285.79,0.0,162.0,           ,1.0,1.0,154.0
5872,Ravintolat_kahvilat,2019-12-30 07:54:15.089820294,2019-12-30,2019-12-30,2019-12-30,6.0,-2.57,-288.36,0.0,162.0,           ,1.0,1.0,94.0
5873,Ruoka_paivittaistavarakauppa,2019-12-30 10:38:05.029940052,2019-12-30,2019-12-30,2019-12-30,6.0,-3.12,-291.48,0.0,162.0,           ,1.0,1.0,143.0
5874,Asuminen,2019-12-30 14:05:01.796407122,2019-12-30,2019-12-30,2019-12-30,6.0,-0.98,-292.46,0.0,162.0,           ,1.0,1.0,132.0
5875,Lapset,2019-12-30 16:48:51.736526880,2019-12-30,2019-12-30,2019-12-30,6.0,-21.04,-313.5,0.0,106.0,OKOYFIHH   ,0.0,0.0,5.0
5876,Ruoka_paivittaistavarakauppa,2019-12-30 20:15:48.502993950,2019-12-30,2019-12-30,2019-12-30,6.0,-1.26,-314.76,0.0,162.0,           ,1.0,1.0,110.0
5877,Ruoka_paivittaistavarakauppa,2019-12-31 19:32:41.676646638,2019-12-31,2019-12-31,2019-12-31,6.0,-3.39,-318.15,0.0,162.0,           ,1.0,1.0,82.0
5878,Kulttuuri_viihde,2020-01-01 18:22:13.333333333,2020-01-01,2020-01-03,2020-01-01,6.0,-8.84,-326.99,0.0,106.0,OKOYFIHH   ,0.0,0.0,4.0
5879,Ravintolat_kahvilat,2020-01-02 12:44:26.666666666,2020-01-02,2020-01-02,2020-01-02,6.0,-5.24,-332.23,0.0,162.0,           ,1.0,1.0,47.0
5880,Liikkuminen,2020-01-03 07:06:39.999999999,2020-01-03,2020-01-03,2020-01-03,6.0,-9.83,-342.06,0.0,162.0,           ,1.0,1.0,46.0
5881,Ruoka_paivittaistavarakauppa,2020-01-03 19:51:06.666666665,2020-01-03,2020-01-03,2020-01-03,6.0,-4.59,-346.65,0.0,162.0,           ,1.0,1.0,154.0
5882,Luokittelemattomat,2020-01-06 01:28:53.333333332,2020-01-06,2020-01-06,2020-01-06,6.0,-2.98,-349.63,0.0,162.0,           ,1.0,1.0,115.0
5883,Ruoka_paivittaistavarakauppa,2020-01-06 08:35:33.333333331,2020-01-06,2020-01-06,2020-01-06,6.0,-12.42,-362.05,0.0,162.0,           ,1.0,1.0,113.0
5884,Ruoka_paivittaistavarakauppa,2020-01-06 14:13:19.999999998,2020-01-06,2020-01-06,2020-01-06,6.0,-9.73,-371.78,0.0,162.0,           ,1.0,1.0,154.0
5885,Ravintolat_kahvilat,2020-01-07 02:57:46.666666664,2020-01-07,2020-01-07,2020-01-07,6.0,-2.0,-373.78,0.0,162.0,           ,1.0,1.0,69.0
5886,Tulot,2020-01-07 21:19:59.999999997,2020-01-07,2020-01-07,2020-01-07,6.0,-12.79,-386.57,0.0,106.0,NDEAFIHH   ,0.0,0.0,32.0
5887,Ruoka_paivittaistavarakauppa,2020-01-09 04:26:39.999999996,2020-01-09,2020-01-09,2020-01-09,6.0,-2.08,-388.65,0.0,162.0,           ,1.0,1.0,94.0
5888,Ruoka_paivittaistavarakauppa,2020-01-09 10:04:26.666666663,2020-01-09,2020-01-09,2020-01-09,6.0,-21.62,-410.27,0.0,162.0,           ,1.0,1.0,99.0
5889,Terveys,2020-01-09 15:42:13.333333330,2020-01-09,2020-01-09,2020-01-09,6.0,-0.95,-411.22,0.0,162.0,           ,1.0,1.0,102.0
5890,Tulot,2020-01-09 22:48:53.333333329,2020-01-09,2020-01-09,2020-01-09,6.0,1080.74,669.52,701.0,524.0,           ,1.0,1.0,218.0
5891,Liikkuminen,2020-01-12 11:33:19.999999995,2020-01-12,2020-01-12,2020-01-12,6.0,-211.83,457.69,0.0,106.0,OKOYFIHH   ,1.0,0.0,11.0
5892,Luokittelemattomat,2020-01-13 05:55:33.333333328,2020-01-13,2020-01-13,2020-01-13,6.0,-52.73,404.96,0.0,106.0,OKOYFIHH   ,1.0,0.0,12.0
5893,Hyvinvointi,2020-01-13 17:11:06.666666662,2020-01-13,2020-01-13,2020-01-13,6.0,-33.75,371.21,0.0,162.0,           ,1.0,1.0,124.0
5894,Ruoka_paivittaistavarakauppa,2020-01-14 00:17:46.666666661,2020-01-14,2020-01-14,2020-01-14,6.0,-46.05,325.16,0.0,106.0,OKOYFIHH   ,0.0,0.0,23.0
5895,Harrastukset,2020-01-14 18:39:59.999999994,2020-01-14,2020-01-14,2020-01-14,6.0,-40.36,284.8,0.0,106.0,OKOYFIHH   ,0.0,0.0,22.0
5896,Asuminen,2020-01-15 13:02:13.333333327,2020-01-15,2020-01-15,2020-01-15,6.0,-105.28,179.52,706.0,129.0,NDEAFIHH   ,0.0,0.0,227.0
5897,Ruoka_paivittaistavarakauppa,2020-01-15 20:08:53.333333326,2020-01-15,2020-01-15,2020-01-15,6.0,-5.76,173.76,0.0,162.0,           ,1.0,1.0,140.0
5898,Muut,2020-01-17 01:46:39.999999993,2020-01-17,2020-01-17,2020-01-17,6.0,-7.66,166.1,0.0,162.0,           ,1.0,1.0,95.0
5899,Ruoka_paivittaistavarakauppa,2020-01-17 07:24:26.666666660,2020-01-17,2020-01-17,2020-01-17,6.0,-67.45,98.65,0.0,162.0,           ,1.0,1.0,123.0
5900,Tulot,2020-01-17 14:31:06.666666659,2020-01-17,2020-01-17,2020-01-17,6.0,-39.13,59.52,0.0,162.0,           ,1.0,1.0,111.0
5901,Ravintolat_kahvilat,2020-01-20 03:15:33.333333325,2020-01-20,2020-01-20,2020-01-20,6.0,-1.55,57.97,0.0,162.0,           ,1.0,1.0,121.0
5902,Ruoka_paivittaistavarakauppa,2020-01-20 08:53:19.999999992,2020-01-20,2020-01-21,2020-01-20,6.0,-23.03,34.94,0.0,162.0,           ,1.0,1.0,95.0
5903,Ruoka_paivittaistavarakauppa,2020-01-20 21:37:46.666666658,2020-01-20,2020-01-20,2020-01-20,6.0,-17.07,17.87,0.0,162.0,           ,1.0,1.0,159.0
5904,Ruoka_paivittaistavarakauppa,2020-01-21 10:22:13.333333324,2020-01-21,2020-01-21,2020-01-21,6.0,-1.01,16.86,0.0,162.0,           ,1.0,1.0,70.0
5905,Lemmikit,2020-01-21 15:59:59.999999991,2020-01-21,2020-01-21,2020-01-21,6.0,-3.85,13.01,0.0,162.0,           ,1.0,1.0,173.0
5906,Ruoka_paivittaistavarakauppa,2020-01-22 23:06:39.999999990,2020-01-22,2020-01-22,2020-01-22,6.0,-9.55,3.46,0.0,162.0,           ,1.0,1.0,170.0
5907,Ruoka_paivittaistavarakauppa,2020-01-23 04:44:26.666666657,2020-01-23,2020-01-23,2020-01-23,6.0,-2.57,0.89,0.0,162.0,           ,1.0,1.0,134.0
5908,Ruoka_paivittaistavarakauppa,2020-01-23 11:51:06.666666656,2020-01-23,2020-01-23,2020-01-23,6.0,-4.92,-4.03,0.0,162.0,           ,1.0,1.0,128.0
5909,Ruoka_paivittaistavarakauppa,2020-01-24 17:28:53.333333323,2020-01-24,2020-01-24,2020-01-24,6.0,-4.7,-8.73,0.0,162.0,           ,1.0,1.0,108.0
5910,Ruoka_paivittaistavarakauppa,2020-01-27 00:35:33.333333322,2020-01-27,2020-01-27,2020-01-27,6.0,-1.16,-9.89,0.0,162.0,           ,1.0,1.0,112.0
5911,Ruoka_paivittaistavarakauppa,2020-01-27 06:13:19.999999989,2020-01-27,2020-01-27,2020-01-27,6.0,-3.17,-13.06,0.0,162.0,           ,1.0,1.0,46.0
5912,Ruoka_paivittaistavarakauppa,2020-01-27 13:19:59.999999988,2020-01-27,2020-01-27,2020-01-27,6.0,-1.07,-14.13,0.0,162.0,           ,1.0,1.0,63.0
5913,Ruoka_paivittaistavarakauppa,2020-01-27 18:57:46.666666655,2020-01-27,2020-01-27,2020-01-27,6.0,-4.5,-18.63,0.0,162.0,           ,1.0,1.0,118.0
5914,Ruoka_paivittaistavarakauppa,2020-01-28 20:26:39.999999987,2020-01-28,2020-01-28,2020-01-28,6.0,-8.28,-26.91,0.0,162.0,           ,1.0,1.0,47.0
5915,Liikkuminen,2020-01-29 07:42:13.333333321,2020-01-29,2020-01-29,2020-01-29,6.0,-33.7,-60.61,0.0,162.0,           ,1.0,1.0,89.0
5916,Lemmikit,2020-01-30 02:04:26.666666654,2020-01-30,2020-01-30,2020-01-30,6.0,-3.82,-64.43,0.0,162.0,           ,1.0,1.0,139.0
5917,Ravintolat_kahvilat,2020-01-31 14:48:53.333333320,2020-01-31,2020-01-31,2020-01-31,6.0,-8.03,-72.46,0.0,162.0,           ,1.0,1.0,97.0
5918,Ruoka_paivittaistavarakauppa,2020-02-03 06:35:36.263736262,2020-02-03,2020-02-03,2020-02-03,6.0,-5.11,-77.57,0.0,162.0,           ,1.0,1.0,121.0
5919,Shoppailu,2020-02-03 13:11:12.527472524,2020-02-03,2020-02-03,2020-02-03,6.0,-34.64,-112.21,0.0,162.0,           ,1.0,1.0,89.0
5920,Ravintolat_kahvilat,2020-02-03 15:17:48.131868131,2020-02-03,2020-02-03,2020-02-03,6.0,-4.48,-116.69,0.0,162.0,           ,1.0,1.0,122.0
5921,Muut,2020-02-03 21:53:24.395604393,2020-02-03,2020-02-03,2020-02-03,6.0,-1.41,-118.1,0.0,162.0,           ,1.0,1.0,72.0
5922,Ruoka_paivittaistavarakauppa,2020-02-04 04:29:00.659340655,2020-02-04,2020-02-04,2020-02-04,6.0,-3.66,-121.76,0.0,162.0,           ,1.0,1.0,152.0
5923,Ruoka_paivittaistavarakauppa,2020-02-04 19:46:48.791208786,2020-02-04,2020-02-04,2020-02-04,6.0,-2.62,-124.38,0.0,162.0,           ,1.0,1.0,177.0
5924,Terveys,2020-02-05 11:04:36.923076917,2020-02-05,2020-02-05,2020-02-05,6.0,-6.53,-130.91,0.0,106.0,OKOYFIHH   ,0.0,0.0,40.0
5925,Lapset,2020-02-05 17:40:13.186813179,2020-02-05,2020-02-07,2020-02-05,6.0,-17.62,-148.53,0.0,162.0,           ,1.0,1.0,110.0
5926,Ruoka_paivittaistavarakauppa,2020-02-07 02:22:25.054945048,2020-02-07,2020-02-07,2020-02-07,6.0,-1.38,-149.91,0.0,162.0,           ,1.0,1.0,48.0
5927,Ruoka_paivittaistavarakauppa,2020-02-07 08:58:01.318681310,2020-02-07,2020-02-07,2020-02-06,6.0,-1.51,-151.42,0.0,162.0,           ,1.0,1.0,107.0
5928,Ravintolat_kahvilat,2020-02-07 15:33:37.582417572,2020-02-07,2020-02-07,2020-02-07,6.0,-2.66,-154.08,0.0,162.0,           ,1.0,1.0,129.0
5929,Kulttuuri_viihde,2020-02-10 00:15:49.450549441,2020-02-10,2020-02-10,2020-02-10,6.0,-2.11,-156.19,0.0,162.0,           ,1.0,1.0,108.0
5930,Ruoka_paivittaistavarakauppa,2020-02-10 06:51:25.714285703,2020-02-10,2020-02-10,2020-02-10,6.0,-5.9,-162.09,0.0,162.0,           ,1.0,1.0,113.0
5931,Ruoka_paivittaistavarakauppa,2020-02-10 13:27:01.978021965,2020-02-10,2020-02-10,2020-02-10,6.0,-14.83,-176.92,0.0,162.0,           ,1.0,1.0,136.0
5932,Ruoka_paivittaistavarakauppa,2020-02-10 22:09:13.846153834,2020-02-10,2020-02-12,2020-02-10,6.0,-0.85,-177.77,0.0,162.0,           ,1.0,1.0,122.0
5933,Saastot_sijoitukset,2020-02-11 04:44:50.109890096,2020-02-11,2020-02-11,2020-02-11,6.0,-22.55,-200.32,0.0,162.0,           ,1.0,1.0,153.0
5934,Ruoka_paivittaistavarakauppa,2020-02-11 20:02:38.241758227,2020-02-11,2020-02-11,2020-02-11,6.0,-3.68,-204.0,0.0,162.0,           ,1.0,1.0,173.0
5935,Hyvinvointijakauneus,2020-02-13 02:38:14.505494489,2020-02-13,2020-02-13,2020-02-13,6.0,-3.55,-207.55,0.0,162.0,           ,1.0,1.0,69.0
5936,Muut,2020-02-13 11:20:26.373626358,2020-02-13,2020-02-13,2020-02-13,6.0,-0.28,-207.83,0.0,162.0,           ,1.0,1.0,158.0
5937,Ruoka_paivittaistavarakauppa,2020-02-14 00:31:38.901098882,2020-02-14,2020-02-14,2020-02-14,6.0,-8.25,-216.08,0.0,162.0,           ,1.0,1.0,159.0
5938,Tulot,2020-02-14 09:13:50.769230751,2020-02-14,2020-02-14,2020-02-14,6.0,321.64,105.56,701.0,522.0,           ,1.0,1.0,217.0
5939,Terveys,2020-02-14 17:56:02.637362620,2020-02-14,2020-02-14,2020-02-14,6.0,-11.11,94.45,0.0,162.0,           ,1.0,1.0,49.0
5940,Ruoka_paivittaistavarakauppa,2020-02-14 22:25:03.296703275,2020-02-14,2020-02-14,2020-02-14,6.0,-13.26,81.19,0.0,162.0,           ,1.0,1.0,118.0
5941,Asuminen,2020-02-17 05:00:39.560439537,2020-02-17,2020-02-17,2020-02-17,6.0,-68.76,12.43,706.0,129.0,OKOYFIHH   ,0.0,0.0,224.0
5942,Kulttuuri_viihde,2020-02-17 07:07:15.164835144,2020-02-17,2020-02-17,2020-02-17,6.0,-7.77,4.66,0.0,162.0,           ,1.0,1.0,82.0
5943,Tulot,2020-02-17 13:42:51.428571406,2020-02-17,2020-02-17,2020-02-17,6.0,730.47,735.13,701.0,510.0,           ,1.0,1.0,214.0
5944,Liikkuminen,2020-02-17 15:49:27.032967013,2020-02-17,2020-02-17,2020-02-17,6.0,-65.15,669.98,0.0,162.0,           ,1.0,1.0,94.0
5945,Ruoka_paivittaistavarakauppa,2020-02-18 09:29:40.219780192,2020-02-18,2020-02-18,2020-02-18,6.0,-3.22,666.76,0.0,162.0,           ,1.0,1.0,47.0
5946,Ruoka_paivittaistavarakauppa,2020-02-18 20:18:27.692307668,2020-02-18,2020-02-18,2020-02-18,6.0,-6.1,660.66,0.0,162.0,           ,1.0,1.0,173.0
5947,Muut,2020-02-19 11:36:15.824175799,2020-02-19,2020-02-21,2020-02-19,6.0,-18.42,642.24,0.0,162.0,           ,1.0,1.0,164.0
5948,Ravintolat_kahvilat,2020-02-20 02:54:03.956043930,2020-02-20,2020-02-20,2020-02-20,6.0,-22.96,619.28,0.0,162.0,           ,1.0,1.0,95.0
5949,Ruoka_paivittaistavarakauppa,2020-02-20 16:05:16.483516454,2020-02-20,2020-02-20,2020-02-20,6.0,-46.45,572.83,0.0,162.0,           ,1.0,1.0,133.0
5950,Asuminen,2020-02-20 18:11:52.087912061,2020-02-20,2020-02-20,2020-02-20,6.0,-10.64,562.19,0.0,162.0,           ,1.0,1.0,137.0
5951,Ruoka_paivittaistavarakauppa,2020-02-21 07:23:04.615384585,2020-02-21,2020-02-21,2020-02-21,6.0,-58.55,503.64,0.0,162.0,           ,1.0,1.0,111.0
5952,Lemmikit,2020-02-24 00:47:28.351648323,2020-02-24,2020-02-24,2020-02-24,6.0,-110.96,392.68,0.0,162.0,           ,1.0,1.0,101.0
5953,Luokittelemattomat,2020-02-24 05:16:29.010988978,2020-02-24,2020-02-24,2020-02-24,6.0,-38.64,354.04,0.0,162.0,           ,1.0,1.0,173.0
5954,Ravintolat_kahvilat,2020-02-24 13:58:40.879120847,2020-02-24,2020-02-24,2020-02-24,6.0,-2.87,351.17,0.0,162.0,           ,1.0,1.0,47.0
5955,Ruoka_paivittaistavarakauppa,2020-02-24 20:34:17.142857109,2020-02-24,2020-02-24,2020-02-24,6.0,-23.11,328.06,0.0,162.0,           ,1.0,1.0,83.0
5956,Lapset,2020-02-24 22:40:52.747252716,2020-02-24,2020-02-24,2020-02-24,6.0,-19.3,308.76,0.0,106.0,OKOYFIHH   ,0.0,0.0,38.0
5957,Hyvinvointijakauneus,2020-02-25 11:52:05.274725240,2020-02-25,2020-02-25,2020-02-25,6.0,-9.95,298.81,0.0,162.0,           ,1.0,1.0,125.0
5958,Ruoka_paivittaistavarakauppa,2020-02-27 03:09:53.406593371,2020-02-27,2020-02-27,2020-02-27,6.0,-29.38,269.43,0.0,162.0,           ,1.0,1.0,154.0
5959,Ruoka_paivittaistavarakauppa,2020-02-27 09:45:29.670329633,2020-02-27,2020-02-27,2020-02-27,6.0,-21.19,248.24,0.0,162.0,           ,1.0,1.0,127.0
5960,Ravintolat_kahvilat,2020-02-28 01:03:17.802197764,2020-02-28,2020-02-28,2020-02-28,6.0,-3.09,245.15,0.0,162.0,           ,1.0,1.0,142.0
5961,Ruoka_paivittaistavarakauppa,2020-02-28 16:21:05.934065895,2020-02-28,2020-02-28,2020-02-28,6.0,-5.11,240.04,0.0,162.0,           ,1.0,1.0,126.0
5962,Tulot,2020-02-28 18:27:41.538461502,2020-02-28,2020-02-28,2020-02-28,6.0,70.45,310.49,701.0,510.0,           ,1.0,1.0,215.0
5963,Luottojen_maksut,2020-03-01 13:10:05.309734513,2020-03-01,2020-03-04,2020-03-01,6.0,-74.22,236.27,0.0,106.0,OKOYFIHH   ,0.0,0.0,40.0
5964,Matkailu,2020-03-02 02:20:10.619469026,2020-03-02,2020-03-02,2020-03-02,6.0,-29.05,207.22,0.0,106.0,OKOYFIHH   ,0.0,0.0,23.0
5965,Tulot,2020-03-02 15:30:15.929203539,2020-03-02,2020-03-02,2020-03-02,6.0,58.81,266.03,710.0,506.0,           ,1.0,1.0,234.0
5966,Ruoka_paivittaistavarakauppa,2020-03-03 04:40:21.238938052,2020-03-03,2020-03-03,2020-03-03,6.0,-16.41,249.62,0.0,162.0,           ,1.0,1.0,170.0
5967,Ruoka_paivittaistavarakauppa,2020-03-03 17:50:26.548672565,2020-03-03,2020-03-03,2020-03-03,6.0,-20.18,229.44,0.0,162.0,           ,1.0,1.0,89.0
5968,Ravintolat_kahvilat,2020-03-04 07:00:31.858407078,2020-03-04,2020-03-04,2020-03-04,6.0,-4.95,224.49,0.0,162.0,           ,1.0,1.0,104.0
5969,Ruoka_paivittaistavarakauppa,2020-03-04 20:10:37.168141591,2020-03-04,2020-03-04,2020-03-04,6.0,-9.0,215.49,0.0,162.0,           ,1.0,1.0,137.0
5970,Harrastukset,2020-03-04 22:30:47.787610617,2020-03-04,2020-03-04,2020-03-04,6.0,-9.46,206.03,0.0,162.0,           ,1.0,1.0,96.0
5971,Lapset,2020-03-05 09:20:42.477876104,2020-03-05,2020-03-05,2020-03-05,6.0,-3.54,202.49,0.0,162.0,           ,1.0,1.0,89.0
5972,Ravintolat_kahvilat,2020-03-06 00:50:58.407079643,2020-03-06,2020-03-06,2020-03-06,6.0,-6.45,196.04,0.0,162.0,           ,1.0,1.0,164.0
5973,Ruoka_paivittaistavarakauppa,2020-03-06 11:40:53.097345130,2020-03-06,2020-03-06,2020-03-06,6.0,-64.1,131.94,0.0,162.0,           ,1.0,1.0,116.0
5974,Ruoka_paivittaistavarakauppa,2020-03-06 14:01:03.716814156,2020-03-06,2020-03-06,2020-03-06,6.0,-27.85,104.09,0.0,162.0,           ,1.0,1.0,121.0
5975,Saastot_sijoitukset,2020-03-09 03:11:09.026548669,2020-03-09,2020-03-10,2020-03-09,6.0,-46.04,58.05,0.0,162.0,           ,1.0,1.0,82.0
5976,Ruoka_paivittaistavarakauppa,2020-03-09 05:31:19.646017695,2020-03-09,2020-03-09,2020-03-09,6.0,-22.52,35.53,0.0,162.0,           ,1.0,1.0,69.0
5977,Lemmikit,2020-03-09 16:21:14.336283182,2020-03-09,2020-03-09,2020-03-09,6.0,-11.92,23.61,0.0,162.0,           ,1.0,1.0,63.0
5978,Ruoka_paivittaistavarakauppa,2020-03-09 18:41:24.955752208,2020-03-09,2020-03-10,2020-03-09,6.0,-23.06,0.55,0.0,162.0,           ,1.0,1.0,174.0
5979,Saastot_sijoitukset,2020-03-10 07:51:30.265486721,2020-03-10,2020-03-10,2020-03-10,6.0,-34.17,-33.62,0.0,162.0,           ,1.0,1.0,157.0
5980,Ruoka_paivittaistavarakauppa,2020-03-10 21:01:35.575221234,2020-03-10,2020-03-10,2020-03-10,6.0,-16.08,-49.7,0.0,162.0,           ,1.0,1.0,47.0
5981,Ruoka_paivittaistavarakauppa,2020-03-12 01:41:56.814159286,2020-03-12,2020-03-12,2020-03-12,6.0,-3.9,-53.6,0.0,162.0,           ,1.0,1.0,165.0
5982,Liikkuminen,2020-03-12 12:31:51.504424773,2020-03-12,2020-03-12,2020-03-12,6.0,-4.8,-58.4,0.0,162.0,           ,1.0,1.0,175.0
5983,Lapset,2020-03-12 23:21:46.194690260,2020-03-12,2020-03-12,2020-03-12,6.0,-11.99,-70.39,0.0,162.0,           ,1.0,1.0,71.0
5984,Lemmikit,2020-03-13 04:02:07.433628312,2020-03-13,2020-03-13,2020-03-13,6.0,-1.77,-72.16,0.0,162.0,           ,1.0,1.0,82.0
5985,Ruoka_paivittaistavarakauppa,2020-03-13 10:11:40.884955747,2020-03-13,2020-03-13,2020-03-13,6.0,-5.18,-77.34,0.0,162.0,           ,1.0,1.0,108.0
5986,Lemmikit,2020-03-13 14:52:02.123893799,2020-03-13,2020-03-13,2020-03-13,6.0,-16.87,-94.21,0.0,162.0,           ,1.0,1.0,108.0
5987,Kulttuuri_viihde,2020-03-13 17:12:12.743362825,2020-03-13,2020-03-13,2020-03-13,6.0,-15.97,-110.18,0.0,162.0,           ,1.0,1.0,69.0
5988,Matkailu,2020-03-16 06:22:18.053097338,2020-03-16,2020-03-16,2020-03-16,6.0,-0.44,-110.62,0.0,162.0,           ,1.0,1.0,63.0
5989,Asuminen,2020-03-16 08:42:28.672566364,2020-03-16,2020-03-16,2020-03-16,6.0,-10.51,-121.13,0.0,162.0,           ,1.0,1.0,86.0
5990,Lemmikit,2020-03-16 19:32:23.362831851,2020-03-16,2020-03-16,2020-03-16,6.0,-1.3,-122.43,0.0,162.0,           ,1.0,1.0,105.0
5991,Ruoka_paivittaistavarakauppa,2020-03-16 21:52:33.982300877,2020-03-16,2020-03-16,2020-03-16,6.0,-2.21,-124.64,0.0,162.0,           ,1.0,1.0,68.0
5992,Saastot_sijoitukset,2020-03-17 11:02:39.292035390,2020-03-17,2020-03-17,2020-03-17,6.0,-7.22,-131.86,0.0,162.0,           ,1.0,1.0,63.0
5993,Ravintolat_kahvilat,2020-03-18 00:12:44.601769903,2020-03-18,2020-03-18,2020-03-18,6.0,-1.87,-133.73,0.0,162.0,           ,1.0,1.0,53.0
5994,Ruoka_paivittaistavarakauppa,2020-03-18 13:22:49.911504416,2020-03-18,2020-03-18,2020-03-18,6.0,-43.43,-177.16,0.0,162.0,           ,1.0,1.0,116.0
5995,Asuminen,2020-03-19 02:32:55.221238929,2020-03-19,2020-03-19,2020-03-19,6.0,-2.08,-179.24,0.0,162.0,           ,1.0,1.0,46.0
5996,Ravintolat_kahvilat,2020-03-19 15:43:00.530973442,2020-03-19,2020-03-19,2020-03-19,6.0,-9.82,-189.06,0.0,162.0,           ,1.0,1.0,99.0
5997,Ravintolat_kahvilat,2020-03-20 04:53:05.840707955,2020-03-20,2020-03-20,2020-03-20,6.0,-0.45,-189.51,0.0,162.0,           ,1.0,1.0,104.0
5998,Ruoka_paivittaistavarakauppa,2020-03-20 07:13:16.460176981,2020-03-20,2020-03-20,2020-03-20,6.0,-14.03,-203.54,0.0,162.0,           ,1.0,1.0,152.0
5999,Ravintolat_kahvilat,2020-03-20 18:03:11.150442468,2020-03-20,2020-03-20,2020-03-20,6.0,-3.14,-206.68,0.0,162.0,           ,1.0,1.0,132.0
6000,Lemmikit,2020-03-20 20:23:21.769911494,2020-03-20,2020-03-20,2020-03-20,6.0,-2.77,-209.45,0.0,162.0,           ,1.0,1.0,170.0
6001,Shoppailu,2020-03-23 01:03:43.008849546,2020-03-23,2020-03-23,2020-03-23,6.0,-2.78,-212.23,0.0,162.0,           ,1.0,1.0,150.0
6002,Ruoka_paivittaistavarakauppa,2020-03-23 09:33:27.079646007,2020-03-23,2020-03-23,2020-03-23,6.0,-4.94,-217.17,0.0,162.0,           ,1.0,1.0,117.0
6003,Luokittelemattomat,2020-03-23 11:53:37.699115033,2020-03-23,2020-03-23,2020-03-23,6.0,-8.91,-226.08,0.0,162.0,           ,1.0,1.0,108.0
6004,Ruoka_paivittaistavarakauppa,2020-03-23 22:43:32.389380520,2020-03-23,2020-03-23,2020-03-23,6.0,-1.55,-227.63,0.0,162.0,           ,1.0,1.0,124.0
6005,Shoppailu,2020-03-24 03:23:53.628318572,2020-03-24,2020-03-24,2020-03-24,6.0,-2.53,-230.16,0.0,162.0,           ,1.0,1.0,127.0
6006,Ravintolat_kahvilat,2020-03-25 14:13:48.318584059,2020-03-25,2020-03-25,2020-03-25,6.0,-1.76,-231.92,0.0,162.0,           ,1.0,1.0,85.0
6007,Ruoka_paivittaistavarakauppa,2020-03-26 05:44:04.247787598,2020-03-26,2020-03-26,2020-03-26,6.0,-5.48,-237.4,0.0,162.0,           ,1.0,1.0,178.0
6008,Ravintolat_kahvilat,2020-03-26 18:54:09.557522111,2020-03-26,2020-03-26,2020-03-26,6.0,-1.73,-239.13,0.0,162.0,           ,1.0,1.0,146.0
6009,Liikkuminen,2020-03-27 08:04:14.867256624,2020-03-27,2020-03-27,2020-03-27,6.0,-62.94,-302.07,0.0,162.0,           ,1.0,1.0,126.0
6010,Liikkuminen,2020-03-27 10:24:25.486725650,2020-03-27,2020-03-27,2020-03-27,6.0,-14.51,-316.58,0.0,162.0,           ,1.0,1.0,164.0
6011,Ruoka_paivittaistavarakauppa,2020-03-27 12:44:36.106194676,2020-03-27,2020-03-27,2020-03-27,6.0,-8.61,-325.19,0.0,162.0,           ,1.0,1.0,178.0
6012,Ruoka_paivittaistavarakauppa,2020-03-27 16:33:58.938053085,2020-03-27,2020-03-27,2020-03-27,6.0,-10.07,-335.26,0.0,162.0,           ,1.0,1.0,182.0
6013,Ravintolat_kahvilat,2020-03-27 21:14:20.176991137,2020-03-27,2020-03-27,2020-03-27,6.0,-11.06,-346.32,0.0,162.0,           ,1.0,1.0,63.0
6014,Ravintolat_kahvilat,2020-03-27 23:34:30.796460163,2020-03-27,2020-03-27,2020-03-27,6.0,-4.7,-351.02,0.0,162.0,           ,1.0,1.0,47.0
6015,Lemmikit,2020-03-30 01:54:41.415929189,2020-03-30,2020-03-30,2020-03-30,6.0,-7.18,-358.2,0.0,162.0,           ,1.0,1.0,121.0
6016,Ruoka_paivittaistavarakauppa,2020-03-30 15:04:46.725663702,2020-03-30,2020-03-31,2020-03-30,6.0,-0.54,-358.74,0.0,162.0,           ,1.0,1.0,130.0
6017,Ruoka_paivittaistavarakauppa,2020-03-31 04:14:52.035398215,2020-03-31,2020-03-31,2020-03-31,6.0,-4.96,-363.7,0.0,162.0,           ,1.0,1.0,148.0
6018,Liikkuminen,2020-03-31 17:24:57.345132728,2020-03-31,2020-03-31,2020-03-31,6.0,-15.96,-379.66,0.0,162.0,           ,1.0,1.0,138.0
6019,Ruoka_paivittaistavarakauppa,2020-04-02 03:10:11.320754716,2020-04-02,2020-04-02,2020-04-02,6.0,-2.25,-381.91,0.0,162.0,           ,1.0,1.0,48.0
6020,Ravintolat_kahvilat,2020-04-03 06:20:22.641509432,2020-04-03,2020-04-03,2020-04-03,6.0,-3.63,-385.54,0.0,162.0,           ,1.0,1.0,93.0
6021,Matkailu,2020-04-03 09:30:33.962264148,2020-04-03,2020-04-03,2020-04-03,6.0,-4.25,-389.79,0.0,164.0,           ,1.0,1.0,186.0
6022,Ruoka_paivittaistavarakauppa,2020-04-06 12:40:45.283018864,2020-04-06,2020-04-07,2020-04-06,6.0,-2.02,-391.81,0.0,162.0,           ,1.0,1.0,155.0
6023,Ruoka_paivittaistavarakauppa,2020-04-06 15:50:56.603773580,2020-04-06,2020-04-06,2020-04-06,6.0,-12.64,-404.45,0.0,162.0,           ,1.0,1.0,179.0
6024,Matkailu,2020-04-06 19:01:07.924528296,2020-04-06,2020-04-06,2020-04-08,6.0,-15.29,-419.74,0.0,164.0,           ,1.0,1.0,188.0
6025,Luottojen_maksut,2020-04-09 07:41:53.207547160,2020-04-09,2020-04-09,2020-04-09,6.0,-13.51,-433.25,0.0,164.0,           ,1.0,1.0,186.0
6026,Hyvinvointi,2020-04-10 01:21:30.566037728,2020-04-10,2020-04-10,2020-04-10,6.0,-20.18,-453.43,0.0,162.0,           ,1.0,1.0,141.0
6027,Ravintolat_kahvilat,2020-04-10 22:11:19.245283012,2020-04-10,2020-04-10,2020-04-10,6.0,-70.83,-524.26,0.0,162.0,           ,1.0,1.0,115.0
6028,Liikkuminen,2020-04-13 04:31:41.886792444,2020-04-13,2020-04-13,2020-04-13,6.0,-1.55,-525.81,0.0,162.0,           ,1.0,1.0,101.0
6029,Ruoka_paivittaistavarakauppa,2020-04-13 10:52:04.528301876,2020-04-13,2020-04-13,2020-04-13,6.0,-5.29,-531.1,0.0,162.0,           ,1.0,1.0,147.0
6030,Muut,2020-04-14 14:02:15.849056592,2020-04-14,2020-04-14,2020-04-14,6.0,-19.92,-551.02,0.0,163.0,           ,1.0,1.0,184.0
6031,Muut,2020-04-14 17:12:27.169811308,2020-04-14,2020-04-14,2020-04-14,6.0,-9.36,-560.38,0.0,164.0,           ,1.0,1.0,187.0
6032,Ravintolat_kahvilat,2020-04-15 23:32:49.811320740,2020-04-15,2020-04-15,2020-04-15,6.0,-0.95,-561.33,0.0,162.0,           ,1.0,1.0,63.0
6033,Tulot,2020-04-16 20:22:38.490566024,2020-04-16,2020-04-16,2020-04-16,6.0,648.95,87.62,0.0,506.0,           ,1.0,1.0,204.0
6034,Ruoka_paivittaistavarakauppa,2020-04-20 02:43:01.132075456,2020-04-20,2020-04-20,2020-04-20,6.0,-17.31,70.31,0.0,162.0,           ,1.0,1.0,64.0
6035,Luokittelemattomat,2020-04-20 05:53:12.452830172,2020-04-20,2020-04-20,2020-04-20,6.0,-22.1,48.21,0.0,162.0,           ,1.0,1.0,48.0
6036,Lapset,2020-04-20 09:03:23.773584888,2020-04-20,2020-04-20,2020-04-20,6.0,-9.46,38.75,0.0,162.0,           ,1.0,1.0,86.0
6037,Tulot,2020-04-22 15:23:46.415094320,2020-04-22,2020-04-22,2020-04-22,6.0,23.23,61.98,0.0,505.0,           ,1.0,1.0,201.0
6038,Lemmikit,2020-04-23 12:13:35.094339604,2020-04-23,2020-04-23,2020-04-23,6.0,-6.3,55.68,0.0,162.0,           ,1.0,1.0,116.0
6039,Muut,2020-04-24 18:33:57.735849036,2020-04-24,2020-04-24,2020-04-24,6.0,-45.67,10.01,0.0,164.0,           ,1.0,1.0,186.0
6040,Muut,2020-04-24 21:44:09.056603752,2020-04-24,2020-04-24,2020-04-24,6.0,-20.57,-10.56,0.0,164.0,           ,1.0,1.0,186.0
6041,Ruoka_paivittaistavarakauppa,2020-04-27 00:54:20.377358468,2020-04-27,2020-04-27,2020-04-27,6.0,-2.57,-13.13,0.0,162.0,           ,1.0,1.0,82.0
6042,Matkailu,2020-04-29 04:04:31.698113184,2020-04-29,2020-04-29,2020-04-29,6.0,-147.24,-160.37,0.0,164.0,           ,1.0,1.0,187.0
6043,Muut,2020-04-29 07:14:43.018867900,2020-04-29,2020-04-29,2020-04-29,6.0,-10.08,-170.45,0.0,164.0,           ,1.0,1.0,186.0
6044,Ravintolat_kahvilat,2020-04-29 10:24:54.339622616,2020-04-29,2020-04-29,2020-04-29,6.0,-3.6,-174.05,0.0,162.0,           ,1.0,1.0,89.0
6045,Matkailu,2020-05-04 22:51:25.714285714,2020-05-04,2020-05-04,2020-05-04,6.0,-3.32,-177.37,0.0,164.0,           ,1.0,1.0,186.0
6046,Matkailu,2020-05-06 21:42:51.428571428,2020-05-06,2020-05-06,2020-05-06,6.0,-14.36,-191.73,0.0,164.0,           ,1.0,1.0,186.0
6047,Muut,2020-05-08 20:34:17.142857142,2020-05-08,2020-05-08,2020-05-08,6.0,-10.46,-202.19,0.0,164.0,           ,1.0,1.0,187.0
6048,Muut,2020-05-13 19:25:42.857142856,2020-05-13,2020-05-13,2020-05-13,6.0,-154.69,-356.88,0.0,164.0,           ,1.0,1.0,186.0
6049,Matkailu,2020-05-15 18:17:08.571428570,2020-05-15,2020-05-15,2020-05-15,6.0,-6.2,-363.08,0.0,164.0,           ,1.0,1.0,189.0
6050,Matkailu,2020-05-18 17:08:34.285714284,2020-05-18,2020-05-18,2020-05-18,6.0,-2.93,-366.01,0.0,164.0,           ,1.0,1.0,187.0
6051,Ravintolat_kahvilat,2020-05-21 15:59:59.999999998,2020-05-21,2020-05-21,2020-05-21,6.0,-4.93,-370.94,0.0,164.0,           ,1.0,1.0,187.0
6052,Muut,2020-05-25 14:51:25.714285712,2020-05-25,2020-05-25,2020-05-25,6.0,-35.06,-406.0,0.0,164.0,           ,1.0,1.0,189.0
6053,Muut,2020-05-27 12:34:17.142857140,2020-05-27,2020-05-27,2020-05-27,6.0,-108.28,-514.28,0.0,164.0,           ,1.0,1.0,189.0
6054,Muut,2020-05-27 13:42:51.428571426,2020-05-27,2020-05-27,2020-05-27,6.0,-4.35,-518.63,0.0,164.0,           ,1.0,1.0,186.0
6055,Muut,2020-06-01 09:29:18.139534883,2020-06-01,2020-06-01,2020-06-01,6.0,-23.55,-542.18,0.0,164.0,           ,1.0,1.0,188.0
6056,Asuminen,2020-06-03 18:58:36.279069766,2020-06-03,2020-06-03,2020-06-03,6.0,-12.15,-554.33,0.0,162.0,           ,1.0,1.0,98.0
6057,Luottojen_maksut,2020-06-05 04:27:54.418604649,2020-06-05,2020-06-05,2020-06-05,6.0,-114.07,-668.4,0.0,172.0,           ,1.0,1.0,195.0
6058,Matkailu,2020-06-05 23:26:30.697674415,2020-06-05,2020-06-05,2020-06-05,6.0,-10.26,-678.66,0.0,164.0,           ,1.0,1.0,186.0
6059,Ruoka_paivittaistavarakauppa,2020-06-08 13:57:12.558139532,2020-06-08,2020-06-08,2020-06-08,6.0,-2.77,-681.43,0.0,162.0,           ,1.0,1.0,155.0
6060,Ruoka_paivittaistavarakauppa,2020-06-09 08:55:48.837209298,2020-06-09,2020-06-10,2020-06-09,6.0,-1.35,-682.78,0.0,162.0,           ,1.0,1.0,139.0
6061,Luottojen_maksut,2020-06-09 18:25:06.976744181,2020-06-09,2020-06-09,2020-06-09,6.0,-12.48,-695.26,0.0,164.0,           ,1.0,1.0,186.0
6062,Muut,2020-06-12 03:54:25.116279064,2020-06-12,2020-06-12,2020-06-12,6.0,-48.55,-743.81,0.0,164.0,           ,1.0,1.0,186.0
6063,Matkailu,2020-06-15 13:23:43.255813947,2020-06-15,2020-06-15,2020-06-15,6.0,-0.15,-743.96,0.0,103.0,           ,1.0,1.0,0.0
6064,Ruoka_paivittaistavarakauppa,2020-06-15 17:51:37.674418596,2020-06-15,2020-06-15,2020-06-15,6.0,-2.19,-746.15,0.0,162.0,           ,1.0,1.0,108.0
6065,Ruoka_paivittaistavarakauppa,2020-06-15 22:53:01.395348830,2020-06-15,2020-06-15,2020-06-15,6.0,-6.21,-752.36,0.0,162.0,           ,1.0,1.0,91.0
6066,Ruoka_paivittaistavarakauppa,2020-06-16 08:22:19.534883713,2020-06-16,2020-06-16,2020-06-16,6.0,-10.82,-763.18,0.0,162.0,           ,1.0,1.0,182.0
6067,Muut,2020-06-19 03:20:55.813953479,2020-06-19,2020-06-19,2020-06-19,6.0,-7.33,-770.51,0.0,164.0,           ,1.0,1.0,186.0
6068,Ruoka_paivittaistavarakauppa,2020-06-19 12:50:13.953488362,2020-06-19,2020-06-19,2020-06-19,6.0,-6.25,-776.76,0.0,162.0,           ,1.0,1.0,159.0
6069,Tulot,2020-06-22 22:19:32.093023245,2020-06-22,2020-06-22,2020-06-22,6.0,743.07,-33.69,0.0,559.0,           ,1.0,1.0,209.0
6070,Ruoka_paivittaistavarakauppa,2020-06-23 07:48:50.232558128,2020-06-23,2020-06-23,2020-06-23,6.0,-11.85,-45.54,0.0,162.0,           ,1.0,1.0,132.0
6071,Asuminen,2020-06-24 17:18:08.372093011,2020-06-24,2020-06-24,2020-06-24,6.0,-14.53,-60.07,706.0,129.0,NDEAFIHH   ,0.0,0.0,226.0
6072,Tulot,2020-06-26 02:47:26.511627894,2020-06-26,2020-06-26,2020-06-26,6.0,4.4,-55.67,0.0,505.0,           ,1.0,1.0,203.0
6073,Muut,2020-06-26 12:16:44.651162777,2020-06-26,2020-06-26,2020-06-26,6.0,-28.36,-84.03,0.0,164.0,           ,1.0,1.0,188.0
6074,Luokittelemattomat,2020-06-27 21:46:02.790697660,2020-06-27,2020-06-27,2020-06-27,6.0,-3.99,-88.02,0.0,106.0,NDEAFIHH   ,0.0,0.0,13.0
6075,Tulot,2020-06-30 07:15:20.930232543,2020-06-30,2020-06-30,2020-06-30,6.0,84.6,-3.42,0.0,505.0,           ,1.0,1.0,200.0
6076,Muut,2020-07-02 21:05:27.272727272,2020-07-02,2020-07-02,2020-07-02,6.0,-6.03,-9.45,0.0,164.0,           ,1.0,1.0,186.0
6077,Asuminen,2020-07-03 18:10:54.545454544,2020-07-03,2020-07-03,2020-07-03,6.0,-15.12,-24.57,706.0,129.0,OKOYFIHH   ,0.0,0.0,228.0
6078,Tulot,2020-07-04 15:16:21.818181816,2020-07-06,2020-07-06,2020-07-06,6.0,21.12,-3.45,0.0,505.0,           ,1.0,1.0,202.0
6079,Ravintolat_kahvilat,2020-07-08 12:21:49.090909088,2020-07-08,2020-07-08,2020-07-08,6.0,-20.81,-24.26,0.0,106.0,DABAFIHH   ,0.0,0.0,23.0
6080,Tulot,2020-07-10 09:27:16.363636360,2020-07-10,2020-07-10,2020-07-10,6.0,51.01,26.75,0.0,505.0,           ,1.0,1.0,201.0
6081,Liikkuminen,2020-07-11 06:32:43.636363632,2020-07-11,2020-07-11,2020-07-10,6.0,-22.75,4.0,0.0,106.0,OKOYFIHH   ,0.0,0.0,13.0
6082,Muut,2020-07-14 03:38:10.909090904,2020-07-14,2020-07-14,2020-07-14,6.0,-18.64,-14.64,0.0,163.0,           ,1.0,1.0,184.0
6083,Tulot,2020-07-16 21:49:05.454545448,2020-07-16,2020-07-16,2020-07-16,6.0,28.44,13.8,710.0,588.0,           ,0.0,1.0,239.0
6084,Ruoka_paivittaistavarakauppa,2020-07-17 00:43:38.181818176,2020-07-17,2020-07-17,2020-07-17,6.0,-2.9,10.9,0.0,162.0,           ,1.0,1.0,134.0
6085,Ruoka_paivittaistavarakauppa,2020-07-20 15:59:59.999999992,2020-07-20,2020-07-21,2020-07-20,6.0,-7.89,3.01,0.0,162.0,           ,1.0,1.0,107.0
6086,Hyvinvointijakauneus,2020-07-20 18:54:32.727272720,2020-07-20,2020-07-20,2020-07-17,6.0,-1.41,1.6,0.0,162.0,           ,1.0,1.0,172.0
6087,Luokittelemattomat,2020-07-24 10:10:54.545454536,2020-07-24,2020-07-24,2020-07-24,6.0,-5.2,-3.6,0.0,162.0,           ,1.0,1.0,46.0
6088,Muut,2020-07-24 13:05:27.272727264,2020-07-24,2020-07-24,2020-07-24,6.0,-23.98,-27.58,0.0,163.0,           ,1.0,1.0,184.0
6089,Ruoka_paivittaistavarakauppa,2020-07-27 07:16:21.818181808,2020-07-27,2020-07-27,2020-07-27,6.0,-13.28,-40.86,0.0,162.0,           ,1.0,1.0,111.0
6090,Ruoka_paivittaistavarakauppa,2020-07-28 04:21:49.090909080,2020-07-28,2020-07-28,2020-07-28,6.0,-1.84,-42.7,0.0,162.0,           ,1.0,1.0,91.0
6091,Ruoka_paivittaistavarakauppa,2020-07-30 01:27:16.363636352,2020-07-30,2020-07-30,2020-07-30,6.0,-1.53,-44.23,0.0,162.0,           ,1.0,1.0,96.0
6092,Tulot,2020-08-03 16:41:44.347826086,2020-08-03,2020-08-03,2020-08-03,6.0,55.62,11.39,0.0,505.0,           ,1.0,1.0,199.0
6093,Ruoka_paivittaistavarakauppa,2020-08-06 09:23:28.695652172,2020-08-06,2020-08-06,2020-08-03,6.0,-12.1,-0.71,0.0,162.0,           ,1.0,1.0,46.0
6094,Tulot,2020-08-07 02:05:13.043478258,2020-08-07,2020-08-07,2020-08-07,6.0,5.16,4.45,0.0,500.0,OKOYFIHH   ,1.0,0.0,198.0
6095,Lemmikit,2020-08-11 18:46:57.391304344,2020-08-11,2020-08-12,2020-08-11,6.0,-15.35,-10.9,0.0,106.0,OKOYFIHH   ,0.0,0.0,41.0
6096,Luottojen_maksut,2020-08-17 04:10:26.086956516,2020-08-17,2020-08-17,2020-08-17,6.0,-36.55,-47.45,0.0,172.0,           ,1.0,1.0,193.0
6097,Matkailu,2020-08-18 11:28:41.739130430,2020-08-18,2020-08-18,2020-08-18,6.0,-4.02,-51.47,0.0,103.0,           ,0.0,1.0,0.0
6098,Lemmikit,2020-08-18 20:52:10.434782602,2020-08-18,2020-08-18,2020-08-17,6.0,-15.15,-66.62,0.0,106.0,OKOYFIHH   ,1.0,0.0,28.0
6099,Lapset,2020-08-21 13:33:54.782608688,2020-08-21,2020-08-21,2020-08-21,6.0,-1.85,-68.47,0.0,162.0,           ,1.0,1.0,102.0
6100,Asuminen,2020-08-25 06:15:39.130434774,2020-08-25,2020-08-25,2020-08-25,6.0,-37.33,-105.8,706.0,129.0,OKOYFIHH   ,0.0,0.0,223.0
6101,Tulot,2020-08-27 22:57:23.478260860,2020-08-27,2020-08-27,2020-08-27,6.0,264.53,158.73,710.0,588.0,           ,0.0,1.0,241.0
6102,Asuminen,2020-08-31 15:39:07.826086946,2020-08-31,2020-08-31,2020-08-31,6.0,-92.16,66.57,0.0,162.0,           ,1.0,1.0,175.0
6103,Tulot,2020-09-03 01:39:18.620689655,2020-09-03,2020-09-03,2020-09-03,6.0,44.17,110.74,0.0,505.0,           ,1.0,1.0,200.0
6104,Tulot,2020-09-05 03:18:37.241379310,2020-09-05,2020-09-05,2020-09-05,6.0,154.28,265.02,0.0,506.0,           ,1.0,1.0,204.0
6105,Muut,2020-09-07 04:57:55.862068965,2020-09-07,2020-09-07,2020-09-07,6.0,-34.1,230.92,0.0,164.0,           ,1.0,1.0,186.0
6106,Vakuutukset,2020-09-11 06:37:14.482758620,2020-09-11,2020-09-11,2020-09-11,6.0,-115.42,115.5,0.0,106.0,OKOYFIHH   ,0.0,0.0,23.0
6107,Vakuutukset,2020-09-11 08:16:33.103448275,2020-09-11,2020-09-11,2020-09-11,6.0,-2.28,113.22,0.0,106.0,OKOYFIHH   ,0.0,0.0,37.0
6108,Hyvinvointi,2020-09-12 09:55:51.724137930,2020-09-12,2020-09-12,2020-09-12,6.0,-17.4,95.82,0.0,106.0,OKOYFIHH   ,0.0,0.0,34.0
6109,Muut,2020-09-15 11:35:10.344827585,2020-09-15,2020-09-15,2020-09-15,6.0,-0.75,95.07,0.0,103.0,           ,0.0,1.0,0.0
6110,Kulttuuri_viihde,2020-09-16 13:14:28.965517240,2020-09-16,2020-09-16,2020-09-16,6.0,-10.75,84.32,0.0,162.0,           ,1.0,1.0,104.0
6111,Tulot,2020-09-18 14:53:47.586206895,2020-09-18,2020-09-18,2020-09-18,6.0,307.76,392.08,710.0,506.0,           ,1.0,1.0,236.0
6112,Tulot,2020-09-21 16:33:06.206896550,2020-09-21,2020-09-21,2020-09-21,6.0,73.66,465.74,710.0,506.0,           ,1.0,1.0,233.0
6113,Lemmikit,2020-09-23 18:12:24.827586205,2020-09-23,2020-09-24,2020-09-23,6.0,-5.76,459.98,0.0,106.0,DABAFIHH   ,0.0,0.0,37.0
6114,Asuminen,2020-09-25 19:51:43.448275860,2020-09-25,2020-09-25,2020-09-25,6.0,-25.13,434.85,0.0,106.0,OKOYFIHH   ,0.0,0.0,5.0
6115,Ruoka_paivittaistavarakauppa,2020-09-28 21:31:02.068965515,2020-09-28,2020-09-28,2020-09-28,6.0,-13.78,421.07,0.0,162.0,           ,1.0,1.0,143.0
6116,Tulot,2020-09-29 23:10:20.689655170,2020-09-29,2020-09-29,2020-09-29,6.0,17.76,438.83,710.0,506.0,           ,1.0,1.0,236.0
6117,Luottojen_maksut,2020-10-05 06:18:56.842105263,2020-10-05,2020-10-05,2020-10-05,6.0,-97.81,341.02,0.0,172.0,           ,1.0,1.0,191.0
6118,Tulot,2020-10-07 12:37:53.684210526,2020-10-07,2020-10-07,2020-10-07,6.0,16.01,357.03,710.0,506.0,           ,1.0,1.0,231.0
6119,Liikkuminen,2020-10-11 18:56:50.526315789,2020-10-11,2020-10-11,2020-10-11,6.0,-36.02,321.01,0.0,106.0,SBANFIHH   ,0.0,0.0,24.0
6120,Luokittelemattomat,2020-10-14 01:15:47.368421052,2020-10-14,2020-10-14,2020-10-14,6.0,-37.13,283.88,0.0,106.0,OKOYFIHH   ,0.0,0.0,36.0
6121,Tulot,2020-10-18 07:34:44.210526315,2020-10-18,2020-10-18,2020-10-18,6.0,384.27,668.15,0.0,505.0,           ,1.0,1.0,200.0
6122,Muut,2020-10-19 13:53:41.052631578,2020-10-19,2020-10-19,2020-10-19,6.0,-5.65,662.5,0.0,103.0,           ,0.0,1.0,0.0
6123,Luottojen_maksut,2020-10-23 20:12:37.894736841,2020-10-23,2020-10-23,2020-10-22,6.0,-80.02,582.48,0.0,172.0,           ,1.0,1.0,191.0
6124,Luottojen_maksut,2020-10-26 02:31:34.736842104,2020-10-26,2020-10-26,2020-10-26,6.0,-138.0,444.48,0.0,172.0,           ,1.0,1.0,191.0
6125,Tulot,2020-10-30 08:50:31.578947367,2020-10-30,2020-10-30,2020-10-30,6.0,103.74,548.22,0.0,505.0,           ,1.0,1.0,199.0
6126,Tulot,2020-11-03 20:34:17.142857142,2020-11-03,2020-11-04,2020-11-03,6.0,93.6,641.82,0.0,505.0,           ,1.0,1.0,201.0
6127,Tulot,2020-11-06 13:42:51.428571426,2020-11-06,2020-11-06,2020-11-06,6.0,-27.71,614.11,0.0,103.0,           ,0.0,1.0,0.0
6128,Muut,2020-11-06 17:08:34.285714284,2020-11-06,2020-11-06,2020-11-06,6.0,-33.02,581.09,0.0,163.0,           ,1.0,1.0,185.0
6129,Tulot,2020-11-12 10:17:08.571428568,2020-11-12,2020-11-12,2020-11-12,6.0,75.6,656.69,710.0,506.0,           ,1.0,1.0,238.0
6130,Tulot,2020-11-16 06:51:25.714285710,2020-11-16,2020-11-16,2020-11-16,6.0,132.87,789.56,710.0,506.0,           ,1.0,1.0,234.0
6131,Muut,2020-11-18 03:25:42.857142852,2020-11-18,2020-11-20,2020-11-18,6.0,-0.54,789.02,0.0,103.0,           ,0.0,1.0,0.0
6132,Muut,2020-11-20 23:59:59.999999994,2020-11-20,2020-11-20,2020-11-20,6.0,-29.12,759.9,0.0,163.0,           ,1.0,1.0,185.0
6133,Tulot,2020-11-23 20:34:17.142857136,2020-11-23,2020-11-23,2020-11-23,6.0,130.3,890.2,0.0,506.0,           ,1.0,1.0,204.0
6134,Tulot,2020-11-27 17:08:34.285714278,2020-11-27,2020-11-27,2020-11-27,6.0,459.74,1349.94,0.0,506.0,           ,1.0,1.0,204.0
6135,Ruoka_paivittaistavarakauppa,2020-11-30 13:42:51.428571420,2020-11-30,2020-11-30,2020-11-30,6.0,-90.09,1259.85,0.0,162.0,           ,1.0,1.0,131.0
6136,Tulot,2020-12-02 06:22:02.448979591,2020-12-02,2020-12-02,2020-12-02,6.0,823.69,2083.54,701.0,520.0,           ,1.0,1.0,216.0
6137,Luottojen_maksut,2020-12-03 12:44:04.897959182,2020-12-03,2020-12-03,2020-12-03,6.0,-1629.23,454.31,0.0,172.0,           ,1.0,1.0,194.0
6138,Luottojen_maksut,2020-12-04 19:06:07.346938773,2020-12-04,2020-12-04,2020-12-04,6.0,-35.79,418.52,0.0,106.0,OKOYFIHH   ,1.0,0.0,16.0
6139,Luottojen_maksut,2020-12-07 01:28:09.795918364,2020-12-07,2020-12-08,2020-12-07,6.0,-82.64,335.88,0.0,172.0,           ,1.0,1.0,192.0
6140,Luottojen_maksut,2020-12-07 07:50:12.244897955,2020-12-07,2020-12-07,2020-12-07,6.0,-19.97,315.91,0.0,172.0,           ,1.0,1.0,192.0
6141,Luottojen_maksut,2020-12-07 14:12:14.693877546,2020-12-07,2020-12-07,2020-12-07,6.0,-124.53,191.38,0.0,172.0,           ,1.0,1.0,192.0
6142,Matkailu,2020-12-09 09:18:22.040816319,2020-12-09,2020-12-09,2020-12-09,6.0,-12.85,178.53,0.0,164.0,           ,1.0,1.0,190.0
6143,Tulot,2020-12-09 20:34:17.142857137,2020-12-09,2020-12-09,2020-12-09,6.0,62.17,240.7,0.0,505.0,           ,1.0,1.0,202.0
6144,Luokittelemattomat,2020-12-11 02:56:19.591836728,2020-12-11,2020-12-11,2020-12-11,6.0,-140.38,100.32,0.0,172.0,           ,1.0,1.0,191.0
6145,Luokittelemattomat,2020-12-12 15:40:24.489795910,2020-12-12,2020-12-12,2020-12-12,6.0,-13.52,86.8,0.0,106.0,ITELFIHH   ,1.0,0.0,23.0
6146,Tulot,2020-12-14 04:24:29.387755092,2020-12-14,2020-12-14,2020-12-14,6.0,63.31,150.11,0.0,505.0,           ,1.0,1.0,199.0
6147,Tulot,2020-12-14 22:02:26.938775501,2020-12-14,2020-12-14,2020-12-14,6.0,167.51,317.62,0.0,505.0,           ,1.0,1.0,199.0
6148,Muut,2020-12-15 10:46:31.836734683,2020-12-15,2020-12-15,2020-12-15,6.0,-53.89,263.73,0.0,163.0,           ,1.0,1.0,184.0
6149,Ruoka_paivittaistavarakauppa,2020-12-18 17:08:34.285714274,2020-12-18,2020-12-18,2020-12-18,6.0,-6.9,256.83,0.0,162.0,           ,1.0,1.0,123.0
6150,Luokittelemattomat,2020-12-18 23:30:36.734693865,2020-12-18,2020-12-18,2020-12-18,6.0,-64.71,192.12,0.0,162.0,           ,1.0,1.0,103.0
6151,Vakuutukset,2020-12-21 12:14:41.632653047,2020-12-21,2020-12-21,2020-12-21,6.0,-6.93,185.19,706.0,129.0,OKOYFIHH   ,0.0,0.0,224.0
6152,Muut,2020-12-22 05:52:39.183673456,2020-12-22,2020-12-22,2020-12-22,6.0,-20.91,164.28,0.0,103.0,           ,0.0,1.0,2.0
6153,Liikkuminen,2020-12-23 18:36:44.081632638,2020-12-23,2020-12-23,2020-12-23,6.0,-9.03,155.25,0.0,162.0,           ,1.0,1.0,142.0
6154,Ruoka_paivittaistavarakauppa,2020-12-24 00:58:46.530612229,2020-12-24,2020-12-24,2020-12-23,6.0,-3.06,152.19,0.0,162.0,           ,1.0,1.0,108.0
6155,Ruoka_paivittaistavarakauppa,2020-12-24 07:20:48.979591820,2020-12-24,2020-12-24,2020-12-24,6.0,-8.35,143.84,0.0,162.0,           ,1.0,1.0,48.0
6156,Ravintolat_kahvilat,2020-12-28 13:42:51.428571411,2020-12-28,2020-12-28,2020-12-28,6.0,-35.03,108.81,0.0,162.0,           ,1.0,1.0,103.0
6157,Tulot,2020-12-28 20:04:53.877551002,2020-12-28,2020-12-28,2020-12-28,6.0,14.78,123.59,0.0,505.0,           ,1.0,1.0,199.0
6158,Muut,2020-12-30 02:26:56.326530593,2020-12-30,2020-12-31,2020-12-30,6.0,-19.35,104.24,0.0,163.0,           ,1.0,1.0,185.0
6159,Ravintolat_kahvilat,2020-12-30 08:48:58.775510184,2020-12-30,2020-12-30,2020-12-30,6.0,-7.5,96.74,0.0,162.0,           ,1.0,1.0,145.0
6160,Tulot,2019-01-01 00:00:00.000000000,2019-01-01,2019-01-01,2019-01-01,7.0,377.64,1932.6,0.0,505.0,           ,1.0,1.0,186.0
6161,Liikkuminen,2019-01-02 09:04:00.000000000,2019-01-02,2019-01-02,2019-01-02,7.0,-121.96,1810.64,0.0,106.0,HELSFIHH   ,0.0,0.0,14.0
6162,Muut,2019-01-03 18:08:00.000000000,2019-01-03,2019-01-03,2019-01-03,7.0,-679.85,1130.79,0.0,105.0,OKOYFIHH   ,1.0,0.0,4.0
6163,Tulot,2019-01-06 03:12:00.000000000,2019-01-06,2019-01-06,2019-01-06,7.0,7.46,1138.25,0.0,505.0,           ,1.0,1.0,185.0
6164,Ruoka_paivittaistavarakauppa,2019-01-07 06:24:00.000000000,2019-01-07,2019-01-07,2019-01-07,7.0,-23.33,1114.92,0.0,162.0,           ,1.0,1.0,95.0
6165,Liikkuminen,2019-01-07 12:16:00.000000000,2019-01-07,2019-01-07,2019-01-07,7.0,-68.51,1046.41,0.0,162.0,           ,1.0,1.0,136.0
6166,Ravintolat_kahvilat,2019-01-07 21:20:00.000000000,2019-01-07,2019-01-07,2019-01-07,7.0,-3.92,1042.49,0.0,162.0,           ,1.0,1.0,134.0
6167,Tulot,2019-01-09 15:28:00.000000000,2019-01-09,2019-01-09,2019-01-09,7.0,486.3,1528.79,0.0,505.0,           ,1.0,1.0,186.0
6168,Ruoka_paivittaistavarakauppa,2019-01-11 00:32:00.000000000,2019-01-11,2019-01-11,2019-01-11,7.0,-9.44,1519.35,0.0,162.0,           ,1.0,1.0,120.0
6169,Tulot,2019-01-13 09:36:00.000000000,2019-01-13,2019-01-13,2019-01-13,7.0,256.69,1776.04,0.0,505.0,           ,1.0,1.0,185.0
6170,Muut,2019-01-13 18:40:00.000000000,2019-01-13,2019-01-13,2019-01-13,7.0,-23.14,1752.9,0.0,163.0,           ,1.0,1.0,173.0
6171,Ruoka_paivittaistavarakauppa,2019-01-15 03:44:00.000000000,2019-01-10,2019-01-15,2019-01-15,7.0,-2.66,1750.24,0.0,162.0,           ,1.0,1.0,152.0
6172,Luokittelemattomat,2019-01-15 12:48:00.000000000,2019-01-15,2019-01-15,2019-01-15,7.0,-15.77,1734.47,0.0,106.0,OKOYFIHH   ,0.0,0.0,32.0
6173,Tulot,2019-01-18 21:52:00.000000000,2019-01-18,2019-01-18,2019-01-18,7.0,131.22,1865.69,0.0,505.0,           ,1.0,1.0,185.0
6174,Muut,2019-01-20 16:00:00.000000000,2019-01-20,2019-01-20,2019-01-20,7.0,-240.4,1625.29,0.0,163.0,           ,1.0,1.0,174.0
6175,Tulot,2019-01-21 06:56:00.000000000,2019-01-21,2019-01-21,2019-01-21,7.0,255.47,1880.76,0.0,505.0,           ,1.0,1.0,185.0
6176,Muut,2019-01-24 01:04:00.000000000,2019-01-24,2019-01-24,2019-01-24,7.0,-130.81,1749.95,0.0,106.0,OKOYFIHH   ,0.0,0.0,30.0
6177,Matkailu,2019-01-24 10:08:00.000000000,2019-01-24,2019-01-24,2019-01-24,7.0,-250.8,1499.15,0.0,163.0,           ,1.0,1.0,174.0
6178,Vakuutukset,2019-01-25 19:12:00.000000000,2019-01-25,2019-01-25,2019-01-25,7.0,-44.58,1454.57,0.0,106.0,DABAFIHH   ,0.0,0.0,35.0
6179,Ruoka_paivittaistavarakauppa,2019-01-28 04:16:00.000000000,2019-01-28,2019-01-28,2019-01-28,7.0,-21.11,1433.46,0.0,162.0,           ,1.0,1.0,142.0
6180,Muut,2019-01-29 13:20:00.000000000,2019-01-29,2019-01-29,2019-01-29,7.0,-274.43,1159.03,0.0,163.0,           ,1.0,1.0,173.0
6181,Tulot,2019-01-29 22:24:00.000000000,2019-01-29,2019-01-29,2019-01-29,7.0,743.77,1902.8,0.0,505.0,           ,1.0,1.0,185.0
6182,Luottojen_maksut,2019-01-31 07:28:00.000000000,2019-01-31,2019-01-31,2019-01-31,7.0,-500.79,1402.01,0.0,172.0,           ,1.0,1.0,183.0
6183,Vakuutukset,2019-02-01 05:45:36.000000000,2019-02-01,2019-02-01,2019-02-01,7.0,-92.07,1309.94,0.0,106.0,OKOYFIHH   ,0.0,0.0,9.0
6184,Luottojen_maksut,2019-02-01 16:30:43.200000000,2019-02-01,2019-02-01,2019-02-01,7.0,-189.51,1120.43,0.0,106.0,OKOYFIHH   ,0.0,0.0,22.0
6185,Tulot,2019-02-01 21:30:14.400000000,2019-02-01,2019-02-01,2019-02-01,7.0,947.11,2067.54,701.0,520.0,           ,1.0,1.0,198.0
6186,Lapset,2019-02-03 08:15:21.600000000,2019-02-03,2019-02-03,2019-02-03,7.0,-6.26,2061.28,0.0,106.0,OKOYFIHH   ,0.0,0.0,8.0
6187,Tulot,2019-02-04 03:15:50.400000000,2019-02-04,2019-02-04,2019-02-04,7.0,1043.75,3105.03,0.0,505.0,           ,1.0,1.0,185.0
6188,Tulot,2019-02-04 09:01:26.400000000,2019-02-04,2019-02-04,2019-02-04,7.0,563.27,3668.3,0.0,505.0,           ,1.0,1.0,186.0
6189,Ruoka_paivittaistavarakauppa,2019-02-04 10:45:07.200000000,2019-02-04,2019-02-04,2019-02-04,7.0,-37.56,3630.74,0.0,162.0,           ,1.0,1.0,124.0
6190,Luokittelemattomat,2019-02-04 14:00:57.600000000,2019-02-04,2019-02-04,2019-02-04,7.0,-13.25,3617.49,0.0,106.0,OKOYFIHH   ,1.0,0.0,9.0
6191,Lapset,2019-02-04 19:00:28.800000000,2019-02-04,2019-02-04,2019-02-04,7.0,-7.65,3609.84,0.0,106.0,OKOYFIHH   ,0.0,0.0,8.0
6192,Tulot,2019-02-04 19:46:33.600000000,2019-02-04,2019-02-04,2019-02-04,7.0,1217.82,4827.66,0.0,505.0,           ,1.0,1.0,186.0
6193,Tulot,2019-02-05 00:46:04.800000000,2019-02-05,2019-02-06,2019-02-05,7.0,3122.95,7950.61,710.0,506.0,           ,1.0,1.0,228.0
6194,Tulot,2019-02-05 11:31:12.000000000,2019-02-05,2019-02-05,2019-02-05,7.0,1945.63,9896.24,710.0,506.0,           ,1.0,1.0,230.0
6195,Luottojen_maksut,2019-02-05 22:16:19.200000000,2019-02-05,2019-02-05,2019-02-05,7.0,-618.81,9277.43,0.0,106.0,DABAFIHH   ,0.0,0.0,20.0
6196,Muut,2019-02-07 06:31:40.800000000,2019-02-07,2019-02-07,2019-02-07,7.0,-146.48,9130.95,0.0,163.0,           ,1.0,1.0,173.0
6197,Muut,2019-02-08 01:32:09.600000000,2019-02-08,2019-02-08,2019-02-08,7.0,-71.26,9059.69,0.0,163.0,           ,1.0,1.0,173.0
6198,Muut,2019-02-08 04:01:55.200000000,2019-02-08,2019-02-08,2019-02-08,7.0,-355.95,8703.74,0.0,163.0,           ,1.0,1.0,173.0
6199,Muut,2019-02-08 14:47:02.400000000,2019-02-08,2019-02-08,2019-02-08,7.0,-148.26,8555.48,0.0,163.0,           ,1.0,1.0,173.0
6200,Luokittelemattomat,2019-02-08 17:16:48.000000000,2019-02-08,2019-02-08,2019-02-08,7.0,-79.49,8475.99,0.0,106.0,OKOYFIHH   ,0.0,0.0,34.0
6201,Tulot,2019-02-11 07:17:45.600000000,2019-02-11,2019-02-11,2019-02-11,7.0,1325.88,9801.87,0.0,505.0,           ,1.0,1.0,185.0
6202,Muut,2019-02-11 09:47:31.200000000,2019-02-11,2019-02-11,2019-02-11,7.0,-41.18,9760.69,0.0,162.0,           ,1.0,1.0,82.0
6203,Ruoka_paivittaistavarakauppa,2019-02-11 12:17:16.800000000,2019-02-11,2019-02-11,2019-02-11,7.0,-5.74,9754.95,0.0,162.0,           ,1.0,1.0,92.0
6204,Ruoka_paivittaistavarakauppa,2019-02-11 18:02:52.800000000,2019-02-11,2019-02-11,2019-02-11,7.0,-0.86,9754.09,0.0,162.0,           ,1.0,1.0,48.0
6205,Terveys,2019-02-11 23:02:24.000000000,2019-02-11,2019-02-11,2019-02-11,7.0,-264.92,9489.17,0.0,162.0,           ,1.0,1.0,100.0
6206,Ruoka_paivittaistavarakauppa,2019-02-12 04:48:00.000000000,2019-02-12,2019-02-12,2019-02-12,7.0,-4.57,9484.6,0.0,162.0,           ,1.0,1.0,40.0
6207,Muut,2019-02-12 13:03:21.600000000,2019-02-12,2019-02-12,2019-02-12,7.0,-191.2,9293.4,0.0,163.0,           ,1.0,1.0,174.0
6208,Asuminen,2019-02-12 20:32:38.400000000,2019-02-12,2019-02-12,2019-02-12,7.0,-193.0,9100.4,0.0,162.0,           ,1.0,1.0,156.0
6209,Harrastukset,2019-02-13 02:18:14.400000000,2019-02-13,2019-02-13,2019-02-13,7.0,-29.44,9070.96,0.0,106.0,OKOYFIHH   ,0.0,0.0,8.0
6210,Tulot,2019-02-13 21:18:43.200000000,2019-02-13,2019-02-13,2019-02-13,7.0,59.23,9130.19,0.0,505.0,           ,1.0,1.0,185.0
6211,Tulot,2019-02-13 23:48:28.800000000,2019-02-13,2019-02-13,2019-02-13,7.0,236.66,9366.85,0.0,505.0,           ,1.0,1.0,187.0
6212,Tulot,2019-02-15 05:34:04.800000000,2019-02-15,2019-02-15,2019-02-15,7.0,45.8,9412.65,710.0,506.0,           ,1.0,1.0,227.0
6213,Tulot,2019-02-15 08:03:50.400000000,2019-02-15,2019-02-15,2019-02-15,7.0,37.07,9449.72,710.0,506.0,           ,1.0,1.0,230.0
6214,Tulot,2019-02-15 10:33:36.000000000,2019-02-15,2019-02-15,2019-02-15,7.0,1.47,9451.19,0.0,505.0,           ,1.0,1.0,186.0
6215,Muut,2019-02-15 15:33:07.200000000,2019-02-15,2019-02-15,2019-02-15,7.0,-6.49,9444.7,0.0,103.0,           ,0.0,1.0,2.0
6216,Muut,2019-02-15 16:19:12.000000000,2019-02-15,2019-02-15,2019-02-15,7.0,-70.96,9373.74,0.0,163.0,           ,1.0,1.0,173.0
6217,Luokittelemattomat,2019-02-18 00:34:33.600000000,2019-02-18,2019-02-18,2019-02-18,7.0,-158.21,9215.53,0.0,106.0,NDEAFIHH   ,0.0,0.0,32.0
6218,Luottojen_maksut,2019-02-18 03:04:19.200000000,2019-02-18,2019-02-18,2019-02-18,7.0,-527.96,8687.57,0.0,172.0,           ,1.0,1.0,182.0
6219,Luottojen_maksut,2019-02-18 11:19:40.800000000,2019-02-18,2019-02-18,2019-02-18,7.0,-47.19,8640.38,0.0,106.0,DABAFIHH   ,1.0,0.0,8.0
6220,Luokittelemattomat,2019-02-18 13:49:26.400000000,2019-02-18,2019-02-18,2019-02-18,7.0,-48.09,8592.29,0.0,172.0,           ,1.0,1.0,181.0
6221,Hyvinvointi,2019-02-18 18:48:57.600000000,2019-02-18,2019-02-18,2019-02-18,7.0,-25.33,8566.96,0.0,162.0,           ,1.0,1.0,42.0
6222,Ravintolat_kahvilat,2019-02-18 22:04:48.000000000,2019-02-18,2019-02-18,2019-02-18,7.0,-120.0,8446.96,0.0,106.0,OKOYFIHH   ,0.0,0.0,10.0
6223,Muut,2019-02-19 03:50:24.000000000,2019-02-19,2019-02-19,2019-02-19,7.0,-68.11,8378.85,0.0,103.0,           ,0.0,1.0,1.0
6224,Ruoka_paivittaistavarakauppa,2019-02-19 06:20:09.600000000,2019-02-19,2019-02-19,2019-02-19,7.0,-13.34,8365.51,0.0,162.0,           ,1.0,1.0,109.0
6225,Ravintolat_kahvilat,2019-02-19 19:35:02.400000000,2019-02-19,2019-02-19,2019-02-19,7.0,-26.58,8338.93,0.0,162.0,           ,1.0,1.0,136.0
6226,Tulot,2019-02-20 08:49:55.200000000,2019-02-20,2019-02-20,2019-02-20,7.0,132.69,8471.62,701.0,521.0,           ,1.0,1.0,203.0
6227,Muut,2019-02-21 17:05:16.800000000,2019-02-21,2019-02-21,2019-02-21,7.0,-402.68,8068.94,0.0,163.0,           ,1.0,1.0,173.0
6228,Asuminen,2019-02-21 22:50:52.800000000,2019-02-21,2019-02-21,2019-02-21,7.0,-11.83,8057.11,0.0,106.0,OKOYFIHH   ,0.0,0.0,8.0
6229,Muut,2019-02-22 01:20:38.400000000,2019-02-22,2019-02-22,2019-02-22,7.0,-307.85,7749.26,0.0,163.0,           ,1.0,1.0,173.0
6230,Tulot,2019-02-22 12:05:45.600000000,2019-02-22,2019-02-22,2019-02-22,7.0,3512.52,11261.78,0.0,505.0,           ,1.0,1.0,187.0
6231,Tulot,2019-02-22 14:35:31.200000000,2019-02-22,2019-02-22,2019-02-22,7.0,348.71,11610.49,710.0,506.0,           ,1.0,1.0,228.0
6232,Tulot,2019-02-23 20:21:07.200000000,2019-02-23,2019-02-23,2019-02-23,7.0,35.7,11646.19,0.0,506.0,           ,1.0,1.0,193.0
6233,Luokittelemattomat,2019-02-24 02:06:43.200000000,2019-02-24,2019-02-24,2019-02-24,7.0,-362.65,11283.54,0.0,106.0,NDEAFIHH   ,1.0,0.0,10.0
6234,Muut,2019-02-24 07:06:14.400000000,2019-02-24,2019-02-24,2019-02-24,7.0,-722.16,10561.38,0.0,105.0,OKOYFIHH   ,1.0,0.0,4.0
6235,Lemmikit,2019-02-24 15:21:36.000000000,2019-02-24,2019-02-24,2019-02-24,7.0,-16.38,10545.0,0.0,106.0,OKOYFIHH   ,0.0,0.0,32.0
6236,Tulot,2019-02-25 09:36:00.000000000,2019-02-25,2019-02-25,2019-02-25,7.0,120.38,10665.38,710.0,588.0,           ,0.0,1.0,235.0
6237,Terveys,2019-02-25 18:37:26.400000000,2019-02-25,2019-02-25,2019-02-25,7.0,-11.3,10654.08,0.0,106.0,OKOYFIHH   ,0.0,0.0,20.0
6238,Luokittelemattomat,2019-02-26 04:36:28.800000000,2019-02-26,2019-02-26,2019-02-26,7.0,-1391.56,9262.52,0.0,106.0,HELSFIHH   ,0.0,0.0,36.0
6239,Tulot,2019-02-26 12:51:50.400000000,2019-02-26,2019-02-26,2019-02-26,7.0,161.24,9423.76,710.0,506.0,           ,1.0,1.0,233.0
6240,Lemmikit,2019-02-26 21:07:12.000000000,2019-02-26,2019-02-26,2019-02-26,7.0,-39.52,9384.24,0.0,106.0,OKOYFIHH   ,0.0,0.0,23.0
6241,Luokittelemattomat,2019-02-27 07:52:19.200000000,2019-02-27,2019-02-27,2019-02-27,7.0,-82.2,9302.04,0.0,106.0,OKOYFIHH   ,1.0,0.0,20.0
6242,Muut,2019-02-27 10:22:04.800000000,2019-02-27,2019-02-27,2019-02-27,7.0,-817.03,8485.01,0.0,105.0,OKOYFIHH   ,1.0,0.0,7.0
6243,Tulot,2019-02-27 17:51:21.600000000,2019-02-27,2019-02-27,2019-02-27,7.0,447.23,8932.24,710.0,506.0,           ,1.0,1.0,232.0
6244,Asuminen,2019-02-27 23:36:57.600000000,2019-02-27,2019-02-27,2019-02-27,7.0,-49.37,8882.87,0.0,129.0,NDEAFIHH   ,0.0,0.0,39.0
6245,Harrastukset,2019-03-01 00:00:00.000000000,2019-03-01,2019-03-01,2019-03-01,7.0,-149.98,8732.89,0.0,106.0,OKOYFIHH   ,0.0,0.0,34.0
6246,Luottojen_maksut,2019-03-01 16:00:00.000000000,2019-03-01,2019-03-01,2019-03-01,7.0,-385.06,8347.83,0.0,172.0,           ,1.0,1.0,184.0
6247,Muut,2019-03-02 08:00:00.000000000,2019-03-02,2019-03-02,2019-03-02,7.0,-61.91,8285.92,0.0,163.0,           ,1.0,1.0,174.0
6248,Tulot,2019-03-04 08:00:00.000000000,2019-03-04,2019-03-04,2019-03-04,7.0,15.67,8301.59,710.0,506.0,           ,1.0,1.0,234.0
6249,Ravintolat_kahvilat,2019-03-04 16:00:00.000000000,2019-03-04,2019-03-04,2019-03-04,7.0,-9.46,8292.13,0.0,162.0,           ,1.0,1.0,41.0
6250,Tulot,2019-03-05 00:00:00.000000000,2019-03-05,2019-03-05,2019-03-05,7.0,22.77,8314.9,710.0,506.0,           ,1.0,1.0,228.0
6251,Luokittelemattomat,2019-03-05 16:00:00.000000000,2019-03-05,2019-03-05,2019-03-05,7.0,-36.46,8278.44,0.0,106.0,OKOYFIHH   ,1.0,0.0,37.0
6252,Ruoka_paivittaistavarakauppa,2019-03-06 00:00:00.000000000,2019-03-06,2019-03-06,2019-03-06,7.0,-15.38,8263.06,0.0,106.0,OKOYFIHH   ,0.0,0.0,20.0
6253,Asuminen,2019-03-07 00:00:00.000000000,2019-03-07,2019-03-07,2019-03-07,7.0,-7.36,8255.7,0.0,162.0,           ,1.0,1.0,40.0
6254,Luottojen_maksut,2019-03-07 08:00:00.000000000,2019-03-07,2019-03-08,2019-03-07,7.0,-1232.04,7023.66,0.0,106.0,NDEAFIHH   ,0.0,0.0,35.0
6255,Asuminen,2019-03-07 08:00:00.000000000,2019-03-07,2019-03-07,2019-03-07,7.0,-342.54,6681.12,0.0,106.0,OKOYFIHH   ,0.0,0.0,24.0
6256,Luokittelemattomat,2019-03-07 16:00:00.000000000,2019-03-07,2019-03-07,2019-03-07,7.0,-123.82,6557.3,0.0,106.0,OKOYFIHH   ,1.0,0.0,12.0
6257,Ruoka_paivittaistavarakauppa,2019-03-08 16:00:00.000000000,2019-03-08,2019-03-08,2019-03-08,7.0,-2.6,6554.7,0.0,162.0,           ,1.0,1.0,67.0
6258,Luokittelemattomat,2019-03-11 00:00:00.000000000,2019-03-11,2019-03-11,2019-03-11,7.0,-420.39,6134.31,0.0,106.0,OKOYFIHH   ,1.0,0.0,33.0
6259,Luokittelemattomat,2019-03-11 08:00:00.000000000,2019-03-11,2019-03-11,2019-03-11,7.0,-9.9,6124.41,0.0,162.0,           ,1.0,1.0,83.0
6260,Asuminen,2019-03-11 08:00:00.000000000,2019-03-11,2019-03-11,2019-03-11,7.0,-75.19,6049.22,0.0,106.0,DABAFIHH   ,0.0,0.0,29.0
6261,Tulot,2019-03-11 16:00:00.000000000,2019-03-11,2019-03-11,2019-03-11,7.0,-29.99,6019.23,0.0,106.0,DABAFIHH   ,0.0,0.0,15.0
6262,Luottojen_maksut,2019-03-12 00:00:00.000000000,2019-03-12,2019-03-12,2019-03-12,7.0,-366.51,5652.72,0.0,172.0,           ,1.0,1.0,182.0
6263,Muut,2019-03-13 16:00:00.000000000,2019-03-13,2019-03-13,2019-03-13,7.0,-54.54,5598.18,0.0,163.0,           ,1.0,1.0,173.0
6264,Liikkuminen,2019-03-14 16:00:00.000000000,2019-03-14,2019-03-14,2019-03-14,7.0,-10.4,5587.78,0.0,162.0,           ,1.0,1.0,69.0
6265,Ruoka_paivittaistavarakauppa,2019-03-15 00:00:00.000000000,2019-03-15,2019-03-15,2019-03-15,7.0,-10.63,5577.15,0.0,162.0,           ,1.0,1.0,119.0
6266,Tulot,2019-03-15 08:00:00.000000000,2019-03-15,2019-03-15,2019-03-15,7.0,108.83,5685.98,701.0,506.0,           ,1.0,1.0,194.0
6267,Matkailu,2019-03-15 08:00:00.000000000,2019-03-15,2019-03-15,2019-03-15,7.0,-465.2,5220.78,0.0,106.0,OKOYFIHH   ,0.0,0.0,27.0
6268,Muut,2019-03-17 00:00:00.000000000,2019-03-17,2019-03-17,2019-03-17,7.0,-218.16,5002.62,0.0,163.0,           ,1.0,1.0,173.0
6269,Lapset,2019-03-18 08:00:00.000000000,2019-03-18,2019-03-18,2019-03-18,7.0,-15.9,4986.72,0.0,162.0,           ,1.0,1.0,118.0
6270,Ruoka_paivittaistavarakauppa,2019-03-18 16:00:00.000000000,2019-03-18,2019-03-18,2019-03-18,7.0,-104.52,4882.2,0.0,162.0,           ,1.0,1.0,43.0
6271,Liikkuminen,2019-03-19 00:00:00.000000000,2019-03-19,2019-03-19,2019-03-19,7.0,-31.43,4850.77,0.0,162.0,           ,1.0,1.0,126.0
6272,Luokittelemattomat,2019-03-19 16:00:00.000000000,2019-03-19,2019-03-19,2019-03-19,7.0,-11.01,4839.76,0.0,162.0,           ,1.0,1.0,169.0
6273,Luottojen_maksut,2019-03-20 00:00:00.000000000,2019-03-20,2019-03-20,2019-03-20,7.0,-60.59,4779.17,0.0,172.0,           ,1.0,1.0,181.0
6274,Liikkuminen,2019-03-20 08:00:00.000000000,2019-03-20,2019-03-20,2019-03-20,7.0,-20.65,4758.52,0.0,162.0,           ,1.0,1.0,112.0
6275,Tulot,2019-03-20 16:00:00.000000000,2019-03-20,2019-03-20,2019-03-20,7.0,405.2,5163.72,701.0,506.0,           ,1.0,1.0,194.0
6276,Hyvinvointijakauneus,2019-03-22 16:00:00.000000000,2019-03-22,2019-03-22,2019-03-22,7.0,-917.92,4245.8,0.0,106.0,OKOYFIHH   ,0.0,0.0,20.0
6277,Asuminen,2019-03-23 00:00:00.000000000,2019-03-23,2019-03-23,2019-03-23,7.0,-366.41,3879.39,0.0,106.0,OKOYFIHH   ,0.0,0.0,35.0
6278,Liikkuminen,2019-03-23 08:00:00.000000000,2019-03-23,2019-03-23,2019-03-23,7.0,-1554.64,2324.75,0.0,106.0,ITELFIHH   ,1.0,0.0,12.0
6279,Muut,2019-03-25 00:00:00.000000000,2019-03-25,2019-03-25,2019-03-25,7.0,-12.01,2312.74,0.0,103.0,           ,0.0,1.0,3.0
6280,Tulot,2019-03-25 08:00:00.000000000,2019-03-25,2019-03-28,2019-03-25,7.0,3360.07,5672.81,710.0,506.0,           ,1.0,1.0,228.0
6281,Ruoka_paivittaistavarakauppa,2019-03-26 08:00:00.000000000,2019-03-22,2019-03-26,2019-03-26,7.0,-11.42,5661.39,0.0,162.0,           ,1.0,1.0,143.0
6282,Lemmikit,2019-03-26 16:00:00.000000000,2019-03-26,2019-03-26,2019-03-26,7.0,-18.16,5643.23,0.0,106.0,OKOYFIHH   ,0.0,0.0,20.0
6283,Ruoka_paivittaistavarakauppa,2019-03-27 00:00:00.000000000,2019-03-27,2019-03-27,2019-03-27,7.0,-6.89,5636.34,0.0,162.0,           ,1.0,1.0,107.0
6284,Ruoka_paivittaistavarakauppa,2019-03-27 16:00:00.000000000,2019-03-27,2019-03-27,2019-03-27,7.0,-18.26,5618.08,0.0,162.0,           ,1.0,1.0,105.0
6285,Luottojen_maksut,2019-03-28 00:00:00.000000000,2019-03-28,2019-03-28,2019-03-28,7.0,-23.81,5594.27,0.0,106.0,NDEAFIHH   ,0.0,0.0,23.0
6286,Ruoka_paivittaistavarakauppa,2019-03-28 08:00:00.000000000,2019-03-28,2019-03-28,2019-03-28,7.0,-37.45,5556.82,0.0,162.0,           ,1.0,1.0,94.0
6287,Liikkuminen,2019-03-29 00:00:00.000000000,2019-03-29,2019-03-29,2019-03-29,7.0,-12.03,5544.79,0.0,162.0,           ,1.0,1.0,145.0
6288,Ruoka_paivittaistavarakauppa,2019-03-29 08:00:00.000000000,2019-03-29,2019-03-29,2019-03-29,7.0,-18.23,5526.56,0.0,162.0,           ,1.0,1.0,112.0
6289,Luottojen_maksut,2019-03-29 16:00:00.000000000,2019-03-29,2019-03-29,2019-03-29,7.0,-25.65,5500.91,0.0,106.0,NDEAFIHH   ,1.0,0.0,21.0
6290,Matkailu,2019-03-29 16:00:00.000000000,2019-03-29,2019-03-29,2019-03-29,7.0,-55.34,5445.57,0.0,162.0,           ,1.0,1.0,156.0
6291,Luottojen_maksut,2019-04-05 12:42:21.176470588,2019-04-05,2019-04-05,2019-04-05,7.0,-4451.6,993.97,0.0,172.0,           ,1.0,1.0,182.0
6292,Luottojen_maksut,2019-04-08 01:24:42.352941176,2019-04-08,2019-04-08,2019-04-08,7.0,-434.74,559.23,0.0,172.0,           ,1.0,1.0,183.0
6293,Matkailu,2019-04-11 14:07:03.529411764,2019-04-11,2019-04-11,2019-04-11,7.0,-22.86,536.37,0.0,106.0,NDEAFIHH   ,0.0,0.0,18.0
6294,Ruoka_paivittaistavarakauppa,2019-04-15 02:49:24.705882352,2019-04-15,2019-04-15,2019-04-15,7.0,-12.74,523.63,0.0,162.0,           ,1.0,1.0,112.0
6295,Ruoka_paivittaistavarakauppa,2019-04-18 15:31:45.882352940,2019-04-18,2019-04-18,2019-04-18,7.0,-7.43,516.2,0.0,162.0,           ,1.0,1.0,60.0
6296,Asuminen,2019-04-22 04:14:07.058823528,2019-04-22,2019-04-22,2019-04-22,7.0,-15.21,500.99,706.0,129.0,OKOYFIHH   ,0.0,0.0,217.0
6297,Ruoka_paivittaistavarakauppa,2019-04-24 16:56:28.235294116,2019-04-24,2019-04-24,2019-04-24,7.0,-22.67,478.32,0.0,162.0,           ,1.0,1.0,154.0
6298,Luokittelemattomat,2019-04-29 05:38:49.411764704,2019-04-29,2019-04-29,2019-04-29,7.0,-14.62,463.7,0.0,162.0,           ,1.0,1.0,74.0
6299,Vakuutukset,2019-05-01 22:12:32.238805970,2019-05-01,2019-05-01,2019-05-01,7.0,-210.25,253.45,706.0,129.0,DABAFIHH   ,0.0,0.0,213.0
6300,Ravintolat_kahvilat,2019-05-02 20:25:04.477611940,2019-05-02,2019-05-02,2019-05-02,7.0,-2.03,251.42,0.0,162.0,           ,1.0,1.0,65.0
6301,Asuminen,2019-05-03 16:50:08.955223880,2019-05-03,2019-05-03,2019-05-03,7.0,-165.23,86.19,0.0,162.0,           ,1.0,1.0,41.0
6302,Ruoka_paivittaistavarakauppa,2019-05-03 18:37:36.716417910,2019-05-03,2019-05-03,2019-05-03,7.0,-4.23,81.96,0.0,162.0,           ,1.0,1.0,147.0
6303,Tulot,2019-05-05 13:15:13.432835820,2019-05-05,2019-05-05,2019-05-05,7.0,42.36,124.32,0.0,505.0,           ,1.0,1.0,186.0
6304,Asuminen,2019-05-06 15:02:41.194029850,2019-05-06,2019-05-07,2019-05-06,7.0,-6.64,117.68,0.0,162.0,           ,1.0,1.0,90.0
6305,Muut,2019-05-08 11:27:45.671641790,2019-05-08,2019-05-08,2019-05-08,7.0,-170.3,-52.62,0.0,163.0,           ,1.0,1.0,173.0
6306,Ruoka_paivittaistavarakauppa,2019-05-09 06:05:22.388059700,2019-05-09,2019-05-09,2019-05-09,7.0,-13.94,-66.56,0.0,162.0,           ,1.0,1.0,156.0
6307,Ruoka_paivittaistavarakauppa,2019-05-09 07:52:50.149253730,2019-05-09,2019-05-10,2019-05-09,7.0,-3.27,-69.83,0.0,162.0,           ,1.0,1.0,67.0
6308,Tulot,2019-05-10 09:40:17.910447760,2019-05-10,2019-05-10,2019-05-10,7.0,592.2,522.37,710.0,588.0,           ,0.0,1.0,235.0
6309,Ruoka_paivittaistavarakauppa,2019-05-13 00:42:59.104477610,2019-05-13,2019-05-13,2019-05-13,7.0,-16.86,505.51,0.0,162.0,           ,1.0,1.0,134.0
6310,Tulot,2019-05-13 02:30:26.865671640,2019-05-13,2019-05-13,2019-05-13,7.0,89.76,595.27,710.0,588.0,           ,0.0,1.0,235.0
6311,Hyvinvointijakauneus,2019-05-13 04:17:54.626865670,2019-05-13,2019-05-13,2019-05-13,7.0,-118.71,476.56,0.0,162.0,           ,1.0,1.0,99.0
6312,Ruoka_paivittaistavarakauppa,2019-05-13 22:55:31.343283580,2019-05-13,2019-05-13,2019-05-13,7.0,-32.1,444.46,0.0,162.0,           ,1.0,1.0,144.0
6313,Matkailu,2019-05-15 21:08:03.582089550,2019-05-15,2019-05-15,2019-05-15,7.0,-37.23,407.23,0.0,162.0,           ,1.0,1.0,109.0
6314,Luottojen_maksut,2019-05-16 15:45:40.298507460,2019-05-16,2019-05-16,2019-05-16,7.0,-73.11,334.12,0.0,162.0,           ,1.0,1.0,94.0
6315,Ruoka_paivittaistavarakauppa,2019-05-16 17:33:08.059701490,2019-05-16,2019-05-16,2019-05-16,7.0,-7.01,327.11,0.0,162.0,           ,1.0,1.0,156.0
6316,Lemmikit,2019-05-16 19:20:35.820895520,2019-05-16,2019-05-16,2019-05-16,7.0,-15.11,312.0,0.0,162.0,           ,1.0,1.0,42.0
6317,Hyvinvointi,2019-05-17 13:58:12.537313430,2019-05-17,2019-05-17,2019-05-17,7.0,-55.98,256.02,0.0,162.0,           ,1.0,1.0,140.0
6318,Lemmikit,2019-05-20 10:23:17.014925370,2019-05-20,2019-05-20,2019-05-20,7.0,-13.43,242.59,0.0,162.0,           ,1.0,1.0,117.0
6319,Asuminen,2019-05-20 12:10:44.776119400,2019-05-20,2019-05-20,2019-05-20,7.0,-9.08,233.51,706.0,129.0,OKOYFIHH   ,0.0,0.0,216.0
6320,Ruoka_paivittaistavarakauppa,2019-05-21 08:35:49.253731340,2019-05-21,2019-05-21,2019-05-21,7.0,-92.57,140.94,0.0,162.0,           ,1.0,1.0,129.0
6321,Ravintolat_kahvilat,2019-05-22 06:48:21.492537310,2019-05-22,2019-05-22,2019-05-22,7.0,-19.62,121.32,0.0,162.0,           ,1.0,1.0,112.0
6322,Tulot,2019-05-23 01:25:58.208955220,2019-05-23,2019-05-23,2019-05-23,7.0,4.35,125.67,710.0,588.0,           ,0.0,1.0,236.0
6323,Saastot_sijoitukset,2019-05-23 05:00:53.731343280,2019-05-23,2019-05-23,2019-05-23,7.0,-22.79,102.88,0.0,162.0,           ,1.0,1.0,101.0
6324,Matkailu,2019-05-24 03:13:25.970149250,2019-05-24,2019-05-24,2019-05-24,7.0,-3.58,99.3,706.0,129.0,OKOYFIHH   ,0.0,0.0,212.0
6325,Asuminen,2019-05-27 16:28:39.402985070,2019-05-27,2019-05-27,2019-05-27,7.0,-37.4,61.9,0.0,162.0,           ,1.0,1.0,164.0
6326,Ruoka_paivittaistavarakauppa,2019-05-27 20:03:34.925373130,2019-05-27,2019-05-27,2019-05-27,7.0,-29.21,32.69,0.0,162.0,           ,1.0,1.0,140.0
6327,Muut,2019-05-27 21:51:02.686567160,2019-05-27,2019-05-27,2019-05-27,7.0,-20.57,12.12,0.0,164.0,           ,1.0,1.0,178.0
6328,Ruoka_paivittaistavarakauppa,2019-05-27 23:38:30.447761190,2019-05-27,2019-05-27,2019-05-27,7.0,-7.02,5.1,0.0,162.0,           ,1.0,1.0,87.0
6329,Lapset,2019-05-28 18:16:07.164179100,2019-05-28,2019-05-30,2019-05-28,7.0,-11.8,-6.7,0.0,162.0,           ,1.0,1.0,156.0
6330,Matkailu,2019-05-30 14:41:11.641791040,2019-05-30,2019-05-30,2019-05-30,7.0,-2.78,-9.48,0.0,103.0,           ,0.0,1.0,1.0
6331,Shoppailu,2019-05-31 12:53:43.880597010,2019-05-31,2019-05-31,2019-05-31,7.0,-29.1,-38.58,706.0,129.0,NDEAFIHH   ,0.0,0.0,218.0
6332,Ruoka_paivittaistavarakauppa,2019-06-03 02:49:24.705882351,2019-06-03,2019-06-03,2019-06-03,7.0,-7.29,-45.87,0.0,162.0,           ,1.0,1.0,74.0
6333,Asuminen,2019-06-03 16:56:28.235294117,2019-06-03,2019-06-03,2019-06-03,7.0,-202.48,-248.35,706.0,129.0,OKOYFIHH   ,0.0,0.0,216.0
6334,Asuminen,2019-06-03 19:45:52.941176468,2019-06-03,2019-06-03,2019-06-03,7.0,-20.28,-268.63,706.0,129.0,OKOYFIHH   ,0.0,0.0,218.0
6335,Liikkuminen,2019-06-04 09:52:56.470588234,2019-06-04,2019-06-04,2019-06-04,7.0,-35.55,-304.18,0.0,162.0,           ,1.0,1.0,112.0
6336,Matkailu,2019-06-04 12:42:21.176470585,2019-06-04,2019-06-04,2019-06-04,7.0,-30.62,-334.8,706.0,129.0,NDEAFIHH   ,0.0,0.0,213.0
6337,Matkailu,2019-06-05 05:38:49.411764702,2019-06-05,2019-06-05,2019-06-05,7.0,-4.43,-339.23,0.0,170.0,           ,1.0,1.0,179.0
6338,Ruoka_paivittaistavarakauppa,2019-06-05 22:35:17.647058819,2019-06-05,2019-06-05,2019-06-05,7.0,-2.41,-341.64,0.0,162.0,           ,1.0,1.0,95.0
6339,Ruoka_paivittaistavarakauppa,2019-06-07 01:24:42.352941170,2019-06-07,2019-06-07,2019-06-07,7.0,-3.41,-345.05,0.0,162.0,           ,1.0,1.0,121.0
6340,Ruoka_paivittaistavarakauppa,2019-06-07 08:28:14.117647053,2019-06-07,2019-06-07,2019-06-07,7.0,-19.49,-364.54,0.0,162.0,           ,1.0,1.0,151.0
6341,Ruoka_paivittaistavarakauppa,2019-06-07 15:31:45.882352936,2019-06-07,2019-06-07,2019-06-07,7.0,-1.48,-366.02,0.0,162.0,           ,1.0,1.0,48.0
6342,Tulot,2019-06-07 18:21:10.588235287,2019-06-07,2019-06-07,2019-06-07,7.0,828.52,462.5,710.0,588.0,           ,0.0,1.0,236.0
6343,Muut,2019-06-07 21:10:35.294117638,2019-06-07,2019-06-07,2019-06-07,7.0,-5.47,457.03,0.0,103.0,           ,0.0,1.0,1.0
6344,Muut,2019-06-10 04:14:07.058823521,2019-06-10,2019-06-10,2019-06-10,7.0,-2.83,454.2,0.0,162.0,           ,1.0,1.0,101.0
6345,Liikkuminen,2019-06-10 11:17:38.823529404,2019-06-10,2019-06-10,2019-06-10,7.0,-59.6,394.6,0.0,162.0,           ,1.0,1.0,41.0
6346,Tulot,2019-06-11 14:07:03.529411755,2019-06-11,2019-06-11,2019-06-11,7.0,8.07,402.67,710.0,588.0,           ,0.0,1.0,236.0
6347,Muut,2019-06-12 07:03:31.764705872,2019-06-12,2019-06-12,2019-06-12,7.0,-45.04,357.63,0.0,163.0,           ,1.0,1.0,173.0
6348,Tulot,2019-06-12 23:59:59.999999989,2019-06-12,2019-06-12,2019-06-12,7.0,12.73,370.36,710.0,588.0,           ,0.0,1.0,235.0
6349,Tulot,2019-06-14 02:49:24.705882340,2019-06-14,2019-06-14,2019-06-14,7.0,13.08,383.44,710.0,588.0,           ,0.0,1.0,235.0
6350,Luokittelemattomat,2019-06-14 09:52:56.470588223,2019-06-14,2019-06-14,2019-06-14,7.0,-38.59,344.85,0.0,162.0,           ,1.0,1.0,165.0
6351,Ravintolat_kahvilat,2019-06-14 16:56:28.235294106,2019-06-14,2019-06-14,2019-06-14,7.0,-4.28,340.57,0.0,162.0,           ,1.0,1.0,42.0
6352,Tulot,2019-06-14 19:45:52.941176457,2019-06-14,2019-06-14,2019-06-14,7.0,45.35,385.92,710.0,588.0,           ,0.0,1.0,235.0
6353,Harrastukset,2019-06-17 05:38:49.411764691,2019-06-17,2019-06-17,2019-06-17,7.0,-33.88,352.04,706.0,129.0,OKOYFIHH   ,0.0,0.0,212.0
6354,Muut,2019-06-17 12:42:21.176470574,2019-06-17,2019-06-17,2019-06-17,7.0,-55.57,296.47,0.0,162.0,           ,1.0,1.0,117.0
6355,Ruoka_paivittaistavarakauppa,2019-06-17 22:35:17.647058808,2019-06-17,2019-06-17,2019-06-17,7.0,-43.09,253.38,0.0,162.0,           ,1.0,1.0,165.0
6356,Luokittelemattomat,2019-06-18 15:31:45.882352925,2019-06-18,2019-06-18,2019-06-18,7.0,-121.12,132.26,0.0,106.0,SBANFIHH   ,1.0,0.0,15.0
6357,Saastot_sijoitukset,2019-06-19 08:28:14.117647042,2019-06-19,2019-06-19,2019-06-19,7.0,-5.39,126.87,0.0,162.0,           ,1.0,1.0,82.0
6358,Ruoka_paivittaistavarakauppa,2019-06-20 01:24:42.352941159,2019-06-20,2019-06-20,2019-06-20,7.0,-19.13,107.74,0.0,162.0,           ,1.0,1.0,48.0
6359,Ruoka_paivittaistavarakauppa,2019-06-20 18:21:10.588235276,2019-06-20,2019-06-20,2019-06-20,7.0,-45.19,62.55,0.0,162.0,           ,1.0,1.0,134.0
6360,Muut,2019-06-21 04:14:07.058823510,2019-06-21,2019-06-21,2019-06-21,7.0,-0.16,62.39,0.0,103.0,           ,0.0,1.0,1.0
6361,Luokittelemattomat,2019-06-21 11:17:38.823529393,2019-06-21,2019-06-21,2019-06-21,7.0,-67.33,-4.94,706.0,129.0,OKOYFIHH   ,0.0,0.0,213.0
6362,Lapset,2019-06-24 07:03:31.764705861,2019-06-24,2019-06-24,2019-06-24,7.0,-16.8,-21.74,706.0,129.0,OKOYFIHH   ,0.0,0.0,212.0
6363,Tulot,2019-06-24 14:07:03.529411744,2019-06-24,2019-06-24,2019-06-24,7.0,-2.84,-24.58,706.0,147.0,OKOYFIHH   ,0.0,0.0,223.0
6364,Ravintolat_kahvilat,2019-06-24 21:10:35.294117627,2019-06-24,2019-06-24,2019-06-24,7.0,-10.24,-34.82,0.0,162.0,           ,1.0,1.0,55.0
6365,Ruoka_paivittaistavarakauppa,2019-06-24 23:59:59.999999978,2019-06-24,2019-06-24,2019-06-24,7.0,-8.96,-43.78,0.0,162.0,           ,1.0,1.0,42.0
6366,Tulot,2019-06-26 09:52:56.470588212,2019-06-26,2019-06-26,2019-06-26,7.0,44.68,0.9,710.0,588.0,           ,0.0,1.0,236.0
6367,Ruoka_paivittaistavarakauppa,2019-06-26 12:42:21.176470563,2019-06-26,2019-06-26,2019-06-26,7.0,-1.02,-0.12,0.0,162.0,           ,1.0,1.0,112.0
6368,Kulttuuri_viihde,2019-06-27 02:49:24.705882329,2019-06-27,2019-06-27,2019-06-27,7.0,-2.41,-2.53,0.0,162.0,           ,1.0,1.0,157.0
6369,Ruoka_paivittaistavarakauppa,2019-06-27 05:38:49.411764680,2019-06-27,2019-06-27,2019-06-27,7.0,-11.13,-13.66,0.0,162.0,           ,1.0,1.0,64.0
6370,Matkailu,2019-06-27 16:56:28.235294095,2019-06-27,2019-06-27,2019-06-27,7.0,-222.95,-236.61,0.0,100.0,           ,1.0,1.0,0.0
6371,Lemmikit,2019-06-27 19:45:52.941176446,2019-06-27,2019-06-27,2019-06-27,7.0,-8.19,-244.8,0.0,162.0,           ,1.0,1.0,78.0
6372,Ravintolat_kahvilat,2019-06-28 15:31:45.882352914,2019-06-28,2019-06-28,2019-06-28,7.0,-1.75,-246.55,0.0,162.0,           ,1.0,1.0,67.0
6373,Ruoka_paivittaistavarakauppa,2019-06-28 22:35:17.647058797,2019-06-28,2019-06-28,2019-06-28,7.0,-0.5,-247.05,0.0,162.0,           ,1.0,1.0,98.0
6374,Muut,2019-07-01 13:10:05.309734513,2019-07-01,2019-07-01,2019-07-01,7.0,-61.91,-308.96,0.0,163.0,           ,1.0,1.0,173.0
6375,Asuminen,2019-07-02 02:20:10.619469026,2019-07-02,2019-07-02,2019-07-02,7.0,-7.48,-316.44,706.0,129.0,NDEAFIHH   ,0.0,0.0,216.0
6376,Liikkuminen,2019-07-02 15:30:15.929203539,2019-07-02,2019-07-02,2019-07-02,7.0,-13.36,-329.8,706.0,129.0,OKOYFIHH   ,0.0,0.0,212.0
6377,Asuminen,2019-07-03 04:40:21.238938052,2019-07-03,2019-07-03,2019-07-03,7.0,-11.62,-341.42,706.0,129.0,OKOYFIHH   ,0.0,0.0,213.0
6378,Muut,2019-07-03 17:50:26.548672565,2019-07-03,2019-07-03,2019-07-03,7.0,-3.81,-345.23,0.0,170.0,           ,1.0,1.0,180.0
6379,Ruoka_paivittaistavarakauppa,2019-07-04 07:00:31.858407078,2019-07-04,2019-07-04,2019-07-04,7.0,-12.11,-357.34,0.0,162.0,           ,1.0,1.0,105.0
6380,Ruoka_paivittaistavarakauppa,2019-07-04 20:10:37.168141591,2019-07-04,2019-07-04,2019-07-04,7.0,-2.12,-359.46,0.0,162.0,           ,1.0,1.0,61.0
6381,Asuminen,2019-07-05 09:20:42.477876104,2019-07-05,2019-07-05,2019-07-05,7.0,-22.33,-381.79,706.0,129.0,OKOYFIHH   ,0.0,0.0,221.0
6382,Ruoka_paivittaistavarakauppa,2019-07-05 22:30:47.787610617,2019-07-05,2019-07-05,2019-07-05,7.0,-33.48,-415.27,0.0,162.0,           ,1.0,1.0,103.0
6383,Lemmikit,2019-07-08 00:50:58.407079643,2019-07-08,2019-07-08,2019-07-08,7.0,-11.2,-426.47,0.0,162.0,           ,1.0,1.0,43.0
6384,Asuminen,2019-07-08 03:11:09.026548669,2019-07-08,2019-07-08,2019-07-08,7.0,-98.21,-524.68,706.0,129.0,OKOYFIHH   ,0.0,0.0,214.0
6385,Ruoka_paivittaistavarakauppa,2019-07-08 11:40:53.097345130,2019-07-08,2019-07-08,2019-07-08,7.0,-2.15,-526.83,0.0,162.0,           ,1.0,1.0,85.0
6386,Ruoka_paivittaistavarakauppa,2019-07-08 14:01:03.716814156,2019-07-08,2019-07-08,2019-07-08,7.0,-3.65,-530.48,0.0,162.0,           ,1.0,1.0,116.0
6387,Luottojen_maksut,2019-07-08 16:21:14.336283182,2019-07-08,2019-07-08,2019-07-08,7.0,-62.33,-592.81,706.0,147.0,OKOYFIHH   ,0.0,0.0,223.0
6388,Ravintolat_kahvilat,2019-07-09 05:31:19.646017695,2019-07-09,2019-07-09,2019-07-09,7.0,-12.65,-605.46,0.0,162.0,           ,1.0,1.0,138.0
6389,Muut,2019-07-09 18:41:24.955752208,2019-07-09,2019-07-09,2019-07-09,7.0,-16.72,-622.18,0.0,163.0,           ,1.0,1.0,173.0
6390,Muut,2019-07-10 07:51:30.265486721,2019-07-10,2019-07-10,2019-07-10,7.0,-8.21,-630.39,706.0,147.0,OKOYFIHH   ,0.0,0.0,225.0
6391,Vakuutukset,2019-07-10 10:11:40.884955747,2019-07-10,2019-07-11,2019-07-09,7.0,-18.11,-648.5,706.0,147.0,OKOYFIHH   ,0.0,0.0,223.0
6392,Ruoka_paivittaistavarakauppa,2019-07-10 21:01:35.575221234,2019-07-10,2019-07-10,2019-07-10,7.0,-4.4,-652.9,0.0,162.0,           ,1.0,1.0,126.0
6393,Ruoka_paivittaistavarakauppa,2019-07-11 23:21:46.194690260,2019-07-11,2019-07-11,2019-07-11,7.0,-12.36,-665.26,0.0,162.0,           ,1.0,1.0,106.0
6394,Ruoka_paivittaistavarakauppa,2019-07-12 01:41:56.814159286,2019-07-12,2019-07-12,2019-07-12,7.0,-30.95,-696.21,0.0,162.0,           ,1.0,1.0,85.0
6395,Tulot,2019-07-12 12:31:51.504424773,2019-07-12,2019-07-12,2019-07-12,7.0,0.94,-695.27,710.0,588.0,           ,0.0,1.0,237.0
6396,Muut,2019-07-15 04:02:07.433628312,2019-07-15,2019-07-15,2019-07-15,7.0,-34.65,-729.92,0.0,163.0,           ,1.0,1.0,174.0
6397,Shoppailu,2019-07-15 06:22:18.053097338,2019-07-15,2019-07-15,2019-07-15,7.0,-14.56,-744.48,0.0,162.0,           ,1.0,1.0,42.0
6398,Ruoka_paivittaistavarakauppa,2019-07-15 11:02:39.292035390,2019-07-15,2019-07-15,2019-07-15,7.0,-1.29,-745.77,0.0,162.0,           ,1.0,1.0,92.0
6399,Ruoka_paivittaistavarakauppa,2019-07-15 14:52:02.123893799,2019-07-15,2019-07-15,2019-07-15,7.0,-6.42,-752.19,0.0,162.0,           ,1.0,1.0,109.0
6400,Muut,2019-07-15 17:12:12.743362825,2019-07-15,2019-07-15,2019-07-15,7.0,-62.84,-815.03,0.0,162.0,           ,1.0,1.0,84.0
6401,Ruoka_paivittaistavarakauppa,2019-07-15 19:32:23.362831851,2019-07-15,2019-07-16,2019-07-15,7.0,-6.6,-821.63,0.0,162.0,           ,1.0,1.0,165.0
6402,Ruoka_paivittaistavarakauppa,2019-07-16 08:42:28.672566364,2019-07-16,2019-07-16,2019-07-16,7.0,-13.56,-835.19,0.0,162.0,           ,1.0,1.0,136.0
6403,Luottojen_maksut,2019-07-16 21:52:33.982300877,2019-07-16,2019-07-16,2019-07-16,7.0,-7.26,-842.45,0.0,162.0,           ,1.0,1.0,85.0
6404,Ruoka_paivittaistavarakauppa,2019-07-18 00:12:44.601769903,2019-07-18,2019-07-18,2019-07-18,7.0,-10.2,-852.65,0.0,162.0,           ,1.0,1.0,74.0
6405,Saastot_sijoitukset,2019-07-18 13:22:49.911504416,2019-07-18,2019-07-18,2019-07-18,7.0,-12.09,-864.74,0.0,162.0,           ,1.0,1.0,94.0
6406,Ruoka_paivittaistavarakauppa,2019-07-19 02:32:55.221238929,2019-07-19,2019-07-19,2019-07-19,7.0,-2.97,-867.71,0.0,162.0,           ,1.0,1.0,70.0
6407,Ruoka_paivittaistavarakauppa,2019-07-19 04:53:05.840707955,2019-07-19,2019-07-19,2019-07-19,7.0,-6.89,-874.6,0.0,162.0,           ,1.0,1.0,105.0
6408,Luokittelemattomat,2019-07-19 15:43:00.530973442,2019-07-19,2019-07-19,2019-07-19,7.0,-2.78,-877.38,0.0,162.0,           ,1.0,1.0,111.0
6409,Ruoka_paivittaistavarakauppa,2019-07-19 18:03:11.150442468,2019-07-19,2019-07-19,2019-07-19,7.0,-3.07,-880.45,0.0,162.0,           ,1.0,1.0,61.0
6410,Liikkuminen,2019-07-22 07:13:16.460176981,2019-07-22,2019-07-22,2019-07-22,7.0,-2.66,-883.11,0.0,162.0,           ,1.0,1.0,69.0
6411,Ruoka_paivittaistavarakauppa,2019-07-22 09:33:27.079646007,2019-07-22,2019-07-22,2019-07-22,7.0,-6.63,-889.74,0.0,162.0,           ,1.0,1.0,85.0
6412,Ruoka_paivittaistavarakauppa,2019-07-22 20:23:21.769911494,2019-07-22,2019-07-22,2019-07-22,7.0,-9.39,-899.13,0.0,162.0,           ,1.0,1.0,161.0
6413,Matkailu,2019-07-22 22:43:32.389380520,2019-07-22,2019-07-22,2019-07-22,7.0,-23.83,-922.96,706.0,129.0,NDEAFIHH   ,0.0,0.0,216.0
6414,Luokittelemattomat,2019-07-23 11:53:37.699115033,2019-07-23,2019-07-23,2019-07-23,7.0,-2.19,-925.15,0.0,162.0,           ,1.0,1.0,48.0
6415,Asuminen,2019-07-24 16:33:58.938053085,2019-07-24,2019-07-24,2019-07-24,7.0,-7.11,-932.26,706.0,147.0,DABAFIHH   ,0.0,0.0,224.0
6416,Muut,2019-07-25 01:03:43.008849546,2019-07-25,2019-07-25,2019-07-25,7.0,-15.89,-948.15,0.0,163.0,           ,1.0,1.0,175.0
6417,Ruoka_paivittaistavarakauppa,2019-07-25 05:44:04.247787598,2019-07-25,2019-07-25,2019-07-25,7.0,-8.33,-956.48,0.0,162.0,           ,1.0,1.0,74.0
6418,Ravintolat_kahvilat,2019-07-26 03:23:53.628318572,2019-07-26,2019-07-26,2019-07-26,7.0,-2.0,-958.48,0.0,162.0,           ,1.0,1.0,171.0
6419,Ruoka_paivittaistavarakauppa,2019-07-26 08:04:14.867256624,2019-07-26,2019-07-26,2019-07-26,7.0,-3.46,-961.94,0.0,162.0,           ,1.0,1.0,112.0
6420,Ruoka_paivittaistavarakauppa,2019-07-26 14:13:48.318584059,2019-07-26,2019-07-26,2019-07-26,7.0,-2.22,-964.16,0.0,162.0,           ,1.0,1.0,83.0
6421,Ruoka_paivittaistavarakauppa,2019-07-26 18:54:09.557522111,2019-07-26,2019-07-26,2019-07-26,7.0,-3.22,-967.38,0.0,162.0,           ,1.0,1.0,112.0
6422,Liikkuminen,2019-07-26 21:14:20.176991137,2019-07-26,2019-07-26,2019-07-26,7.0,-39.49,-1006.87,0.0,162.0,           ,1.0,1.0,82.0
6423,Ruoka_paivittaistavarakauppa,2019-07-26 23:34:30.796460163,2019-07-26,2019-07-26,2019-07-26,7.0,-0.38,-1007.25,0.0,162.0,           ,1.0,1.0,92.0
6424,Saastot_sijoitukset,2019-07-29 10:24:25.486725650,2019-07-29,2019-07-29,2019-07-29,7.0,-18.77,-1026.02,0.0,162.0,           ,1.0,1.0,83.0
6425,Muut,2019-07-29 12:44:36.106194676,2019-07-29,2019-07-31,2019-07-29,7.0,-10.65,-1036.67,0.0,163.0,           ,1.0,1.0,173.0
6426,Liikkuminen,2019-07-30 01:54:41.415929189,2019-07-30,2019-07-30,2019-07-30,7.0,-11.23,-1047.9,0.0,162.0,           ,1.0,1.0,83.0
6427,Tulot,2019-07-30 15:04:46.725663702,2019-07-30,2019-07-30,2019-07-30,7.0,614.86,-433.04,701.0,521.0,           ,1.0,1.0,202.0
6428,Muut,2019-07-31 04:14:52.035398215,2019-07-31,2019-07-31,2019-07-31,7.0,-5.75,-438.79,0.0,106.0,OKOYFIHH   ,0.0,0.0,20.0
6429,Muut,2019-07-31 17:24:57.345132728,2019-07-31,2019-07-31,2019-07-31,7.0,-8.33,-447.12,0.0,105.0,OKOYFIHH   ,1.0,0.0,4.0
6430,Tulot,2019-08-01 22:12:32.238805970,2019-08-01,2019-08-02,2019-08-01,7.0,224.8,-222.32,701.0,520.0,           ,1.0,1.0,199.0
6431,Asuminen,2019-08-02 20:25:04.477611940,2019-08-02,2019-08-02,2019-08-02,7.0,-28.95,-251.27,0.0,106.0,NDEAFIHH   ,0.0,0.0,25.0
6432,Muut,2019-08-03 16:50:08.955223880,2019-08-03,2019-08-03,2019-08-03,7.0,-14.64,-265.91,0.0,163.0,           ,1.0,1.0,173.0
6433,Hyvinvointijakauneus,2019-08-03 18:37:36.716417910,2019-08-03,2019-08-03,2019-08-03,7.0,-15.69,-281.6,0.0,106.0,OKOYFIHH   ,0.0,0.0,20.0
6434,Ruoka_paivittaistavarakauppa,2019-08-05 13:15:13.432835820,2019-08-05,2019-08-05,2019-08-05,7.0,-1.21,-282.81,0.0,162.0,           ,1.0,1.0,40.0
6435,Kulttuuri_viihde,2019-08-05 15:02:41.194029850,2019-08-05,2019-08-05,2019-08-05,7.0,-5.08,-287.89,0.0,162.0,           ,1.0,1.0,156.0
6436,Asuminen,2019-08-07 11:27:45.671641790,2019-08-07,2019-08-07,2019-08-07,7.0,-13.81,-301.7,706.0,147.0,NDEAFIHH   ,0.0,0.0,223.0
6437,Kulttuuri_viihde,2019-08-08 06:05:22.388059700,2019-08-08,2019-08-08,2019-08-08,7.0,-0.53,-302.23,0.0,162.0,           ,1.0,1.0,40.0
6438,Ruoka_paivittaistavarakauppa,2019-08-08 09:40:17.910447760,2019-08-08,2019-08-08,2019-08-08,7.0,-4.38,-306.61,0.0,162.0,           ,1.0,1.0,124.0
6439,Ravintolat_kahvilat,2019-08-09 07:52:50.149253730,2019-08-09,2019-08-09,2019-08-09,7.0,-1.48,-308.09,0.0,162.0,           ,1.0,1.0,146.0
6440,Ravintolat_kahvilat,2019-08-12 02:30:26.865671640,2019-08-12,2019-08-12,2019-08-12,7.0,-7.53,-315.62,0.0,162.0,           ,1.0,1.0,44.0
6441,Kulttuuri_viihde,2019-08-12 04:17:54.626865670,2019-08-12,2019-08-12,2019-08-12,7.0,-49.12,-364.74,0.0,106.0,OKOYFIHH   ,0.0,0.0,28.0
6442,Ruoka_paivittaistavarakauppa,2019-08-13 21:08:03.582089550,2019-08-13,2019-08-13,2019-08-13,7.0,-2.47,-367.21,0.0,162.0,           ,1.0,1.0,103.0
6443,Asuminen,2019-08-13 22:55:31.343283580,2019-08-13,2019-08-13,2019-08-13,7.0,-29.14,-396.35,706.0,129.0,OKOYFIHH   ,0.0,0.0,213.0
6444,Ruoka_paivittaistavarakauppa,2019-08-14 00:42:59.104477610,2019-08-14,2019-08-14,2019-08-14,7.0,-4.04,-400.39,0.0,162.0,           ,1.0,1.0,150.0
6445,Ravintolat_kahvilat,2019-08-15 19:20:35.820895520,2019-08-15,2019-08-15,2019-08-15,7.0,-4.49,-404.88,0.0,162.0,           ,1.0,1.0,92.0
6446,Liikkuminen,2019-08-16 15:45:40.298507460,2019-08-16,2019-08-16,2019-08-16,7.0,-16.96,-421.84,0.0,106.0,OKOYFIHH   ,1.0,0.0,19.0
6447,Luokittelemattomat,2019-08-16 17:33:08.059701490,2019-08-16,2019-08-16,2019-08-16,7.0,-5.66,-427.5,0.0,106.0,OKOYFIHH   ,0.0,0.0,9.0
6448,Ravintolat_kahvilat,2019-08-19 12:10:44.776119400,2019-08-19,2019-08-19,2019-08-19,7.0,-0.75,-428.25,0.0,162.0,           ,1.0,1.0,123.0
6449,Ruoka_paivittaistavarakauppa,2019-08-19 13:58:12.537313430,2019-08-19,2019-08-19,2019-08-19,7.0,-4.97,-433.22,0.0,162.0,           ,1.0,1.0,69.0
6450,Muut,2019-08-20 10:23:17.014925370,2019-08-20,2019-08-20,2019-08-20,7.0,-3.15,-436.37,0.0,162.0,           ,1.0,1.0,165.0
6451,Lapset,2019-08-21 06:48:21.492537310,2019-08-21,2019-08-21,2019-08-21,7.0,-4.98,-441.35,0.0,162.0,           ,1.0,1.0,130.0
6452,Luokittelemattomat,2019-08-23 03:13:25.970149250,2019-08-23,2019-08-23,2019-08-23,7.0,-27.4,-468.75,0.0,106.0,OKOYFIHH   ,1.0,0.0,20.0
6453,Muut,2019-08-23 05:00:53.731343280,2019-08-23,2019-08-23,2019-08-23,7.0,-39.03,-507.78,0.0,163.0,           ,1.0,1.0,173.0
6454,Ruoka_paivittaistavarakauppa,2019-08-23 08:35:49.253731340,2019-08-23,2019-08-23,2019-08-23,7.0,-10.02,-517.8,0.0,162.0,           ,1.0,1.0,92.0
6455,Muut,2019-08-25 01:25:58.208955220,2019-08-25,2019-08-25,2019-08-25,7.0,-8.07,-525.87,0.0,163.0,           ,1.0,1.0,173.0
6456,Ruoka_paivittaistavarakauppa,2019-08-26 21:51:02.686567160,2019-08-26,2019-08-27,2019-08-26,7.0,-8.22,-534.09,0.0,162.0,           ,1.0,1.0,92.0
6457,Muut,2019-08-26 23:38:30.447761190,2019-08-26,2019-08-26,2019-08-26,7.0,-2.64,-536.73,0.0,162.0,           ,1.0,1.0,92.0
6458,Hyvinvointijakauneus,2019-08-27 20:03:34.925373130,2019-08-27,2019-08-27,2019-08-27,7.0,-0.93,-537.66,0.0,162.0,           ,1.0,1.0,159.0
6459,Asuminen,2019-08-28 18:16:07.164179100,2019-08-28,2019-08-28,2019-08-28,7.0,-24.03,-561.69,706.0,129.0,OKOYFIHH   ,0.0,0.0,212.0
6460,Ruoka_paivittaistavarakauppa,2019-08-29 12:53:43.880597010,2019-08-29,2019-08-29,2019-08-29,7.0,-5.28,-566.97,0.0,162.0,           ,1.0,1.0,123.0
6461,Muut,2019-08-29 14:41:11.641791040,2019-08-29,2019-08-30,2019-08-29,7.0,-6.77,-573.74,0.0,162.0,           ,1.0,1.0,74.0
6462,Muut,2019-08-30 16:28:39.402985070,2019-08-30,2019-08-30,2019-08-30,7.0,-14.67,-588.41,0.0,163.0,           ,1.0,1.0,175.0
6463,Vakuutukset,2019-09-02 08:00:00.000000000,2019-09-02,2019-09-02,2019-09-02,7.0,-9.15,-597.56,706.0,147.0,OKOYFIHH   ,0.0,0.0,222.0
6464,Ruoka_paivittaistavarakauppa,2019-09-03 16:00:00.000000000,2019-09-03,2019-09-03,2019-09-02,7.0,-1.01,-598.57,0.0,162.0,           ,1.0,1.0,132.0
6465,Liikkuminen,2019-09-06 00:00:00.000000000,2019-09-06,2019-09-06,2019-09-06,7.0,-1.3,-599.87,0.0,162.0,           ,1.0,1.0,117.0
6466,Hyvinvointijakauneus,2019-09-06 08:00:00.000000000,2019-09-06,2019-09-06,2019-09-06,7.0,-4.73,-604.6,0.0,162.0,           ,1.0,1.0,151.0
6467,Ruoka_paivittaistavarakauppa,2019-09-06 16:00:00.000000000,2019-09-06,2019-09-06,2019-09-06,7.0,-2.36,-606.96,0.0,162.0,           ,1.0,1.0,140.0
6468,Ruoka_paivittaistavarakauppa,2019-09-09 00:00:00.000000000,2019-09-09,2019-09-09,2019-09-09,7.0,-5.67,-612.63,0.0,162.0,           ,1.0,1.0,107.0
6469,Tulot,2019-09-10 08:00:00.000000000,2019-09-10,2019-09-10,2019-09-10,7.0,248.67,-363.96,710.0,506.0,           ,1.0,1.0,227.0
6470,Muut,2019-09-12 00:00:00.000000000,2019-09-12,2019-09-12,2019-09-12,7.0,-4.31,-368.27,0.0,162.0,           ,1.0,1.0,109.0
6471,Matkailu,2019-09-12 16:00:00.000000000,2019-09-12,2019-09-12,2019-09-12,7.0,-10.42,-378.69,706.0,147.0,OKOYFIHH   ,0.0,0.0,222.0
6472,Hyvinvointijakauneus,2019-09-13 08:00:00.000000000,2019-09-13,2019-09-13,2019-09-13,7.0,-20.76,-399.45,0.0,162.0,           ,1.0,1.0,84.0
6473,Lemmikit,2019-09-16 16:00:00.000000000,2019-09-16,2019-09-16,2019-09-16,7.0,-6.49,-405.94,0.0,162.0,           ,1.0,1.0,99.0
6474,Matkailu,2019-09-17 00:00:00.000000000,2019-09-17,2019-09-17,2019-09-17,7.0,-8.23,-414.17,0.0,103.0,           ,0.0,1.0,2.0
6475,Muut,2019-09-17 08:00:00.000000000,2019-09-17,2019-09-17,2019-09-17,7.0,-136.59,-550.76,706.0,147.0,OKOYFIHH   ,0.0,0.0,222.0
6476,Lemmikit,2019-09-19 16:00:00.000000000,2019-09-19,2019-09-19,2019-09-19,7.0,-2.97,-553.73,0.0,162.0,           ,1.0,1.0,92.0
6477,Ruoka_paivittaistavarakauppa,2019-09-20 00:00:00.000000000,2019-09-20,2019-09-20,2019-09-20,7.0,-37.68,-591.41,0.0,162.0,           ,1.0,1.0,105.0
6478,Ruoka_paivittaistavarakauppa,2019-09-23 00:00:00.000000000,2019-09-23,2019-09-23,2019-09-23,7.0,-7.39,-598.8,0.0,162.0,           ,1.0,1.0,107.0
6479,Ruoka_paivittaistavarakauppa,2019-09-23 08:00:00.000000000,2019-09-23,2019-09-23,2019-09-23,7.0,-3.2,-602.0,0.0,162.0,           ,1.0,1.0,100.0
6480,Asuminen,2019-09-23 16:00:00.000000000,2019-09-23,2019-09-24,2019-09-23,7.0,-8.5,-610.5,706.0,147.0,OKOYFIHH   ,0.0,0.0,224.0
6481,Liikkuminen,2019-09-26 08:00:00.000000000,2019-09-26,2019-09-26,2019-09-26,7.0,-2.54,-613.04,0.0,162.0,           ,1.0,1.0,165.0
6482,Ruoka_paivittaistavarakauppa,2019-09-27 00:00:00.000000000,2019-09-27,2019-09-27,2019-09-27,7.0,-2.5,-615.54,0.0,162.0,           ,1.0,1.0,143.0
6483,Matkailu,2019-09-27 16:00:00.000000000,2019-09-27,2019-09-27,2019-09-27,7.0,-8.76,-624.3,0.0,162.0,           ,1.0,1.0,44.0
6484,Asuminen,2019-09-30 08:00:00.000000000,2019-09-30,2019-09-30,2019-09-30,7.0,-364.72,-989.02,0.0,162.0,           ,1.0,1.0,148.0
6485,Tulot,2019-10-02 12:17:33.658536585,2019-10-02,2019-10-02,2019-10-02,7.0,1767.57,778.55,701.0,520.0,           ,1.0,1.0,200.0
6486,Matkailu,2019-10-04 00:35:07.317073170,2019-10-04,2019-10-04,2019-10-04,7.0,-29.22,749.33,0.0,162.0,           ,1.0,1.0,134.0
6487,Ruoka_paivittaistavarakauppa,2019-10-04 12:52:40.975609755,2019-10-04,2019-10-04,2019-10-04,7.0,-8.71,740.62,0.0,162.0,           ,1.0,1.0,85.0
6488,Ravintolat_kahvilat,2019-10-07 01:10:14.634146340,2019-10-07,2019-10-07,2019-10-07,7.0,-5.77,734.85,0.0,162.0,           ,1.0,1.0,51.0
6489,Matkailu,2019-10-08 13:27:48.292682925,2019-10-08,2019-10-08,2019-10-08,7.0,-52.9,681.95,706.0,147.0,OKOYFIHH   ,0.0,0.0,222.0
6490,Liikkuminen,2019-10-09 01:45:21.951219510,2019-10-09,2019-10-09,2019-10-09,7.0,-68.17,613.78,0.0,162.0,           ,1.0,1.0,48.0
6491,Hyvinvointijakauneus,2019-10-11 14:02:55.609756095,2019-10-11,2019-10-11,2019-10-11,7.0,-4.81,608.97,0.0,162.0,           ,1.0,1.0,98.0
6492,Ruoka_paivittaistavarakauppa,2019-10-14 02:20:29.268292680,2019-10-14,2019-10-14,2019-10-14,7.0,-15.03,593.94,0.0,162.0,           ,1.0,1.0,40.0
6493,Ruoka_paivittaistavarakauppa,2019-10-14 14:38:02.926829265,2019-10-14,2019-10-14,2019-10-14,7.0,-19.77,574.17,0.0,162.0,           ,1.0,1.0,98.0
6494,Ruoka_paivittaistavarakauppa,2019-10-16 02:55:36.585365850,2019-10-16,2019-10-16,2019-10-16,7.0,-2.78,571.39,0.0,162.0,           ,1.0,1.0,42.0
6495,Luokittelemattomat,2019-10-16 15:13:10.243902435,2019-10-16,2019-10-16,2019-10-16,7.0,-231.38,340.01,706.0,129.0,OKOYFIHH   ,0.0,0.0,219.0
6496,Ravintolat_kahvilat,2019-10-21 03:30:43.902439020,2019-10-21,2019-10-21,2019-10-21,7.0,-43.19,296.82,0.0,162.0,           ,1.0,1.0,172.0
6497,Ravintolat_kahvilat,2019-10-21 15:48:17.560975605,2019-10-21,2019-10-21,2019-10-21,7.0,-1.9,294.92,0.0,162.0,           ,1.0,1.0,74.0
6498,Liikkuminen,2019-10-22 04:05:51.219512190,2019-10-22,2019-10-22,2019-10-22,7.0,-10.12,284.8,0.0,162.0,           ,1.0,1.0,101.0
6499,Ravintolat_kahvilat,2019-10-23 16:23:24.878048775,2019-10-23,2019-10-23,2019-10-23,7.0,-19.61,265.19,0.0,162.0,           ,1.0,1.0,159.0
6500,Luottojen_maksut,2019-10-24 04:40:58.536585360,2019-10-24,2019-10-24,2019-10-24,7.0,-4.62,260.57,0.0,162.0,           ,1.0,1.0,67.0
6501,Luokittelemattomat,2019-10-25 16:58:32.195121945,2019-10-25,2019-10-25,2019-10-25,7.0,-5.85,254.72,0.0,162.0,           ,1.0,1.0,61.0
6502,Tulot,2019-10-28 05:16:05.853658530,2019-10-28,2019-10-28,2019-10-28,7.0,-16.43,238.29,706.0,147.0,OKOYFIHH   ,0.0,0.0,223.0
6503,Ruoka_paivittaistavarakauppa,2019-10-29 17:33:39.512195115,2019-10-29,2019-10-29,2019-10-29,7.0,-64.61,173.68,0.0,162.0,           ,1.0,1.0,45.0
6504,Kulttuuri_viihde,2019-10-31 05:51:13.170731700,2019-10-31,2019-10-31,2019-10-31,7.0,-1.55,172.13,0.0,162.0,           ,1.0,1.0,51.0
6505,Ruoka_paivittaistavarakauppa,2019-11-01 06:38:17.872340425,2019-11-01,2019-11-01,2019-11-01,7.0,-20.7,151.43,0.0,162.0,           ,1.0,1.0,136.0
6506,Lemmikit,2019-11-04 13:16:35.744680850,2019-11-04,2019-11-04,2019-11-04,7.0,-24.28,127.15,0.0,162.0,           ,1.0,1.0,98.0
6507,Ravintolat_kahvilat,2019-11-04 19:54:53.617021275,2019-11-04,2019-11-04,2019-11-04,7.0,-8.24,118.91,0.0,162.0,           ,1.0,1.0,144.0
6508,Luokittelemattomat,2019-11-05 02:33:11.489361700,2019-11-05,2019-11-05,2019-11-05,7.0,-2.23,116.68,0.0,162.0,           ,1.0,1.0,53.0
6509,Ruoka_paivittaistavarakauppa,2019-11-07 09:11:29.361702125,2019-11-07,2019-11-07,2019-11-07,7.0,-9.9,106.78,0.0,162.0,           ,1.0,1.0,156.0
6510,Asuminen,2019-11-07 15:49:47.234042550,2019-11-07,2019-11-07,2019-11-07,7.0,-37.24,69.54,706.0,129.0,OKOYFIHH   ,0.0,0.0,215.0
6511,Luokittelemattomat,2019-11-11 05:06:22.978723400,2019-11-11,2019-11-11,2019-11-11,7.0,-33.39,36.15,0.0,162.0,           ,1.0,1.0,94.0
6512,Ruoka_paivittaistavarakauppa,2019-11-11 22:28:05.106382975,2019-11-11,2019-11-11,2019-11-11,7.0,-11.2,24.95,0.0,162.0,           ,1.0,1.0,130.0
6513,Ruoka_paivittaistavarakauppa,2019-11-12 11:44:40.851063825,2019-11-12,2019-11-12,2019-11-12,7.0,-13.33,11.62,0.0,162.0,           ,1.0,1.0,89.0
6514,Ruoka_paivittaistavarakauppa,2019-11-14 18:22:58.723404250,2019-11-14,2019-11-14,2019-11-14,7.0,-8.26,3.36,0.0,162.0,           ,1.0,1.0,145.0
6515,Muut,2019-11-15 01:01:16.595744675,2019-11-15,2019-11-15,2019-11-15,7.0,-7.9,-4.54,706.0,147.0,OKOYFIHH   ,0.0,0.0,224.0
6516,Muut,2019-11-15 07:39:34.468085100,2019-11-15,2019-11-15,2019-11-15,7.0,-2.93,-7.47,706.0,147.0,DABAFIHH   ,0.0,0.0,222.0
6517,Ruoka_paivittaistavarakauppa,2019-11-18 20:56:10.212765950,2019-11-18,2019-11-18,2019-11-18,7.0,-2.65,-10.12,0.0,162.0,           ,1.0,1.0,134.0
6518,Liikkuminen,2019-11-19 14:17:52.340425525,2019-11-19,2019-11-20,2019-11-19,7.0,-3.23,-13.35,0.0,162.0,           ,1.0,1.0,112.0
6519,Asuminen,2019-11-20 03:34:28.085106375,2019-11-20,2019-11-21,2019-11-20,7.0,-9.89,-23.24,0.0,162.0,           ,1.0,1.0,134.0
6520,Ruoka_paivittaistavarakauppa,2019-11-21 10:12:45.957446800,2019-11-21,2019-11-21,2019-11-21,7.0,-0.51,-23.75,0.0,162.0,           ,1.0,1.0,89.0
6521,Tulot,2019-11-22 16:51:03.829787225,2019-11-22,2019-11-22,2019-11-22,7.0,-15.82,-39.57,0.0,162.0,           ,1.0,1.0,170.0
6522,Ruoka_paivittaistavarakauppa,2019-11-22 23:29:21.702127650,2019-11-22,2019-11-22,2019-11-21,7.0,-1.87,-41.44,0.0,162.0,           ,1.0,1.0,122.0
6523,Liikkuminen,2019-11-25 06:07:39.574468075,2019-11-25,2019-11-25,2019-11-25,7.0,-27.07,-68.51,0.0,162.0,           ,1.0,1.0,158.0
6524,Lemmikit,2019-11-26 12:45:57.446808500,2019-11-26,2019-11-29,2019-11-26,7.0,-4.8,-73.31,0.0,162.0,           ,1.0,1.0,126.0
6525,Luokittelemattomat,2019-11-27 02:02:33.191489350,2019-11-27,2019-11-27,2019-11-27,7.0,-5.31,-78.62,0.0,162.0,           ,1.0,1.0,119.0
6526,Asuminen,2019-11-27 19:24:15.319148925,2019-11-27,2019-11-27,2019-11-27,7.0,-3.92,-82.54,0.0,162.0,           ,1.0,1.0,41.0
6527,Ravintolat_kahvilat,2019-11-29 08:40:51.063829775,2019-11-29,2019-11-29,2019-11-29,7.0,-3.85,-86.39,0.0,162.0,           ,1.0,1.0,147.0
6528,Luokittelemattomat,2019-12-02 09:26:17.528089886,2019-12-02,2019-12-02,2019-12-02,7.0,-2.06,-88.45,0.0,162.0,           ,1.0,1.0,44.0
6529,Liikkuminen,2019-12-03 02:09:26.292134829,2019-12-03,2019-12-03,2019-12-03,7.0,-88.23,-176.68,0.0,162.0,           ,1.0,1.0,145.0
6530,Tulot,2019-12-03 16:43:08.764044943,2019-12-03,2019-12-03,2019-12-03,7.0,379.56,202.88,710.0,506.0,           ,1.0,1.0,231.0
6531,Ruoka_paivittaistavarakauppa,2019-12-03 18:52:35.056179772,2019-12-03,2019-12-03,2019-12-03,7.0,-39.18,163.7,0.0,162.0,           ,1.0,1.0,41.0
6532,Lapset,2019-12-04 11:35:43.820224715,2019-12-04,2019-12-04,2019-12-04,7.0,-29.05,134.65,0.0,162.0,           ,1.0,1.0,84.0
6533,Liikkuminen,2019-12-04 13:45:10.112359544,2019-12-04,2019-12-04,2019-12-04,7.0,-11.23,123.42,0.0,162.0,           ,1.0,1.0,97.0
6534,Ruoka_paivittaistavarakauppa,2019-12-04 21:02:01.348314601,2019-12-04,2019-12-04,2019-12-04,7.0,-73.27,50.15,0.0,162.0,           ,1.0,1.0,41.0
6535,Ruoka_paivittaistavarakauppa,2019-12-05 04:18:52.584269658,2019-12-05,2019-12-05,2019-12-05,7.0,-7.68,42.47,0.0,162.0,           ,1.0,1.0,159.0
6536,Ruoka_paivittaistavarakauppa,2019-12-06 06:28:18.876404487,2019-12-06,2019-12-06,2019-12-06,7.0,-1.49,40.98,0.0,162.0,           ,1.0,1.0,61.0
6537,Ruoka_paivittaistavarakauppa,2019-12-06 23:11:27.640449430,2019-12-06,2019-12-06,2019-12-06,7.0,-3.92,37.06,0.0,162.0,           ,1.0,1.0,76.0
6538,Liikkuminen,2019-12-09 08:37:45.168539316,2019-12-09,2019-12-09,2019-12-09,7.0,-2.27,34.79,0.0,162.0,           ,1.0,1.0,111.0
6539,Lemmikit,2019-12-09 10:47:11.460674145,2019-12-09,2019-12-09,2019-12-09,7.0,-5.32,29.47,0.0,162.0,           ,1.0,1.0,48.0
6540,Ruoka_paivittaistavarakauppa,2019-12-09 15:54:36.404494373,2019-12-09,2019-12-09,2019-12-09,7.0,-25.79,3.68,0.0,162.0,           ,1.0,1.0,89.0
6541,Lapset,2019-12-10 01:20:53.932584259,2019-12-10,2019-12-10,2019-12-10,7.0,-7.56,-3.88,0.0,162.0,           ,1.0,1.0,97.0
6542,Ruoka_paivittaistavarakauppa,2019-12-10 18:04:02.696629202,2019-12-10,2019-12-10,2019-12-10,7.0,-20.7,-24.58,0.0,162.0,           ,1.0,1.0,61.0
6543,Asuminen,2019-12-12 03:30:20.224719088,2019-12-12,2019-12-12,2019-12-12,7.0,-16.65,-41.23,0.0,162.0,           ,1.0,1.0,40.0
6544,Ruoka_paivittaistavarakauppa,2019-12-12 12:56:37.752808974,2019-12-12,2019-12-12,2019-12-12,7.0,-13.99,-55.22,0.0,162.0,           ,1.0,1.0,106.0
6545,Tulot,2019-12-13 05:39:46.516853917,2019-12-13,2019-12-13,2019-12-13,7.0,27.83,-27.39,710.0,505.0,           ,1.0,1.0,226.0
6546,Ruoka_paivittaistavarakauppa,2019-12-13 20:13:28.988764031,2019-12-13,2019-12-13,2019-12-13,7.0,-87.7,-115.09,706.0,147.0,OKOYFIHH   ,0.0,0.0,222.0
6547,Muut,2019-12-15 22:22:55.280898860,2019-12-15,2019-12-15,2019-12-15,7.0,-51.36,-166.45,0.0,163.0,           ,1.0,1.0,174.0
6548,Ravintolat_kahvilat,2019-12-16 07:49:12.808988746,2019-12-16,2019-12-16,2019-12-16,7.0,-0.49,-166.94,0.0,162.0,           ,1.0,1.0,101.0
6549,Ruoka_paivittaistavarakauppa,2019-12-16 15:06:04.044943803,2019-12-16,2019-12-16,2019-12-16,7.0,-10.92,-177.86,0.0,162.0,           ,1.0,1.0,98.0
6550,Lemmikit,2019-12-16 17:15:30.337078632,2019-12-16,2019-12-16,2019-12-16,7.0,-4.73,-182.59,0.0,162.0,           ,1.0,1.0,101.0
6551,Kulttuuri_viihde,2019-12-17 00:32:21.573033689,2019-12-17,2019-12-17,2019-12-17,7.0,-2.14,-184.73,0.0,162.0,           ,1.0,1.0,68.0
6552,Luokittelemattomat,2019-12-18 09:58:39.101123575,2019-12-18,2019-12-18,2019-12-18,7.0,-5.06,-189.79,0.0,162.0,           ,1.0,1.0,100.0
6553,Ruoka_paivittaistavarakauppa,2019-12-19 02:41:47.865168518,2019-12-19,2019-12-19,2019-12-19,7.0,-0.82,-190.61,0.0,162.0,           ,1.0,1.0,78.0
6554,Liikkuminen,2019-12-19 19:24:56.629213461,2019-12-19,2019-12-19,2019-12-19,7.0,-4.71,-195.32,0.0,162.0,           ,1.0,1.0,101.0
6555,Muut,2019-12-20 04:51:14.157303347,2019-12-20,2019-12-20,2019-12-20,7.0,-71.03,-266.35,0.0,163.0,           ,1.0,1.0,173.0
6556,Ravintolat_kahvilat,2019-12-20 12:08:05.393258404,2019-12-20,2019-12-20,2019-12-20,7.0,-2.06,-268.41,0.0,162.0,           ,1.0,1.0,48.0
6557,Luokittelemattomat,2019-12-23 07:00:40.449438176,2019-12-23,2019-12-23,2019-12-23,7.0,-0.61,-269.02,0.0,162.0,           ,1.0,1.0,78.0
6558,Ruoka_paivittaistavarakauppa,2019-12-23 09:10:06.741573005,2019-12-23,2019-12-23,2019-12-23,7.0,-4.04,-273.06,0.0,162.0,           ,1.0,1.0,145.0
6559,Ravintolat_kahvilat,2019-12-23 14:17:31.685393233,2019-12-23,2019-12-27,2019-12-23,7.0,-3.73,-276.79,0.0,162.0,           ,1.0,1.0,41.0
6560,Ruoka_paivittaistavarakauppa,2019-12-23 16:26:57.977528062,2019-12-23,2019-12-25,2019-12-23,7.0,-6.51,-283.3,0.0,162.0,           ,1.0,1.0,107.0
6561,Ruoka_paivittaistavarakauppa,2019-12-23 21:34:22.921348290,2019-12-23,2019-12-23,2019-12-23,7.0,-13.24,-296.54,0.0,162.0,           ,1.0,1.0,46.0
6562,Ruoka_paivittaistavarakauppa,2019-12-23 23:43:49.213483119,2019-12-23,2019-12-23,2019-12-23,7.0,-3.29,-299.83,0.0,162.0,           ,1.0,1.0,74.0
6563,Ravintolat_kahvilat,2019-12-25 01:53:15.505617948,2019-12-25,2019-12-25,2019-12-25,7.0,-5.59,-305.42,0.0,162.0,           ,1.0,1.0,146.0
6564,Hyvinvointijakauneus,2019-12-26 18:36:24.269662891,2019-12-26,2019-12-26,2019-12-26,7.0,-12.72,-318.14,0.0,162.0,           ,1.0,1.0,119.0
6565,Ruoka_paivittaistavarakauppa,2019-12-27 04:02:41.797752777,2019-12-27,2019-12-27,2019-12-27,7.0,-15.43,-333.57,0.0,162.0,           ,1.0,1.0,111.0
6566,Liikkuminen,2019-12-27 11:19:33.033707834,2019-12-27,2019-12-27,2019-12-27,7.0,-5.55,-339.12,0.0,162.0,           ,1.0,1.0,55.0
6567,Ruoka_paivittaistavarakauppa,2019-12-27 20:45:50.561797720,2019-12-27,2019-12-27,2019-12-27,7.0,-4.41,-343.53,0.0,162.0,           ,1.0,1.0,84.0
6568,Ruoka_paivittaistavarakauppa,2019-12-30 06:12:08.089887606,2019-12-30,2019-12-30,2019-12-30,7.0,-5.05,-348.58,0.0,162.0,           ,1.0,1.0,114.0
6569,Ravintolat_kahvilat,2019-12-30 13:28:59.325842663,2019-12-30,2019-12-30,2019-12-30,7.0,-3.51,-352.09,0.0,162.0,           ,1.0,1.0,102.0
6570,Luokittelemattomat,2019-12-30 15:38:25.617977492,2019-12-30,2019-12-30,2019-12-30,7.0,-4.36,-356.45,0.0,162.0,           ,1.0,1.0,41.0
6571,Asuminen,2019-12-30 22:55:16.853932549,2019-12-30,2019-12-30,2019-12-30,7.0,-4.4,-360.85,0.0,162.0,           ,1.0,1.0,157.0
6572,Ruoka_paivittaistavarakauppa,2020-01-02 03:03:16.363636363,2020-01-02,2020-01-02,2020-01-02,7.0,-13.49,-374.34,0.0,162.0,           ,1.0,1.0,123.0
6573,Ruoka_paivittaistavarakauppa,2020-01-03 06:06:32.727272726,2020-01-03,2020-01-03,2020-01-03,7.0,-1.51,-375.85,0.0,162.0,           ,1.0,1.0,121.0
6574,Kulttuuri_viihde,2020-01-03 09:09:49.090909089,2020-01-03,2020-01-03,2020-01-03,7.0,-1.98,-377.83,0.0,162.0,           ,1.0,1.0,123.0
6575,Muut,2020-01-03 12:13:05.454545452,2020-01-03,2020-01-03,2020-01-03,7.0,-3.78,-381.61,0.0,162.0,           ,1.0,1.0,88.0
6576,Muut,2020-01-06 15:16:21.818181815,2020-01-06,2020-01-06,2020-01-06,7.0,-3.47,-385.08,0.0,162.0,           ,1.0,1.0,145.0
6577,Ruoka_paivittaistavarakauppa,2020-01-07 18:19:38.181818178,2020-01-07,2020-01-07,2020-01-07,7.0,-23.57,-408.65,0.0,162.0,           ,1.0,1.0,48.0
6578,Ruoka_paivittaistavarakauppa,2020-01-08 21:22:54.545454541,2020-01-08,2020-01-08,2020-01-08,7.0,-7.99,-416.64,0.0,162.0,           ,1.0,1.0,166.0
6579,Ruoka_paivittaistavarakauppa,2020-01-10 00:26:10.909090904,2020-01-10,2020-01-10,2020-01-10,7.0,-10.04,-426.68,0.0,162.0,           ,1.0,1.0,84.0
6580,Muut,2020-01-13 03:29:27.272727267,2020-01-13,2020-01-13,2020-01-13,7.0,-9.35,-436.03,0.0,162.0,           ,1.0,1.0,42.0
6581,Ruoka_paivittaistavarakauppa,2020-01-13 09:35:59.999999993,2020-01-13,2020-01-13,2020-01-13,7.0,-1.45,-437.48,0.0,162.0,           ,1.0,1.0,83.0
6582,Ruoka_paivittaistavarakauppa,2020-01-13 12:39:16.363636356,2020-01-13,2020-01-13,2020-01-13,7.0,-4.79,-442.27,0.0,162.0,           ,1.0,1.0,129.0
6583,Ruoka_paivittaistavarakauppa,2020-01-14 15:42:32.727272719,2020-01-14,2020-01-15,2020-01-14,7.0,-61.28,-503.55,0.0,162.0,           ,1.0,1.0,134.0
6584,Muut,2020-01-15 06:32:43.636363630,2020-01-15,2020-01-15,2020-01-15,7.0,-2.91,-506.46,0.0,103.0,           ,0.0,1.0,1.0
6585,Muut,2020-01-15 18:45:49.090909082,2020-01-15,2020-01-15,2020-01-15,7.0,-16.68,-523.14,0.0,162.0,           ,1.0,1.0,116.0
6586,Hyvinvointi,2020-01-17 21:49:05.454545445,2020-01-17,2020-01-17,2020-01-17,7.0,-2.25,-525.39,0.0,162.0,           ,1.0,1.0,123.0
6587,Kulttuuri_viihde,2020-01-20 00:52:21.818181808,2020-01-20,2020-01-20,2020-01-20,7.0,-1.76,-527.15,0.0,162.0,           ,1.0,1.0,41.0
6588,Ruoka_paivittaistavarakauppa,2020-01-20 03:55:38.181818171,2020-01-20,2020-01-20,2020-01-20,7.0,-11.18,-538.33,0.0,162.0,           ,1.0,1.0,85.0
6589,Lemmikit,2020-01-20 06:58:54.545454534,2020-01-20,2020-01-20,2020-01-20,7.0,-9.17,-547.5,0.0,162.0,           ,1.0,1.0,102.0
6590,Kulttuuri_viihde,2020-01-20 10:02:10.909090897,2020-01-20,2020-01-20,2020-01-20,7.0,-11.44,-558.94,0.0,162.0,           ,1.0,1.0,101.0
6591,Luokittelemattomat,2020-01-23 13:05:27.272727260,2020-01-23,2020-01-23,2020-01-23,7.0,-1260.15,-1819.09,702.0,106.0,           ,1.0,1.0,205.0
6592,Ruoka_paivittaistavarakauppa,2020-01-24 16:08:43.636363623,2020-01-24,2020-01-24,2020-01-24,7.0,-0.55,-1819.64,0.0,162.0,           ,1.0,1.0,85.0
6593,Muut,2020-01-25 19:11:59.999999986,2020-01-25,2020-01-25,2020-01-25,7.0,-3.96,-1823.6,0.0,163.0,           ,1.0,1.0,174.0
6594,Lemmikit,2020-01-27 22:15:16.363636349,2020-01-27,2020-01-27,2020-01-27,7.0,-10.71,-1834.31,0.0,162.0,           ,1.0,1.0,156.0
6595,Ravintolat_kahvilat,2020-01-29 01:18:32.727272712,2020-01-29,2020-01-29,2020-01-29,7.0,-6.37,-1840.68,0.0,162.0,           ,1.0,1.0,42.0
6596,Ruoka_paivittaistavarakauppa,2020-01-29 04:21:49.090909075,2020-01-29,2020-01-29,2020-01-29,7.0,-3.16,-1843.84,0.0,162.0,           ,1.0,1.0,115.0
6597,Saastot_sijoitukset,2020-01-30 07:25:05.454545438,2020-01-30,2020-01-31,2020-01-30,7.0,-3.35,-1847.19,0.0,162.0,           ,1.0,1.0,160.0
6598,Ruoka_paivittaistavarakauppa,2020-01-30 10:28:21.818181801,2020-01-30,2020-01-30,2020-01-30,7.0,-2.82,-1850.01,0.0,162.0,           ,1.0,1.0,102.0
6599,Ruoka_paivittaistavarakauppa,2020-02-03 12:31:18.260869563,2020-02-03,2020-02-03,2020-02-03,7.0,-10.43,-1860.44,0.0,162.0,           ,1.0,1.0,165.0
6600,Muut,2020-02-03 16:20:52.173913042,2020-02-03,2020-02-03,2020-02-03,7.0,-0.77,-1861.21,0.0,162.0,           ,1.0,1.0,111.0
6601,Ravintolat_kahvilat,2020-02-03 20:10:26.086956521,2020-02-03,2020-02-03,2020-02-03,7.0,-5.67,-1866.88,0.0,162.0,           ,1.0,1.0,145.0
6602,Ruoka_paivittaistavarakauppa,2020-02-04 08:41:44.347826084,2020-02-04,2020-02-04,2020-02-04,7.0,-6.49,-1873.37,0.0,162.0,           ,1.0,1.0,134.0
6603,Liikkuminen,2020-02-05 04:52:10.434782605,2020-02-05,2020-02-05,2020-02-05,7.0,-9.76,-1883.13,0.0,162.0,           ,1.0,1.0,55.0
6604,Ruoka_paivittaistavarakauppa,2020-02-06 01:02:36.521739126,2020-02-06,2020-02-06,2020-02-06,7.0,-29.54,-1912.67,0.0,162.0,           ,1.0,1.0,128.0
6605,Liikkuminen,2020-02-06 21:13:02.608695647,2020-02-06,2020-02-06,2020-02-06,7.0,-11.7,-1924.37,0.0,162.0,           ,1.0,1.0,148.0
6606,Lapset,2020-02-07 13:33:54.782608689,2020-02-07,2020-02-07,2020-02-07,7.0,-0.53,-1924.9,0.0,162.0,           ,1.0,1.0,123.0
6607,Luottojen_maksut,2020-02-07 17:23:28.695652168,2020-02-07,2020-02-07,2020-02-07,7.0,-1.63,-1926.53,0.0,162.0,           ,1.0,1.0,40.0
6608,Ruoka_paivittaistavarakauppa,2020-02-10 05:54:46.956521731,2020-02-10,2020-02-10,2020-02-10,7.0,-4.09,-1930.62,0.0,162.0,           ,1.0,1.0,83.0
6609,Ruoka_paivittaistavarakauppa,2020-02-10 09:44:20.869565210,2020-02-10,2020-02-12,2020-02-10,7.0,-23.34,-1953.96,0.0,162.0,           ,1.0,1.0,103.0
6610,Ravintolat_kahvilat,2020-02-11 02:05:13.043478252,2020-02-11,2020-02-11,2020-02-11,7.0,-23.69,-1977.65,0.0,162.0,           ,1.0,1.0,119.0
6611,Saastot_sijoitukset,2020-02-11 18:26:05.217391294,2020-02-11,2020-02-11,2020-02-11,7.0,-7.05,-1984.7,0.0,162.0,           ,1.0,1.0,43.0
6612,Ruoka_paivittaistavarakauppa,2020-02-11 22:15:39.130434773,2020-02-11,2020-02-11,2020-02-11,7.0,-4.65,-1989.35,0.0,162.0,           ,1.0,1.0,42.0
6613,Liikkuminen,2020-02-13 14:36:31.304347815,2020-02-13,2020-02-13,2020-02-13,7.0,-8.34,-1997.69,0.0,162.0,           ,1.0,1.0,114.0
6614,Ruoka_paivittaistavarakauppa,2020-02-14 06:57:23.478260857,2020-02-14,2020-02-14,2020-02-14,7.0,-24.57,-2022.26,0.0,162.0,           ,1.0,1.0,82.0
6615,Tulot,2020-02-14 10:46:57.391304336,2020-02-14,2020-02-14,2020-02-14,7.0,46.04,-1976.22,0.0,505.0,           ,1.0,1.0,188.0
6616,Ruoka_paivittaistavarakauppa,2020-02-17 03:07:49.565217378,2020-02-17,2020-02-17,2020-02-17,7.0,-4.76,-1980.98,0.0,162.0,           ,1.0,1.0,99.0
6617,Ruoka_paivittaistavarakauppa,2020-02-17 19:28:41.739130420,2020-02-17,2020-02-17,2020-02-17,7.0,-3.22,-1984.2,0.0,162.0,           ,1.0,1.0,100.0
6618,Ruoka_paivittaistavarakauppa,2020-02-17 23:18:15.652173899,2020-02-17,2020-02-17,2020-02-17,7.0,-0.95,-1985.15,0.0,162.0,           ,1.0,1.0,78.0
6619,Ruoka_paivittaistavarakauppa,2020-02-18 15:39:07.826086941,2020-02-18,2020-02-18,2020-02-18,7.0,-0.97,-1986.12,0.0,162.0,           ,1.0,1.0,138.0
6620,Ravintolat_kahvilat,2020-02-19 11:49:33.913043462,2020-02-19,2020-02-19,2020-02-19,7.0,-1.52,-1987.64,0.0,162.0,           ,1.0,1.0,98.0
6621,Ruoka_paivittaistavarakauppa,2020-02-20 00:20:52.173913025,2020-02-20,2020-02-20,2020-02-20,7.0,-17.42,-2005.06,0.0,162.0,           ,1.0,1.0,117.0
6622,Ravintolat_kahvilat,2020-02-20 04:10:26.086956504,2020-02-20,2020-02-20,2020-02-20,7.0,-5.78,-2010.84,0.0,162.0,           ,1.0,1.0,104.0
6623,Liikkuminen,2020-02-20 07:59:59.999999983,2020-02-20,2020-02-20,2020-02-20,7.0,-11.23,-2022.07,0.0,162.0,           ,1.0,1.0,85.0
6624,Muut,2020-02-23 16:41:44.347826067,2020-02-23,2020-02-23,2020-02-23,7.0,-45.39,-2067.46,0.0,163.0,           ,1.0,1.0,175.0
6625,Asuminen,2020-02-24 09:02:36.521739109,2020-02-24,2020-02-24,2020-02-24,7.0,-59.39,-2126.85,0.0,162.0,           ,1.0,1.0,128.0
6626,Ruoka_paivittaistavarakauppa,2020-02-24 12:52:10.434782588,2020-02-24,2020-02-24,2020-02-24,7.0,-5.02,-2131.87,0.0,162.0,           ,1.0,1.0,115.0
6627,Ruoka_paivittaistavarakauppa,2020-02-24 20:31:18.260869546,2020-02-24,2020-02-24,2020-02-24,7.0,-20.03,-2151.9,0.0,162.0,           ,1.0,1.0,78.0
6628,Ruoka_paivittaistavarakauppa,2020-02-25 05:13:02.608695630,2020-02-25,2020-02-25,2020-02-25,7.0,-3.84,-2155.74,0.0,162.0,           ,1.0,1.0,67.0
6629,Ruoka_paivittaistavarakauppa,2020-02-27 01:23:28.695652151,2020-02-27,2020-02-27,2020-02-27,7.0,-3.87,-2159.61,0.0,162.0,           ,1.0,1.0,52.0
6630,Luokittelemattomat,2020-02-27 13:54:46.956521714,2020-02-27,2020-02-27,2020-02-27,7.0,-964.59,-3124.2,706.0,129.0,OKOYFIHH   ,0.0,0.0,219.0
6631,Ruoka_paivittaistavarakauppa,2020-02-27 21:33:54.782608672,2020-02-27,2020-02-27,2020-02-27,7.0,-13.6,-3137.8,0.0,162.0,           ,1.0,1.0,156.0
6632,Muut,2020-02-28 17:44:20.869565193,2020-02-28,2020-02-28,2020-02-28,7.0,-105.7,-3243.5,0.0,163.0,           ,1.0,1.0,177.0
6633,Luottojen_maksut,2020-03-02 01:26:09.230769230,2020-03-02,2020-03-02,2020-03-02,7.0,-3.47,-3246.97,0.0,106.0,NDEAFIHH   ,0.0,0.0,32.0
6634,Matkailu,2020-03-02 14:09:13.846153845,2020-03-02,2020-03-02,2020-03-02,7.0,-253.92,-3500.89,0.0,163.0,           ,1.0,1.0,174.0
6635,Kulttuuri_viihde,2020-03-03 02:52:18.461538460,2020-03-03,2020-03-03,2020-03-03,7.0,-7.66,-3508.55,0.0,162.0,           ,1.0,1.0,102.0
6636,Tulot,2020-03-03 12:43:04.615384615,2020-03-03,2020-03-03,2020-03-03,7.0,804.15,-2704.4,0.0,505.0,           ,1.0,1.0,186.0
6637,Ruoka_paivittaistavarakauppa,2020-03-03 15:35:23.076923075,2020-03-03,2020-03-03,2020-03-03,7.0,-2.94,-2707.34,0.0,162.0,           ,1.0,1.0,47.0
6638,Liikkuminen,2020-03-04 04:18:27.692307690,2020-03-04,2020-03-04,2020-03-04,7.0,-37.58,-2744.92,0.0,162.0,           ,1.0,1.0,148.0
6639,Ruoka_paivittaistavarakauppa,2020-03-04 05:44:36.923076920,2020-03-04,2020-03-04,2020-03-04,7.0,-10.48,-2755.4,0.0,162.0,           ,1.0,1.0,41.0
6640,Tulot,2020-03-04 17:01:32.307692305,2020-03-04,2020-03-04,2020-03-04,7.0,1709.88,-1045.52,701.0,521.0,           ,1.0,1.0,202.0
6641,Muut,2020-03-06 07:10:46.153846150,2020-03-06,2020-03-06,2020-03-06,7.0,-6.87,-1052.39,0.0,163.0,           ,1.0,1.0,173.0
6642,Liikkuminen,2020-03-06 08:36:55.384615380,2020-03-06,2020-03-06,2020-03-06,7.0,-0.68,-1053.07,0.0,162.0,           ,1.0,1.0,168.0
6643,Ruoka_paivittaistavarakauppa,2020-03-06 18:27:41.538461535,2020-03-06,2020-03-06,2020-03-06,7.0,-6.69,-1059.76,0.0,162.0,           ,1.0,1.0,74.0
6644,Ruoka_paivittaistavarakauppa,2020-03-06 19:53:50.769230765,2020-03-06,2020-03-06,2020-03-06,7.0,-0.88,-1060.64,0.0,162.0,           ,1.0,1.0,165.0
6645,Matkailu,2020-03-09 10:03:04.615384610,2020-03-09,2020-03-09,2020-03-09,7.0,-39.45,-1100.09,706.0,129.0,NDEAFIHH   ,0.0,0.0,212.0
6646,Ruoka_paivittaistavarakauppa,2020-03-09 11:29:13.846153840,2020-03-09,2020-03-09,2020-03-09,7.0,-5.42,-1105.51,0.0,162.0,           ,1.0,1.0,123.0
6647,Liikkuminen,2020-03-09 21:19:59.999999995,2020-03-09,2020-03-09,2020-03-09,7.0,-2.75,-1108.26,0.0,162.0,           ,1.0,1.0,84.0
6648,Ruoka_paivittaistavarakauppa,2020-03-09 22:46:09.230769225,2020-03-09,2020-03-09,2020-03-09,7.0,-0.6,-1108.86,0.0,162.0,           ,1.0,1.0,132.0
6649,Ruoka_paivittaistavarakauppa,2020-03-10 00:12:18.461538455,2020-03-10,2020-03-10,2020-03-10,7.0,-3.06,-1111.92,0.0,162.0,           ,1.0,1.0,74.0
6650,Asuminen,2020-03-10 12:55:23.076923070,2020-03-10,2020-03-10,2020-03-10,7.0,-1.23,-1113.15,0.0,162.0,           ,1.0,1.0,128.0
6651,Liikkuminen,2020-03-10 14:21:32.307692300,2020-03-10,2020-03-10,2020-03-10,7.0,-10.69,-1123.84,0.0,162.0,           ,1.0,1.0,112.0
6652,Ruoka_paivittaistavarakauppa,2020-03-11 01:38:27.692307685,2020-03-11,2020-03-13,2020-03-11,7.0,-3.44,-1127.28,0.0,162.0,           ,1.0,1.0,96.0
6653,Ruoka_paivittaistavarakauppa,2020-03-11 17:13:50.769230760,2020-03-11,2020-03-11,2020-03-11,7.0,-10.26,-1137.54,0.0,162.0,           ,1.0,1.0,132.0
6654,Ravintolat_kahvilat,2020-03-12 03:04:36.923076915,2020-03-12,2020-03-12,2020-03-12,7.0,-2.07,-1139.61,0.0,162.0,           ,1.0,1.0,116.0
6655,Ruoka_paivittaistavarakauppa,2020-03-12 15:47:41.538461530,2020-03-12,2020-03-12,2020-03-12,7.0,-5.14,-1144.75,0.0,162.0,           ,1.0,1.0,131.0
6656,Lapset,2020-03-13 04:30:46.153846145,2020-03-13,2020-03-13,2020-03-13,7.0,-27.14,-1171.89,0.0,162.0,           ,1.0,1.0,77.0
6657,Ravintolat_kahvilat,2020-03-13 05:56:55.384615375,2020-03-13,2020-03-13,2020-03-13,7.0,-14.34,-1186.23,0.0,162.0,           ,1.0,1.0,147.0
6658,Hyvinvointijakauneus,2020-03-16 07:23:04.615384605,2020-03-16,2020-03-16,2020-03-16,7.0,-8.79,-1195.02,0.0,162.0,           ,1.0,1.0,123.0
6659,Liikkuminen,2020-03-16 08:49:13.846153835,2020-03-16,2020-03-16,2020-03-16,7.0,-9.85,-1204.87,0.0,162.0,           ,1.0,1.0,46.0
6660,Ruoka_paivittaistavarakauppa,2020-03-16 10:15:23.076923065,2020-03-16,2020-03-16,2020-03-16,7.0,-2.02,-1206.89,0.0,162.0,           ,1.0,1.0,112.0
6661,Tulot,2020-03-16 18:39:59.999999990,2020-03-16,2020-03-16,2020-03-16,7.0,-4.46,-1211.35,0.0,162.0,           ,1.0,1.0,95.0
6662,Lemmikit,2020-03-16 20:06:09.230769220,2020-03-16,2020-03-16,2020-03-16,7.0,-8.48,-1219.83,0.0,162.0,           ,1.0,1.0,102.0
6663,Liikkuminen,2020-03-16 21:32:18.461538450,2020-03-16,2020-03-16,2020-03-16,7.0,-4.36,-1224.19,0.0,162.0,           ,1.0,1.0,62.0
6664,Ruoka_paivittaistavarakauppa,2020-03-16 22:58:27.692307680,2020-03-16,2020-03-16,2020-03-16,7.0,-6.64,-1230.83,0.0,162.0,           ,1.0,1.0,145.0
6665,Ravintolat_kahvilat,2020-03-18 11:41:32.307692295,2020-03-18,2020-03-18,2020-03-18,7.0,-5.01,-1235.84,0.0,162.0,           ,1.0,1.0,100.0
6666,Ruoka_paivittaistavarakauppa,2020-03-19 00:24:36.923076910,2020-03-19,2020-03-19,2020-03-19,7.0,-7.47,-1243.31,0.0,162.0,           ,1.0,1.0,81.0
6667,Lapset,2020-03-20 01:50:46.153846140,2020-03-20,2020-03-20,2020-03-20,7.0,-28.71,-1272.02,0.0,162.0,           ,1.0,1.0,83.0
6668,Asuminen,2020-03-20 14:33:50.769230755,2020-03-20,2020-03-20,2020-03-20,7.0,-3.55,-1275.57,0.0,162.0,           ,1.0,1.0,89.0
6669,Muut,2020-03-21 13:07:41.538461525,2020-03-21,2020-03-21,2020-03-21,7.0,-12.94,-1288.51,0.0,163.0,           ,1.0,1.0,175.0
6670,Luottojen_maksut,2020-03-22 04:43:04.615384600,2020-03-22,2020-03-22,2020-03-22,7.0,-41.77,-1330.28,0.0,106.0,DABAFIHH   ,1.0,0.0,12.0
6671,Muut,2020-03-22 17:26:09.230769215,2020-03-22,2020-03-22,2020-03-22,7.0,-17.13,-1347.41,0.0,163.0,           ,1.0,1.0,173.0
6672,Muut,2020-03-23 03:16:55.384615370,2020-03-19,2020-03-23,2020-03-23,7.0,-53.27,-1400.68,0.0,162.0,           ,1.0,1.0,126.0
6673,Liikkuminen,2020-03-23 06:09:13.846153830,2020-03-23,2020-03-23,2020-03-23,7.0,-56.25,-1456.93,0.0,162.0,           ,1.0,1.0,42.0
6674,Ruoka_paivittaistavarakauppa,2020-03-23 15:59:59.999999985,2020-03-23,2020-03-23,2020-03-23,7.0,-11.17,-1468.1,0.0,162.0,           ,1.0,1.0,106.0
6675,Luokittelemattomat,2020-03-23 18:52:18.461538445,2020-03-23,2020-03-23,2020-03-23,7.0,-5.13,-1473.23,0.0,162.0,           ,1.0,1.0,130.0
6676,Ruoka_paivittaistavarakauppa,2020-03-23 20:18:27.692307675,2020-03-23,2020-03-23,2020-03-23,7.0,-1.69,-1474.92,0.0,162.0,           ,1.0,1.0,156.0
6677,Muut,2020-03-24 07:35:23.076923060,2020-03-24,2020-03-24,2020-03-24,7.0,-22.49,-1497.41,0.0,163.0,           ,1.0,1.0,173.0
6678,Ruoka_paivittaistavarakauppa,2020-03-25 21:44:36.923076905,2020-03-25,2020-03-25,2020-03-25,7.0,-3.68,-1501.09,0.0,162.0,           ,1.0,1.0,145.0
6679,Muut,2020-03-25 23:10:46.153846135,2020-03-27,2020-03-25,2020-03-25,7.0,-18.68,-1519.77,0.0,106.0,DABAFIHH   ,0.0,0.0,14.0
6680,Ravintolat_kahvilat,2020-03-26 09:01:32.307692290,2020-03-26,2020-03-26,2020-03-26,7.0,-10.35,-1530.12,0.0,162.0,           ,1.0,1.0,153.0
6681,Tulot,2020-03-26 10:27:41.538461520,2020-03-26,2020-03-26,2020-03-26,7.0,4347.42,2817.3,701.0,506.0,           ,1.0,1.0,195.0
6682,Ruoka_paivittaistavarakauppa,2020-03-27 11:53:50.769230750,2020-03-27,2020-03-27,2020-03-27,7.0,-69.98,2747.32,0.0,162.0,           ,1.0,1.0,84.0
6683,Tulot,2020-03-27 13:19:59.999999980,2020-03-27,2020-03-27,2020-03-27,7.0,1120.98,3868.3,710.0,506.0,           ,1.0,1.0,229.0
6684,Ruoka_paivittaistavarakauppa,2020-03-30 00:36:55.384615365,2020-03-30,2020-03-30,2020-03-30,7.0,-42.08,3826.22,0.0,162.0,           ,1.0,1.0,151.0
6685,Luottojen_maksut,2020-03-30 02:03:04.615384595,2020-03-30,2020-03-30,2020-03-30,7.0,-1193.99,2632.23,0.0,172.0,           ,1.0,1.0,184.0
6686,Luokittelemattomat,2020-03-30 03:29:13.846153825,2020-03-30,2020-03-30,2020-03-30,7.0,-27.71,2604.52,0.0,106.0,OKOYFIHH   ,1.0,0.0,32.0
6687,Luottojen_maksut,2020-03-30 16:12:18.461538440,2020-03-30,2020-03-31,2020-03-30,7.0,-44.69,2559.83,0.0,106.0,OKOYFIHH   ,1.0,0.0,9.0
6688,Tulot,2020-03-30 17:38:27.692307670,2020-03-30,2020-03-30,2020-03-30,7.0,1.46,2561.29,0.0,505.0,           ,1.0,1.0,186.0
6689,Hyvinvointijakauneus,2020-03-31 04:55:23.076923055,2020-03-31,2020-03-31,2020-03-31,7.0,-78.37,2482.92,0.0,106.0,HANDFIHH   ,0.0,0.0,31.0
6690,Tulot,2020-03-31 14:46:09.230769210,2020-03-31,2020-03-31,2020-03-31,7.0,232.39,2715.31,701.0,506.0,           ,1.0,1.0,194.0
6691,Ravintolat_kahvilat,2020-04-02 21:42:51.428571428,2020-04-02,2020-04-02,2020-04-02,7.0,-20.0,2695.31,0.0,162.0,           ,1.0,1.0,69.0
6692,Muut,2020-04-02 22:51:25.714285714,2020-04-02,2020-04-03,2020-04-02,7.0,-23.18,2672.13,0.0,162.0,           ,1.0,1.0,60.0
6693,Ruoka_paivittaistavarakauppa,2020-04-03 19:25:42.857142856,2020-04-03,2020-04-03,2020-04-03,7.0,-21.41,2650.72,0.0,162.0,           ,1.0,1.0,55.0
6694,Ruoka_paivittaistavarakauppa,2020-04-03 20:34:17.142857142,2020-04-03,2020-04-03,2020-04-03,7.0,-75.48,2575.24,0.0,162.0,           ,1.0,1.0,71.0
6695,Terveys,2020-04-06 17:08:34.285714284,2020-04-06,2020-04-06,2020-04-06,7.0,-17.93,2557.31,0.0,162.0,           ,1.0,1.0,42.0
6696,Ruoka_paivittaistavarakauppa,2020-04-06 18:17:08.571428570,2020-04-06,2020-04-06,2020-04-06,7.0,-15.09,2542.22,0.0,162.0,           ,1.0,1.0,146.0
6697,Asuminen,2020-04-07 15:59:59.999999998,2020-04-07,2020-04-07,2020-04-07,7.0,-13.46,2528.76,0.0,162.0,           ,1.0,1.0,105.0
6698,Kulttuuri_viihde,2020-04-08 14:51:25.714285712,2020-04-08,2020-04-08,2020-04-08,7.0,-27.31,2501.45,0.0,162.0,           ,1.0,1.0,94.0
6699,Asuminen,2020-04-09 13:42:51.428571426,2020-04-09,2020-04-09,2020-04-09,7.0,-37.98,2463.47,706.0,129.0,NDEAFIHH   ,0.0,0.0,220.0
6700,Luokittelemattomat,2020-04-10 12:34:17.142857140,2020-04-10,2020-04-10,2020-04-10,7.0,-62.97,2400.5,0.0,162.0,           ,1.0,1.0,108.0
6701,Liikkuminen,2020-04-13 07:59:59.999999996,2020-04-13,2020-04-13,2020-04-13,7.0,-77.1,2323.4,0.0,162.0,           ,1.0,1.0,83.0
6702,Ruoka_paivittaistavarakauppa,2020-04-13 09:08:34.285714282,2020-04-13,2020-04-13,2020-04-13,7.0,-5.42,2317.98,0.0,162.0,           ,1.0,1.0,134.0
6703,Ravintolat_kahvilat,2020-04-13 11:25:42.857142854,2020-04-13,2020-04-13,2020-04-13,7.0,-2.7,2315.28,0.0,162.0,           ,1.0,1.0,98.0
6704,Muut,2020-04-14 10:17:08.571428568,2020-04-14,2020-04-14,2020-04-14,7.0,-109.66,2205.62,0.0,163.0,           ,1.0,1.0,173.0
6705,Luottojen_maksut,2020-04-15 06:51:25.714285710,2020-04-15,2020-04-15,2020-04-15,7.0,-3.91,2201.71,0.0,162.0,           ,1.0,1.0,92.0
6706,Muut,2020-04-16 05:42:51.428571424,2020-04-16,2020-04-16,2020-04-16,7.0,-16.52,2185.19,0.0,162.0,           ,1.0,1.0,148.0
6707,Luokittelemattomat,2020-04-17 04:34:17.142857138,2020-04-17,2020-04-17,2020-04-17,7.0,-7.69,2177.5,0.0,162.0,           ,1.0,1.0,114.0
6708,Asuminen,2020-04-20 01:08:34.285714280,2020-04-20,2020-04-20,2020-04-20,7.0,-75.2,2102.3,0.0,106.0,OKOYFIHH   ,0.0,0.0,29.0
6709,Luottojen_maksut,2020-04-20 02:17:08.571428566,2020-04-20,2020-04-20,2020-04-20,7.0,-629.04,1473.26,0.0,129.0,OKOYFIHH   ,0.0,0.0,38.0
6710,Kulttuuri_viihde,2020-04-20 03:25:42.857142852,2020-04-20,2020-04-20,2020-04-20,7.0,-14.13,1459.13,0.0,162.0,           ,1.0,1.0,107.0
6711,Ruoka_paivittaistavarakauppa,2020-04-20 21:42:51.428571422,2020-04-20,2020-04-20,2020-04-20,7.0,-35.46,1423.67,0.0,162.0,           ,1.0,1.0,41.0
6712,Ruoka_paivittaistavarakauppa,2020-04-20 22:51:25.714285708,2020-04-20,2020-04-20,2020-04-20,7.0,-17.47,1406.2,0.0,162.0,           ,1.0,1.0,48.0
6713,Luottojen_maksut,2020-04-20 23:59:59.999999994,2020-04-20,2020-04-20,2020-04-20,7.0,-379.49,1026.71,0.0,106.0,HELSFIHH   ,0.0,0.0,12.0
6714,Asuminen,2020-04-23 20:34:17.142857136,2020-04-23,2020-04-23,2020-04-23,7.0,-37.59,989.12,0.0,162.0,           ,1.0,1.0,113.0
6715,Ruoka_paivittaistavarakauppa,2020-04-24 18:17:08.571428564,2020-04-24,2020-04-24,2020-04-24,7.0,-0.41,988.71,0.0,162.0,           ,1.0,1.0,163.0
6716,Ravintolat_kahvilat,2020-04-24 19:25:42.857142850,2020-04-24,2020-04-24,2020-04-24,7.0,-20.45,968.26,0.0,162.0,           ,1.0,1.0,100.0
6717,Muut,2020-04-27 14:51:25.714285706,2020-04-27,2020-04-27,2020-04-24,7.0,-22.93,945.33,0.0,162.0,           ,1.0,1.0,168.0
6718,Ravintolat_kahvilat,2020-04-27 15:59:59.999999992,2020-04-27,2020-04-27,2020-04-27,7.0,-15.19,930.14,0.0,162.0,           ,1.0,1.0,134.0
6719,Saastot_sijoitukset,2020-04-27 17:08:34.285714278,2020-04-27,2020-04-27,2020-04-27,7.0,-59.74,870.4,0.0,162.0,           ,1.0,1.0,41.0
6720,Tulot,2020-04-28 13:42:51.428571420,2020-04-28,2020-04-28,2020-04-28,7.0,378.41,1248.81,701.0,506.0,           ,1.0,1.0,194.0
6721,Luokittelemattomat,2020-04-30 12:34:17.142857134,2020-04-30,2020-04-30,2020-04-30,7.0,-199.69,1049.12,0.0,106.0,ITELFIHH   ,1.0,0.0,36.0
6722,Asuminen,2020-05-01 03:23:11.411042943,2020-05-01,2020-05-01,2020-05-01,7.0,-55.32,993.8,706.0,129.0,OKOYFIHH   ,0.0,0.0,221.0
6723,Luottojen_maksut,2020-05-01 09:07:43.803680981,2020-05-01,2020-05-01,2020-05-01,7.0,-36.84,956.96,0.0,172.0,           ,1.0,1.0,184.0
6724,Muut,2020-05-01 18:15:27.607361962,2020-05-01,2020-05-01,2020-05-01,7.0,-27.22,929.74,706.0,105.0,OKOYFIHH   ,1.0,0.0,207.0
6725,Shoppailu,2020-05-02 12:30:55.214723924,2020-05-02,2020-05-02,2020-05-02,7.0,-34.91,894.83,0.0,129.0,OKOYFIHH   ,0.0,0.0,38.0
6726,Luokittelemattomat,2020-05-02 15:54:06.625766867,2020-05-02,2020-05-02,2020-05-02,7.0,-69.43,825.4,0.0,106.0,OKOYFIHH   ,1.0,0.0,26.0
6727,Tulot,2020-05-03 21:38:39.018404905,2020-05-03,2020-05-03,2020-05-03,7.0,1677.36,2502.76,0.0,505.0,           ,1.0,1.0,185.0
6728,Hyvinvointijakauneus,2020-05-04 01:01:50.429447848,2020-05-04,2020-05-04,2020-05-04,7.0,-22.61,2480.15,0.0,162.0,           ,1.0,1.0,154.0
6729,Luokittelemattomat,2020-05-04 06:46:22.822085886,2020-05-04,2020-05-04,2020-05-04,7.0,-123.11,2357.04,0.0,106.0,NDEAFIHH   ,0.0,0.0,15.0
6730,Luokittelemattomat,2020-05-04 10:09:34.233128829,2020-05-04,2020-05-04,2020-05-04,7.0,-21.55,2335.49,0.0,106.0,DABAFIHH   ,0.0,0.0,13.0
6731,Ravintolat_kahvilat,2020-05-04 19:17:18.036809810,2020-05-04,2020-05-04,2020-05-04,7.0,-106.08,2229.41,0.0,162.0,           ,1.0,1.0,103.0
6732,Harrastukset,2020-05-05 04:25:01.840490791,2020-05-05,2020-05-05,2020-05-05,7.0,-370.4,1859.01,0.0,162.0,           ,1.0,1.0,102.0
6733,Ravintolat_kahvilat,2020-05-05 13:32:45.644171772,2020-05-05,2020-05-05,2020-05-05,7.0,-21.38,1837.63,0.0,162.0,           ,1.0,1.0,78.0
6734,Ruoka_paivittaistavarakauppa,2020-05-05 22:40:29.447852753,2020-05-05,2020-05-05,2020-05-05,7.0,-7.68,1829.95,0.0,162.0,           ,1.0,1.0,70.0
6735,Vakuutukset,2020-05-06 11:11:24.662576677,2020-05-06,2020-05-06,2020-05-06,7.0,-34.39,1795.56,0.0,106.0,OKOYFIHH   ,0.0,0.0,36.0
6736,Muut,2020-05-06 16:55:57.055214715,2020-05-06,2020-05-06,2020-05-06,7.0,-12.17,1783.39,0.0,105.0,OKOYFIHH   ,1.0,0.0,5.0
6737,Luottojen_maksut,2020-05-07 02:03:40.858895696,2020-05-07,2020-05-07,2020-05-07,7.0,-218.21,1565.18,0.0,106.0,ESSEFIHX   ,0.0,0.0,8.0
6738,Luokittelemattomat,2020-05-07 14:34:36.073619620,2020-05-07,2020-05-07,2020-05-07,7.0,-53.0,1512.18,0.0,162.0,           ,1.0,1.0,41.0
6739,Ruoka_paivittaistavarakauppa,2020-05-07 20:19:08.466257658,2020-05-07,2020-05-07,2020-05-07,7.0,-6.86,1505.32,0.0,162.0,           ,1.0,1.0,121.0
6740,Kulttuuri_viihde,2020-05-08 05:26:52.269938639,2020-05-08,2020-05-08,2020-05-08,7.0,-82.73,1422.59,0.0,162.0,           ,1.0,1.0,116.0
6741,Tulot,2020-05-08 07:48:13.251533734,2020-05-08,2020-05-08,2020-05-05,7.0,724.75,2147.34,701.0,506.0,           ,1.0,1.0,196.0
6742,Ruoka_paivittaistavarakauppa,2020-05-08 08:50:03.680981582,2020-05-08,2020-05-08,2020-05-08,7.0,-18.15,2129.19,0.0,162.0,           ,1.0,1.0,140.0
6743,Ruoka_paivittaistavarakauppa,2020-05-08 17:57:47.484662563,2020-05-08,2020-05-08,2020-05-08,7.0,-15.46,2113.73,0.0,162.0,           ,1.0,1.0,69.0
6744,Ruoka_paivittaistavarakauppa,2020-05-08 23:42:19.877300601,2020-05-08,2020-05-08,2020-05-08,7.0,-46.41,2067.32,0.0,162.0,           ,1.0,1.0,85.0
6745,Muut,2020-05-11 03:05:31.288343544,2020-05-11,2020-05-11,2020-05-11,7.0,-235.89,1831.43,0.0,162.0,           ,1.0,1.0,78.0
6746,Liikkuminen,2020-05-11 12:13:15.092024525,2020-05-11,2020-05-11,2020-05-11,7.0,-71.11,1760.32,0.0,162.0,           ,1.0,1.0,84.0
6747,Ruoka_paivittaistavarakauppa,2020-05-11 15:36:26.503067468,2020-05-11,2020-05-11,2020-05-11,7.0,-5.01,1755.31,0.0,162.0,           ,1.0,1.0,165.0
6748,Asuminen,2020-05-11 21:20:58.895705506,2020-05-11,2020-05-11,2020-05-11,7.0,-43.49,1711.82,0.0,162.0,           ,1.0,1.0,55.0
6749,Ruoka_paivittaistavarakauppa,2020-05-11 22:22:49.325153354,2020-05-11,2020-05-11,2020-05-11,7.0,-13.61,1698.21,0.0,162.0,           ,1.0,1.0,127.0
6750,Ruoka_paivittaistavarakauppa,2020-05-12 00:44:10.306748449,2020-05-12,2020-05-12,2020-05-12,7.0,-14.98,1683.23,0.0,162.0,           ,1.0,1.0,134.0
6751,Tulot,2020-05-12 06:28:42.699386487,2020-05-12,2020-05-12,2020-05-12,7.0,497.37,2180.6,701.0,506.0,           ,1.0,1.0,194.0
6752,Ruoka_paivittaistavarakauppa,2020-05-12 09:51:54.110429430,2020-05-12,2020-05-12,2020-05-12,7.0,-39.98,2140.62,0.0,162.0,           ,1.0,1.0,69.0
6753,Tulot,2020-05-13 04:07:21.717791392,2020-05-13,2020-05-13,2020-05-13,7.0,620.96,2761.58,701.0,506.0,           ,1.0,1.0,194.0
6754,Ravintolat_kahvilat,2020-05-13 07:30:33.128834335,2020-05-13,2020-05-13,2020-05-13,7.0,-32.59,2728.99,0.0,162.0,           ,1.0,1.0,92.0
6755,Ravintolat_kahvilat,2020-05-13 13:15:05.521472373,2020-05-13,2020-05-13,2020-05-13,7.0,-53.5,2675.49,0.0,162.0,           ,1.0,1.0,83.0
6756,Luottojen_maksut,2020-05-14 18:59:37.914110411,2020-05-14,2020-05-14,2020-05-14,7.0,-104.94,2570.55,0.0,106.0,OKOYFIHH   ,0.0,0.0,16.0
6757,Luottojen_maksut,2020-05-15 01:46:00.736196297,2020-05-15,2020-05-15,2020-05-15,7.0,-213.16,2357.39,706.0,129.0,OKOYFIHH   ,0.0,0.0,218.0
6758,Ravintolat_kahvilat,2020-05-15 05:09:12.147239240,2020-05-15,2020-05-15,2020-05-15,7.0,-34.96,2322.43,0.0,162.0,           ,1.0,1.0,97.0
6759,Harrastukset,2020-05-15 08:32:23.558282183,2020-05-15,2020-05-15,2020-05-15,7.0,-17.81,2304.62,706.0,129.0,NDEAFIHH   ,0.0,0.0,213.0
6760,Ruoka_paivittaistavarakauppa,2020-05-15 10:53:44.539877278,2020-05-15,2020-05-15,2020-05-15,7.0,-31.92,2272.7,0.0,162.0,           ,1.0,1.0,165.0
6761,Muut,2020-05-15 16:38:16.932515316,2020-05-15,2020-05-15,2020-05-15,7.0,-280.14,1992.56,0.0,163.0,           ,1.0,1.0,175.0
6762,Ruoka_paivittaistavarakauppa,2020-05-15 20:01:28.343558259,2020-05-15,2020-05-15,2020-05-15,7.0,-7.66,1984.9,0.0,162.0,           ,1.0,1.0,95.0
6763,Ravintolat_kahvilat,2020-05-15 23:24:39.754601202,2020-05-15,2020-05-15,2020-05-15,7.0,-10.31,1974.59,0.0,162.0,           ,1.0,1.0,145.0
6764,Asuminen,2020-05-18 02:47:51.165644145,2020-05-18,2020-05-18,2020-05-18,7.0,-97.33,1877.26,0.0,162.0,           ,1.0,1.0,86.0
6765,Ravintolat_kahvilat,2020-05-18 11:55:34.969325126,2020-05-18,2020-05-18,2020-05-18,7.0,-10.37,1866.89,0.0,162.0,           ,1.0,1.0,104.0
6766,Harrastukset,2020-05-18 14:16:55.950920221,2020-05-18,2020-05-18,2020-05-18,7.0,-58.09,1808.8,0.0,162.0,           ,1.0,1.0,66.0
6767,Ruoka_paivittaistavarakauppa,2020-05-18 17:40:07.361963164,2020-05-18,2020-05-18,2020-05-18,7.0,-41.76,1767.04,0.0,162.0,           ,1.0,1.0,67.0
6768,Ruoka_paivittaistavarakauppa,2020-05-18 21:03:18.773006107,2020-05-18,2020-05-18,2020-05-18,7.0,-13.0,1754.04,0.0,162.0,           ,1.0,1.0,40.0
6769,Muut,2020-05-19 00:26:30.184049050,2020-05-19,2020-05-19,2020-05-19,7.0,-43.69,1710.35,0.0,162.0,           ,1.0,1.0,103.0
6770,Liikkuminen,2020-05-19 06:11:02.576687088,2020-05-19,2020-05-19,2020-05-19,7.0,-11.06,1699.29,0.0,162.0,           ,1.0,1.0,57.0
6771,Shoppailu,2020-05-19 15:18:46.380368069,2020-05-19,2020-05-19,2020-05-19,7.0,-2.85,1696.44,0.0,162.0,           ,1.0,1.0,110.0
6772,Ravintolat_kahvilat,2020-05-20 16:20:36.809815917,2020-05-20,2020-05-20,2020-05-20,7.0,-1.1,1695.34,0.0,162.0,           ,1.0,1.0,165.0
6773,Terveys,2020-05-20 19:43:48.220858860,2020-05-20,2020-05-20,2020-05-20,7.0,-18.86,1676.48,0.0,162.0,           ,1.0,1.0,94.0
6774,Ruoka_paivittaistavarakauppa,2020-05-21 03:49:41.595091993,2020-05-21,2020-05-21,2020-05-21,7.0,-25.45,1651.03,0.0,162.0,           ,1.0,1.0,149.0
6775,Liikkuminen,2020-05-21 07:12:53.006134936,2020-05-21,2020-05-21,2020-05-21,7.0,-73.25,1577.78,0.0,162.0,           ,1.0,1.0,163.0
6776,Ruoka_paivittaistavarakauppa,2020-05-21 09:34:13.987730031,2020-05-21,2020-05-21,2020-05-21,7.0,-47.1,1530.68,0.0,162.0,           ,1.0,1.0,85.0
6777,Ruoka_paivittaistavarakauppa,2020-05-21 18:41:57.791411012,2020-05-21,2020-05-21,2020-05-21,7.0,-28.21,1502.47,0.0,162.0,           ,1.0,1.0,89.0
6778,Ravintolat_kahvilat,2020-05-21 22:05:09.202453955,2020-05-21,2020-05-21,2020-05-21,7.0,-28.36,1474.11,0.0,162.0,           ,1.0,1.0,96.0
6779,Ruoka_paivittaistavarakauppa,2020-05-22 10:36:04.417177879,2020-05-22,2020-05-22,2020-05-22,7.0,-20.68,1453.43,0.0,162.0,           ,1.0,1.0,73.0
6780,Ruoka_paivittaistavarakauppa,2020-05-22 12:57:25.398772974,2020-05-22,2020-05-22,2020-05-22,7.0,-12.71,1440.72,0.0,162.0,           ,1.0,1.0,101.0
6781,Ruoka_paivittaistavarakauppa,2020-05-25 01:28:20.613496898,2020-05-25,2020-05-29,2020-05-25,7.0,-11.45,1429.27,0.0,162.0,           ,1.0,1.0,42.0
6782,Lapset,2020-05-25 08:14:43.435582784,2020-05-25,2020-05-25,2020-05-25,7.0,-13.74,1415.53,0.0,162.0,           ,1.0,1.0,147.0
6783,Ruoka_paivittaistavarakauppa,2020-05-25 17:22:27.239263765,2020-05-25,2020-05-25,2020-05-25,7.0,-13.24,1402.29,0.0,162.0,           ,1.0,1.0,119.0
6784,Ruoka_paivittaistavarakauppa,2020-05-26 02:30:11.042944746,2020-05-26,2020-05-26,2020-05-26,7.0,-10.63,1391.66,0.0,162.0,           ,1.0,1.0,106.0
6785,Ruoka_paivittaistavarakauppa,2020-05-26 04:51:32.024539841,2020-05-26,2020-05-26,2020-05-26,7.0,-24.28,1367.38,0.0,162.0,           ,1.0,1.0,117.0
6786,Luottojen_maksut,2020-05-26 11:37:54.846625727,2020-05-26,2020-05-26,2020-05-26,7.0,-8.81,1358.57,0.0,162.0,           ,1.0,1.0,85.0
6787,Tulot,2020-05-26 12:39:45.276073575,2020-05-26,2020-05-26,2020-05-26,7.0,333.01,1691.58,701.0,522.0,           ,1.0,1.0,204.0
6788,Muut,2020-05-26 13:59:15.828220822,2020-05-26,2020-05-26,2020-05-26,7.0,-59.2,1632.38,0.0,163.0,           ,1.0,1.0,173.0
6789,Ruoka_paivittaistavarakauppa,2020-05-26 20:45:38.650306708,2020-05-26,2020-05-26,2020-05-25,7.0,-53.75,1578.63,0.0,162.0,           ,1.0,1.0,126.0
6790,Matkailu,2020-05-26 23:06:59.631901803,2020-05-26,2020-05-26,2020-05-26,7.0,-750.75,827.88,0.0,106.0,DABAFIHH   ,0.0,0.0,11.0
6791,Liikkuminen,2020-05-27 05:53:22.453987689,2020-05-27,2020-05-27,2020-05-27,7.0,-15.56,812.32,0.0,162.0,           ,1.0,1.0,48.0
6792,Ravintolat_kahvilat,2020-05-27 15:01:06.257668670,2020-05-27,2020-05-27,2020-05-27,7.0,-17.55,794.77,0.0,162.0,           ,1.0,1.0,109.0
6793,Ruoka_paivittaistavarakauppa,2020-05-27 18:24:17.668711613,2020-05-27,2020-05-27,2020-05-27,7.0,-10.82,783.95,0.0,162.0,           ,1.0,1.0,167.0
6794,Muut,2020-05-29 00:08:50.061349651,2020-05-29,2020-05-29,2020-05-29,7.0,-2.35,781.6,0.0,162.0,           ,1.0,1.0,106.0
6795,Ruoka_paivittaistavarakauppa,2020-05-29 01:10:40.490797499,2020-05-29,2020-05-29,2020-05-29,7.0,-43.2,738.4,0.0,162.0,           ,1.0,1.0,129.0
6796,Liikkuminen,2020-05-29 03:32:01.472392594,2020-05-29,2020-05-29,2020-05-29,7.0,-9.13,729.27,0.0,162.0,           ,1.0,1.0,41.0
6797,Tulot,2020-05-29 06:55:12.883435537,2020-05-29,2020-05-29,2020-05-29,7.0,-19.6,709.67,0.0,106.0,NDEAFIHH   ,0.0,0.0,20.0
6798,Ruoka_paivittaistavarakauppa,2020-05-29 09:16:33.865030632,2020-05-29,2020-05-29,2020-05-29,7.0,-39.24,670.43,0.0,162.0,           ,1.0,1.0,141.0
6799,Saastot_sijoitukset,2020-05-29 10:18:24.294478480,2020-05-29,2020-05-29,2020-05-29,7.0,-8.09,662.34,0.0,162.0,           ,1.0,1.0,112.0
6800,Muut,2020-05-29 16:02:56.687116518,2020-05-29,2020-05-29,2020-05-29,7.0,-29.88,632.46,0.0,162.0,           ,1.0,1.0,157.0
6801,Matkailu,2020-05-29 21:47:29.079754556,2020-05-29,2020-05-29,2020-05-29,7.0,-4.68,627.78,0.0,162.0,           ,1.0,1.0,54.0
6802,Tulot,2020-05-30 19:26:08.098159461,2020-05-30,2020-05-30,2020-05-30,7.0,65.24,693.02,0.0,506.0,           ,1.0,1.0,189.0
6803,Ruoka_paivittaistavarakauppa,2020-06-01 13:27:28.598130841,2020-06-01,2020-06-01,2020-06-01,7.0,-8.38,684.64,0.0,162.0,           ,1.0,1.0,133.0
6804,Saastot_sijoitukset,2020-06-02 02:54:57.196261682,2020-06-02,2020-06-02,2020-06-02,7.0,-22.77,661.87,0.0,162.0,           ,1.0,1.0,141.0
6805,Asuminen,2020-06-02 16:22:25.794392523,2020-06-02,2020-06-02,2020-06-02,7.0,-6.19,655.68,0.0,162.0,           ,1.0,1.0,134.0
6806,Muut,2020-06-03 05:49:54.392523364,2020-06-03,2020-06-03,2020-06-03,7.0,-32.68,623.0,0.0,163.0,           ,1.0,1.0,174.0
6807,Muut,2020-06-04 08:44:51.588785046,2020-06-04,2020-06-04,2020-06-04,7.0,-101.0,522.0,0.0,105.0,OKOYFIHH   ,1.0,0.0,4.0
6808,Asuminen,2020-06-04 22:12:20.186915887,2020-06-04,2020-06-04,2020-06-04,7.0,-13.7,508.3,0.0,106.0,OKOYFIHH   ,0.0,0.0,11.0
6809,Liikkuminen,2020-06-05 11:39:48.785046728,2020-06-05,2020-06-05,2020-06-05,7.0,-3.81,504.49,0.0,106.0,OKOYFIHH   ,1.0,0.0,15.0
6810,Kulttuuri_viihde,2020-06-05 14:34:45.981308410,2020-06-05,2020-06-05,2020-06-05,7.0,-7.58,496.91,0.0,162.0,           ,1.0,1.0,41.0
6811,Ruoka_paivittaistavarakauppa,2020-06-05 17:29:43.177570092,2020-06-05,2020-06-05,2020-06-05,7.0,-13.39,483.52,0.0,162.0,           ,1.0,1.0,112.0
6812,Tulot,2020-06-05 19:17:22.990654205,2020-06-05,2020-06-05,2020-06-05,7.0,258.76,742.28,701.0,506.0,           ,1.0,1.0,194.0
6813,Muut,2020-06-06 01:07:17.383177569,2020-06-06,2020-06-06,2020-06-06,7.0,-62.63,679.65,0.0,163.0,           ,1.0,1.0,174.0
6814,Ravintolat_kahvilat,2020-06-08 04:02:14.579439251,2020-06-08,2020-06-08,2020-06-08,7.0,-5.66,673.99,0.0,162.0,           ,1.0,1.0,74.0
6815,Ruoka_paivittaistavarakauppa,2020-06-08 06:57:11.775700933,2020-06-08,2020-06-08,2020-06-08,7.0,-12.38,661.61,0.0,162.0,           ,1.0,1.0,104.0
6816,Matkailu,2020-06-08 23:19:37.570093456,2020-06-08,2020-06-08,2020-06-08,7.0,-419.72,241.89,0.0,105.0,OKOYFIHH   ,1.0,0.0,5.0
6817,Saastot_sijoitukset,2020-06-09 09:52:08.971962615,2020-06-09,2020-06-09,2020-06-09,7.0,-4.06,237.83,0.0,162.0,           ,1.0,1.0,126.0
6818,Tulot,2020-06-09 20:24:40.373831774,2020-06-09,2020-06-09,2020-06-09,7.0,111.06,348.89,701.0,506.0,           ,1.0,1.0,194.0
6819,Muut,2020-06-10 02:14:34.766355138,2020-06-10,2020-06-10,2020-06-10,7.0,-50.25,298.64,0.0,163.0,           ,1.0,1.0,176.0
6820,Ruoka_paivittaistavarakauppa,2020-06-10 12:47:06.168224297,2020-06-10,2020-06-10,2020-06-09,7.0,-33.74,264.9,0.0,162.0,           ,1.0,1.0,40.0
6821,Ruoka_paivittaistavarakauppa,2020-06-11 15:42:03.364485979,2020-06-11,2020-06-11,2020-06-11,7.0,-5.0,259.9,0.0,162.0,           ,1.0,1.0,58.0
6822,Ruoka_paivittaistavarakauppa,2020-06-12 05:09:31.962616820,2020-06-12,2020-06-12,2020-06-12,7.0,-12.27,247.63,0.0,162.0,           ,1.0,1.0,156.0
6823,Ruoka_paivittaistavarakauppa,2020-06-12 18:37:00.560747661,2020-06-12,2020-06-12,2020-06-12,7.0,-17.99,229.64,0.0,162.0,           ,1.0,1.0,96.0
6824,Muut,2020-06-13 10:59:26.355140184,2020-06-13,2020-06-13,2020-06-13,7.0,-37.28,192.36,0.0,105.0,OKOYFIHH   ,1.0,0.0,5.0
6825,Harrastukset,2020-06-15 00:26:54.953271025,2020-06-15,2020-06-15,2020-06-15,7.0,-31.13,161.23,0.0,106.0,OKOYFIHH   ,0.0,0.0,9.0
6826,Ruoka_paivittaistavarakauppa,2020-06-15 08:04:29.158878502,2020-06-15,2020-06-15,2020-06-15,7.0,-18.3,142.93,0.0,162.0,           ,1.0,1.0,56.0
6827,Asuminen,2020-06-15 13:54:23.551401866,2020-06-15,2020-06-15,2020-06-15,7.0,-8.08,134.85,0.0,106.0,NDEAFIHH   ,0.0,0.0,18.0
6828,Muut,2020-06-15 21:31:57.757009343,2020-06-15,2020-06-15,2020-06-15,7.0,-31.14,103.71,0.0,105.0,OKOYFIHH   ,1.0,0.0,6.0
6829,Muut,2020-06-16 03:21:52.149532707,2020-06-16,2020-06-16,2020-06-16,7.0,-11.73,91.98,0.0,162.0,           ,1.0,1.0,83.0
6830,Matkailu,2020-06-16 16:49:20.747663548,2020-06-16,2020-06-16,2020-06-16,7.0,-7.62,84.36,0.0,162.0,           ,1.0,1.0,114.0
6831,Liikkuminen,2020-06-16 19:44:17.943925230,2020-06-16,2020-06-16,2020-06-16,7.0,-34.63,49.73,0.0,162.0,           ,1.0,1.0,42.0
6832,Lapset,2020-06-17 06:16:49.345794389,2020-06-17,2020-06-17,2020-06-17,7.0,-1.9,47.83,0.0,162.0,           ,1.0,1.0,109.0
6833,Shoppailu,2020-06-18 09:11:46.542056071,2020-06-18,2020-06-18,2020-06-18,7.0,-20.91,26.92,0.0,162.0,           ,1.0,1.0,84.0
6834,Ravintolat_kahvilat,2020-06-18 22:39:15.140186912,2020-06-18,2020-06-18,2020-06-18,7.0,-9.12,17.8,0.0,162.0,           ,1.0,1.0,89.0
6835,Saastot_sijoitukset,2020-06-19 12:06:43.738317753,2020-06-19,2020-06-19,2020-06-19,7.0,-0.9,16.9,0.0,162.0,           ,1.0,1.0,148.0
6836,Asuminen,2020-06-20 04:29:09.532710276,2020-06-20,2020-06-20,2020-06-20,7.0,-13.46,3.44,0.0,106.0,OKOYFIHH   ,0.0,0.0,23.0
6837,Shoppailu,2020-06-22 01:34:12.336448594,2020-06-22,2020-06-22,2020-06-22,7.0,-4.96,-1.52,0.0,162.0,           ,1.0,1.0,84.0
6838,Lemmikit,2020-06-22 07:24:06.728971958,2020-06-22,2020-06-22,2020-06-22,7.0,-10.72,-12.24,0.0,162.0,           ,1.0,1.0,108.0
6839,Ravintolat_kahvilat,2020-06-22 15:01:40.934579435,2020-06-22,2020-06-22,2020-06-22,7.0,-4.42,-16.66,0.0,162.0,           ,1.0,1.0,119.0
6840,Ruoka_paivittaistavarakauppa,2020-06-22 20:51:35.327102799,2020-06-22,2020-06-22,2020-06-22,7.0,-24.51,-41.17,0.0,162.0,           ,1.0,1.0,99.0
6841,Luokittelemattomat,2020-06-23 10:19:03.925233640,2020-06-23,2020-06-23,2020-06-23,7.0,-11.8,-52.97,0.0,162.0,           ,1.0,1.0,157.0
6842,Matkailu,2020-06-23 17:56:38.130841117,2020-06-23,2020-06-23,2020-06-23,7.0,-105.63,-158.6,0.0,106.0,SBANFIHH   ,0.0,0.0,17.0
6843,Ruoka_paivittaistavarakauppa,2020-06-23 23:46:32.523364481,2020-06-23,2020-06-23,2020-06-23,7.0,-3.25,-161.85,0.0,162.0,           ,1.0,1.0,133.0
6844,Ruoka_paivittaistavarakauppa,2020-06-24 13:14:01.121495322,2020-06-24,2020-06-24,2020-06-24,7.0,-0.65,-162.5,0.0,162.0,           ,1.0,1.0,102.0
6845,Ruoka_paivittaistavarakauppa,2020-06-25 05:36:26.915887845,2020-06-25,2020-06-25,2020-06-25,7.0,-3.8,-166.3,0.0,162.0,           ,1.0,1.0,55.0
6846,Ruoka_paivittaistavarakauppa,2020-06-26 02:41:29.719626163,2020-06-26,2020-06-26,2020-06-26,7.0,-2.75,-169.05,0.0,162.0,           ,1.0,1.0,84.0
6847,Ravintolat_kahvilat,2020-06-26 08:31:24.112149527,2020-06-26,2020-06-26,2020-06-26,7.0,-6.36,-175.41,0.0,162.0,           ,1.0,1.0,79.0
6848,Ruoka_paivittaistavarakauppa,2020-06-26 16:08:58.317757004,2020-06-26,2020-06-26,2020-06-26,7.0,-10.73,-186.14,0.0,162.0,           ,1.0,1.0,84.0
6849,Ruoka_paivittaistavarakauppa,2020-06-26 19:03:55.514018686,2020-06-26,2020-06-26,2020-06-26,7.0,-5.82,-191.96,0.0,162.0,           ,1.0,1.0,55.0
6850,Ruoka_paivittaistavarakauppa,2020-06-26 21:58:52.710280368,2020-06-26,2020-06-26,2020-06-26,7.0,-35.95,-227.91,0.0,162.0,           ,1.0,1.0,96.0
6851,Liikkuminen,2020-06-29 00:53:49.906542050,2020-06-29,2020-06-29,2020-06-29,7.0,-0.68,-228.59,0.0,162.0,           ,1.0,1.0,40.0
6852,Muut,2020-06-29 11:26:21.308411209,2020-06-29,2020-06-29,2020-06-29,7.0,-14.46,-243.05,0.0,105.0,OKOYFIHH   ,1.0,0.0,4.0
6853,Ruoka_paivittaistavarakauppa,2020-06-29 14:21:18.504672891,2020-06-29,2020-06-29,2020-06-29,7.0,-4.39,-247.44,0.0,162.0,           ,1.0,1.0,147.0
6854,Ruoka_paivittaistavarakauppa,2020-06-29 17:16:15.700934573,2020-06-29,2020-06-29,2020-06-29,7.0,-1.86,-249.3,0.0,162.0,           ,1.0,1.0,115.0
6855,Ruoka_paivittaistavarakauppa,2020-06-30 03:48:47.102803732,2020-06-30,2020-06-30,2020-06-30,7.0,-18.82,-268.12,0.0,162.0,           ,1.0,1.0,48.0
6856,Tulot,2020-07-01 18:22:13.333333333,2020-07-01,2020-07-01,2020-07-01,7.0,363.31,95.19,701.0,520.0,           ,1.0,1.0,200.0
6857,Ravintolat_kahvilat,2020-07-02 12:44:26.666666666,2020-07-02,2020-07-02,2020-07-02,7.0,-8.2,86.99,0.0,162.0,           ,1.0,1.0,50.0
6858,Hyvinvointijakauneus,2020-07-02 19:51:06.666666665,2020-07-02,2020-07-02,2020-07-02,7.0,-15.2,71.79,0.0,162.0,           ,1.0,1.0,61.0
6859,Asuminen,2020-07-03 01:28:53.333333332,2020-07-03,2020-07-03,2020-07-03,7.0,-15.6,56.19,0.0,162.0,           ,1.0,1.0,97.0
6860,Ruoka_paivittaistavarakauppa,2020-07-03 07:06:39.999999999,2020-07-03,2020-07-03,2020-07-03,7.0,-6.06,50.13,0.0,162.0,           ,1.0,1.0,128.0
6861,Liikkuminen,2020-07-06 08:35:33.333333331,2020-07-06,2020-07-06,2020-07-06,7.0,-32.59,17.54,0.0,162.0,           ,1.0,1.0,97.0
6862,Ruoka_paivittaistavarakauppa,2020-07-06 14:13:19.999999998,2020-07-06,2020-07-06,2020-07-06,7.0,-2.01,15.53,0.0,162.0,           ,1.0,1.0,145.0
6863,Saastot_sijoitukset,2020-07-07 02:57:46.666666664,2020-07-07,2020-07-07,2020-07-07,7.0,-2.43,13.1,0.0,162.0,           ,1.0,1.0,123.0
6864,Ruoka_paivittaistavarakauppa,2020-07-07 21:19:59.999999997,2020-07-07,2020-07-07,2020-07-07,7.0,-6.91,6.19,0.0,162.0,           ,1.0,1.0,42.0
6865,Ruoka_paivittaistavarakauppa,2020-07-08 15:42:13.333333330,2020-07-08,2020-07-08,2020-07-08,7.0,-3.54,2.65,0.0,162.0,           ,1.0,1.0,165.0
6866,Ruoka_paivittaistavarakauppa,2020-07-09 04:26:39.999999996,2020-07-09,2020-07-09,2020-07-09,7.0,-2.03,0.62,0.0,162.0,           ,1.0,1.0,67.0
6867,Ruoka_paivittaistavarakauppa,2020-07-09 10:04:26.666666663,2020-07-09,2020-07-09,2020-07-09,7.0,-0.64,-0.02,0.0,162.0,           ,1.0,1.0,107.0
6868,Ruoka_paivittaistavarakauppa,2020-07-10 22:48:53.333333329,2020-07-10,2020-07-10,2020-07-10,7.0,-30.99,-31.01,0.0,162.0,           ,1.0,1.0,95.0
6869,Asuminen,2020-07-13 05:55:33.333333328,2020-07-13,2020-07-13,2020-07-13,7.0,-3.16,-34.17,0.0,162.0,           ,1.0,1.0,89.0
6870,Liikkuminen,2020-07-13 11:33:19.999999995,2020-07-13,2020-07-13,2020-07-13,7.0,-32.23,-66.4,0.0,162.0,           ,1.0,1.0,42.0
6871,Ruoka_paivittaistavarakauppa,2020-07-13 17:11:06.666666662,2020-07-13,2020-07-13,2020-07-13,7.0,-5.06,-71.46,0.0,162.0,           ,1.0,1.0,120.0
6872,Ravintolat_kahvilat,2020-07-13 18:39:59.999999994,2020-07-13,2020-07-13,2020-07-13,7.0,-6.62,-78.08,0.0,162.0,           ,1.0,1.0,123.0
6873,Ravintolat_kahvilat,2020-07-14 13:02:13.333333327,2020-07-14,2020-07-14,2020-07-14,7.0,-4.06,-82.14,0.0,162.0,           ,1.0,1.0,82.0
6874,Muut,2020-07-15 00:17:46.666666661,2020-07-15,2020-07-15,2020-07-15,7.0,-16.12,-98.26,0.0,162.0,           ,1.0,1.0,111.0
6875,Ruoka_paivittaistavarakauppa,2020-07-15 07:24:26.666666660,2020-07-15,2020-07-15,2020-07-17,7.0,-25.94,-124.2,0.0,162.0,           ,1.0,1.0,92.0
6876,Ruoka_paivittaistavarakauppa,2020-07-17 01:46:39.999999993,2020-07-17,2020-07-17,2020-07-17,7.0,-10.93,-135.13,0.0,162.0,           ,1.0,1.0,99.0
6877,Matkailu,2020-07-17 20:08:53.333333326,2020-07-17,2020-07-17,2020-07-17,7.0,-9.51,-144.64,0.0,162.0,           ,1.0,1.0,109.0
6878,Tulot,2020-07-20 03:15:33.333333325,2020-07-20,2020-07-20,2020-07-20,7.0,622.69,478.05,701.0,510.0,           ,1.0,1.0,197.0
6879,Saastot_sijoitukset,2020-07-20 08:53:19.999999992,2020-07-20,2020-07-20,2020-07-20,7.0,-103.42,374.63,0.0,162.0,           ,1.0,1.0,67.0
6880,Ravintolat_kahvilat,2020-07-20 14:31:06.666666659,2020-07-20,2020-07-20,2020-07-20,7.0,-2.55,372.08,0.0,162.0,           ,1.0,1.0,156.0
6881,Ruoka_paivittaistavarakauppa,2020-07-20 15:59:59.999999991,2020-07-20,2020-07-20,2020-07-20,7.0,-11.81,360.27,0.0,162.0,           ,1.0,1.0,94.0
6882,Ruoka_paivittaistavarakauppa,2020-07-20 21:37:46.666666658,2020-07-20,2020-07-20,2020-07-20,7.0,-15.71,344.56,0.0,162.0,           ,1.0,1.0,103.0
6883,Ruoka_paivittaistavarakauppa,2020-07-21 10:22:13.333333324,2020-07-21,2020-07-21,2020-07-21,7.0,-15.89,328.67,0.0,162.0,           ,1.0,1.0,61.0
6884,Ruoka_paivittaistavarakauppa,2020-07-22 04:44:26.666666657,2020-07-22,2020-07-23,2020-07-22,7.0,-5.54,323.13,0.0,162.0,           ,1.0,1.0,134.0
6885,Ravintolat_kahvilat,2020-07-22 17:28:53.333333323,2020-07-22,2020-07-22,2020-07-22,7.0,-6.14,316.99,0.0,162.0,           ,1.0,1.0,120.0
6886,Muut,2020-07-23 23:06:39.999999990,2020-07-23,2020-07-23,2020-07-23,7.0,-8.43,308.56,706.0,147.0,OKOYFIHH   ,0.0,0.0,222.0
6887,Ruoka_paivittaistavarakauppa,2020-07-27 00:35:33.333333322,2020-07-27,2020-07-27,2020-07-27,7.0,-14.74,293.82,0.0,162.0,           ,1.0,1.0,170.0
6888,Luokittelemattomat,2020-07-27 06:13:19.999999989,2020-07-27,2020-07-27,2020-07-27,7.0,-108.81,185.01,0.0,162.0,           ,1.0,1.0,67.0
6889,Ruoka_paivittaistavarakauppa,2020-07-27 11:51:06.666666656,2020-07-27,2020-07-27,2020-07-27,7.0,-29.55,155.46,0.0,162.0,           ,1.0,1.0,83.0
6890,Ruoka_paivittaistavarakauppa,2020-07-27 13:19:59.999999988,2020-07-27,2020-07-27,2020-07-27,7.0,-34.35,121.11,0.0,162.0,           ,1.0,1.0,111.0
6891,Saastot_sijoitukset,2020-07-27 18:57:46.666666655,2020-07-27,2020-07-27,2020-07-27,7.0,-18.07,103.04,0.0,162.0,           ,1.0,1.0,82.0
6892,Ruoka_paivittaistavarakauppa,2020-07-29 07:42:13.333333321,2020-07-29,2020-07-29,2020-07-29,7.0,-9.95,93.09,0.0,162.0,           ,1.0,1.0,57.0
6893,Ruoka_paivittaistavarakauppa,2020-07-29 20:26:39.999999987,2020-07-29,2020-07-29,2020-07-31,7.0,-9.62,83.47,0.0,162.0,           ,1.0,1.0,135.0
6894,Ruoka_paivittaistavarakauppa,2020-07-30 02:04:26.666666654,2020-07-30,2020-07-30,2020-07-30,7.0,-8.78,74.69,0.0,162.0,           ,1.0,1.0,70.0
6895,Ruoka_paivittaistavarakauppa,2020-07-30 14:48:53.333333320,2020-07-30,2020-07-30,2020-07-30,7.0,-7.04,67.65,0.0,162.0,           ,1.0,1.0,80.0
6896,Liikkuminen,2020-08-03 04:53:35.533980582,2020-08-03,2020-08-03,2020-08-03,7.0,-14.97,52.68,0.0,162.0,           ,1.0,1.0,78.0
6897,Luokittelemattomat,2020-08-03 09:47:11.067961164,2020-08-03,2020-08-03,2020-08-03,7.0,-5.0,47.68,0.0,162.0,           ,1.0,1.0,95.0
6898,Ruoka_paivittaistavarakauppa,2020-08-03 14:26:47.766990291,2020-07-29,2020-08-03,2020-08-03,7.0,-2.95,44.73,0.0,162.0,           ,1.0,1.0,120.0
6899,Tulot,2020-08-04 00:13:58.834951455,2020-08-04,2020-08-04,2020-08-04,7.0,-3.66,41.07,0.0,162.0,           ,1.0,1.0,89.0
6900,Ruoka_paivittaistavarakauppa,2020-08-04 05:07:34.368932037,2020-08-04,2020-08-04,2020-08-04,7.0,-6.18,34.89,0.0,162.0,           ,1.0,1.0,165.0
6901,Ruoka_paivittaistavarakauppa,2020-08-04 14:40:46.601941746,2020-08-04,2020-08-04,2020-08-04,7.0,-9.51,25.38,0.0,162.0,           ,1.0,1.0,124.0
6902,Ruoka_paivittaistavarakauppa,2020-08-04 19:20:23.300970873,2020-08-04,2020-08-04,2020-08-04,7.0,-14.68,10.7,0.0,162.0,           ,1.0,1.0,116.0
6903,Ruoka_paivittaistavarakauppa,2020-08-06 05:21:33.203883492,2020-08-06,2020-08-06,2020-08-06,7.0,-4.24,6.46,0.0,162.0,           ,1.0,1.0,78.0
6904,Liikkuminen,2020-08-06 19:34:22.135922328,2020-08-06,2020-08-06,2020-08-06,7.0,-31.42,-24.96,0.0,162.0,           ,1.0,1.0,51.0
6905,Muut,2020-08-07 00:27:57.669902910,2020-08-07,2020-08-07,2020-08-07,7.0,-18.02,-42.98,0.0,162.0,           ,1.0,1.0,49.0
6906,Ruoka_paivittaistavarakauppa,2020-08-07 10:01:09.902912619,2020-08-07,2020-08-07,2020-08-07,7.0,-13.74,-56.72,0.0,162.0,           ,1.0,1.0,145.0
6907,Tulot,2020-08-07 14:54:45.436893201,2020-08-07,2020-08-07,2020-08-07,7.0,437.26,380.54,701.0,521.0,           ,1.0,1.0,202.0
6908,Ruoka_paivittaistavarakauppa,2020-08-07 19:48:20.970873783,2020-08-07,2020-08-07,2020-08-07,7.0,-7.72,372.82,0.0,162.0,           ,1.0,1.0,108.0
6909,Tulot,2020-08-09 00:41:56.504854365,2020-08-09,2020-08-09,2020-08-09,7.0,242.85,615.67,0.0,506.0,           ,1.0,1.0,190.0
6910,Ruoka_paivittaistavarakauppa,2020-08-10 10:15:08.737864074,2020-08-10,2020-08-10,2020-08-10,7.0,-19.79,595.88,0.0,162.0,           ,1.0,1.0,105.0
6911,Kulttuuri_viihde,2020-08-10 15:08:44.271844656,2020-08-10,2020-08-10,2020-08-10,7.0,-1.67,594.21,0.0,162.0,           ,1.0,1.0,113.0
6912,Muut,2020-08-11 05:35:32.038834947,2020-08-11,2020-08-11,2020-08-11,7.0,-3.37,590.84,0.0,162.0,           ,1.0,1.0,69.0
6913,Shoppailu,2020-08-11 20:02:19.805825238,2020-08-11,2020-08-11,2020-08-11,7.0,-27.08,563.76,0.0,162.0,           ,1.0,1.0,127.0
6914,Ravintolat_kahvilat,2020-08-12 00:55:55.339805820,2020-08-12,2020-08-12,2020-08-11,7.0,-3.59,560.17,0.0,162.0,           ,1.0,1.0,84.0
6915,Ruoka_paivittaistavarakauppa,2020-08-12 05:49:30.873786402,2020-08-12,2020-08-12,2020-08-12,7.0,-21.97,538.2,0.0,162.0,           ,1.0,1.0,75.0
6916,Liikkuminen,2020-08-12 15:22:43.106796111,2020-08-12,2020-08-12,2020-08-12,7.0,-16.12,522.08,0.0,162.0,           ,1.0,1.0,40.0
6917,Saastot_sijoitukset,2020-08-12 20:16:18.640776693,2020-08-12,2020-08-12,2020-08-12,7.0,-69.14,452.94,0.0,162.0,           ,1.0,1.0,109.0
6918,Tulot,2020-08-13 10:29:07.572815529,2020-08-13,2020-08-13,2020-08-13,7.0,-14.06,438.88,0.0,162.0,           ,1.0,1.0,118.0
6919,Luottojen_maksut,2020-08-14 10:43:06.407766984,2020-08-14,2020-08-14,2020-08-14,7.0,-38.32,400.56,0.0,162.0,           ,1.0,1.0,136.0
6920,Ruoka_paivittaistavarakauppa,2020-08-17 01:09:54.174757275,2020-08-17,2020-08-17,2020-08-17,7.0,-8.69,391.87,0.0,162.0,           ,1.0,1.0,107.0
6921,Ruoka_paivittaistavarakauppa,2020-08-17 06:03:29.708737857,2020-08-17,2020-08-17,2020-08-17,7.0,-7.31,384.56,0.0,162.0,           ,1.0,1.0,48.0
6922,Ruoka_paivittaistavarakauppa,2020-08-17 15:36:41.941747566,2020-08-17,2020-08-17,2020-08-17,7.0,-9.72,374.84,0.0,162.0,           ,1.0,1.0,63.0
6923,Tulot,2020-08-17 20:30:17.475728148,2020-08-17,2020-08-17,2020-08-17,7.0,194.99,569.83,0.0,506.0,           ,1.0,1.0,190.0
6924,Lemmikit,2020-08-18 10:57:05.242718439,2020-08-18,2020-08-18,2020-08-18,7.0,-12.41,557.42,0.0,162.0,           ,1.0,1.0,40.0
6925,Ruoka_paivittaistavarakauppa,2020-08-19 01:23:53.009708730,2020-08-19,2020-08-19,2020-08-19,7.0,-6.53,550.89,0.0,162.0,           ,1.0,1.0,156.0
6926,Muut,2020-08-19 01:37:51.844660185,2020-08-19,2020-08-19,2020-08-19,7.0,-0.13,550.76,0.0,103.0,           ,0.0,1.0,1.0
6927,Lapset,2020-08-19 11:11:04.077669894,2020-08-19,2020-08-19,2020-08-19,7.0,-12.36,538.4,0.0,162.0,           ,1.0,1.0,59.0
6928,Liikkuminen,2020-08-19 15:50:40.776699021,2020-08-19,2020-08-19,2020-08-19,7.0,-59.3,479.1,0.0,162.0,           ,1.0,1.0,106.0
6929,Ruoka_paivittaistavarakauppa,2020-08-20 06:17:28.543689312,2020-08-20,2020-08-20,2020-08-20,7.0,-37.94,441.16,0.0,162.0,           ,1.0,1.0,96.0
6930,Kulttuuri_viihde,2020-08-20 20:44:16.310679603,2020-08-20,2020-08-20,2020-08-20,7.0,-33.92,407.24,0.0,162.0,           ,1.0,1.0,107.0
6931,Tulot,2020-08-22 16:04:39.611650476,2020-08-22,2020-08-22,2020-08-22,7.0,31.81,439.05,0.0,506.0,           ,1.0,1.0,189.0
6932,Hyvinvointi,2020-08-24 01:51:50.679611640,2020-08-24,2020-08-24,2020-08-24,7.0,-14.05,425.0,0.0,162.0,           ,1.0,1.0,156.0
6933,Ruoka_paivittaistavarakauppa,2020-08-24 06:31:27.378640767,2020-08-24,2020-08-24,2020-08-24,7.0,-16.56,408.44,0.0,162.0,           ,1.0,1.0,72.0
6934,Lapset,2020-08-24 11:25:02.912621349,2020-08-24,2020-08-27,2020-08-24,7.0,-54.02,354.42,0.0,162.0,           ,1.0,1.0,101.0
6935,Ruoka_paivittaistavarakauppa,2020-08-24 16:18:38.446601931,2020-08-24,2020-08-24,2020-08-24,7.0,-12.04,342.38,0.0,162.0,           ,1.0,1.0,162.0
6936,Muut,2020-08-24 20:58:15.145631058,2020-08-24,2020-08-26,2020-08-24,7.0,-1.66,340.72,0.0,162.0,           ,1.0,1.0,113.0
6937,Luottojen_maksut,2020-08-26 21:12:13.980582513,2020-08-26,2020-08-26,2020-08-26,7.0,-51.56,289.16,706.0,129.0,OKOYFIHH   ,0.0,0.0,217.0
6938,Shoppailu,2020-08-27 02:05:49.514563095,2020-08-27,2020-08-27,2020-08-27,7.0,-19.11,270.05,0.0,162.0,           ,1.0,1.0,167.0
6939,Ruoka_paivittaistavarakauppa,2020-08-27 11:39:01.747572804,2020-08-27,2020-08-27,2020-08-27,7.0,-96.04,174.01,0.0,162.0,           ,1.0,1.0,116.0
6940,Tulot,2020-08-28 06:45:26.213592222,2020-08-28,2020-08-28,2020-08-28,7.0,70.76,244.77,0.0,506.0,           ,1.0,1.0,192.0
6941,Liikkuminen,2020-08-28 11:53:00.582524259,2020-08-28,2020-09-01,2020-08-28,7.0,-90.36,154.41,0.0,162.0,           ,1.0,1.0,120.0
6942,Ruoka_paivittaistavarakauppa,2020-08-28 16:32:37.281553386,2020-08-28,2020-08-28,2020-08-28,7.0,-11.34,143.07,0.0,162.0,           ,1.0,1.0,84.0
6943,Asuminen,2020-08-28 21:26:12.815533968,2020-08-28,2020-08-28,2020-08-28,7.0,-13.15,129.92,0.0,162.0,           ,1.0,1.0,125.0
6944,Asuminen,2020-08-31 02:19:48.349514550,2020-08-31,2020-08-31,2020-08-31,7.0,-40.08,89.84,706.0,129.0,OKOYFIHH   ,0.0,0.0,218.0
6945,Lapset,2020-08-31 06:59:25.048543677,2020-08-31,2020-08-31,2020-08-31,7.0,-11.7,78.14,0.0,162.0,           ,1.0,1.0,145.0
6946,Luottojen_maksut,2020-08-31 16:46:36.116504841,2020-08-31,2020-08-31,2020-08-31,7.0,-29.47,48.67,0.0,162.0,           ,1.0,1.0,155.0
6947,Liikkuminen,2020-09-01 21:29:33.134328358,2020-09-01,2020-09-03,2020-09-01,7.0,-12.44,36.23,0.0,162.0,           ,1.0,1.0,146.0
6948,Lapset,2020-09-02 18:59:06.268656716,2020-09-02,2020-09-02,2020-09-02,7.0,-7.94,28.29,0.0,106.0,OKOYFIHH   ,0.0,0.0,9.0
6949,Tulot,2020-09-03 16:28:39.402985074,2020-09-03,2020-09-03,2020-09-03,7.0,18.03,46.32,0.0,506.0,           ,1.0,1.0,190.0
6950,Tulot,2020-09-04 11:27:45.671641790,2020-09-04,2020-09-04,2020-09-04,7.0,3.93,50.25,0.0,506.0,           ,1.0,1.0,192.0
6951,Lapset,2020-09-04 13:58:12.537313432,2020-09-04,2020-09-04,2020-09-04,7.0,-3.43,46.82,0.0,162.0,           ,1.0,1.0,149.0
6952,Tulot,2020-09-06 08:57:18.805970148,2020-09-06,2020-09-06,2020-09-06,7.0,64.57,111.39,0.0,506.0,           ,1.0,1.0,191.0
6953,Ruoka_paivittaistavarakauppa,2020-09-07 06:26:51.940298506,2020-09-07,2020-09-07,2020-09-07,7.0,-2.43,108.96,0.0,162.0,           ,1.0,1.0,122.0
6954,Lemmikit,2020-09-08 01:25:58.208955222,2020-09-08,2020-09-08,2020-09-08,7.0,-4.91,104.05,706.0,129.0,OKOYFIHH   ,0.0,0.0,212.0
6955,Vakuutukset,2020-09-09 03:56:25.074626864,2020-09-09,2020-09-09,2020-09-09,7.0,-182.52,-78.47,706.0,129.0,OKOYFIHH   ,0.0,0.0,213.0
6956,Tulot,2020-09-10 15:24:10.746268654,2020-09-10,2020-09-10,2020-09-10,7.0,108.54,30.07,0.0,506.0,           ,1.0,1.0,192.0
6957,Tulot,2020-09-10 17:54:37.611940296,2020-09-10,2020-09-10,2020-09-10,7.0,526.46,556.53,701.0,510.0,           ,1.0,1.0,197.0
6958,Tulot,2020-09-10 20:25:04.477611938,2020-09-10,2020-09-10,2020-09-10,7.0,14.95,571.48,0.0,506.0,           ,1.0,1.0,193.0
6959,Luokittelemattomat,2020-09-10 22:55:31.343283580,2020-09-10,2020-09-10,2020-09-10,7.0,-74.29,497.19,706.0,129.0,OKOYFIHH   ,0.0,0.0,212.0
6960,Asuminen,2020-09-14 10:23:17.014925370,2020-09-14,2020-09-14,2020-09-14,7.0,-44.25,452.94,706.0,129.0,NDEAFIHH   ,0.0,0.0,213.0
6961,Muut,2020-09-15 07:52:50.149253728,2020-09-15,2020-09-17,2020-09-15,7.0,-64.91,388.03,706.0,105.0,OKOYFIHH   ,1.0,0.0,206.0
6962,Asuminen,2020-09-15 12:53:43.880597012,2020-09-15,2020-09-15,2020-09-15,7.0,-11.29,376.74,706.0,129.0,DABAFIHH   ,0.0,0.0,217.0
6963,Asuminen,2020-09-16 05:22:23.283582086,2020-09-16,2020-09-18,2020-09-16,7.0,-19.47,357.27,706.0,129.0,OKOYFIHH   ,0.0,0.0,217.0
6964,Ruoka_paivittaistavarakauppa,2020-09-17 02:51:56.417910444,2020-09-17,2020-09-17,2020-09-17,7.0,-26.08,331.19,0.0,162.0,           ,1.0,1.0,156.0
6965,Ruoka_paivittaistavarakauppa,2020-09-18 00:21:29.552238802,2020-09-18,2020-09-18,2020-09-18,7.0,-10.31,320.88,0.0,162.0,           ,1.0,1.0,96.0
6966,Ruoka_paivittaistavarakauppa,2020-09-18 19:20:35.820895518,2020-09-18,2020-09-18,2020-09-18,7.0,-7.69,313.19,0.0,162.0,           ,1.0,1.0,113.0
6967,Liikkuminen,2020-09-18 21:51:02.686567160,2020-09-18,2020-09-18,2020-09-18,7.0,-61.97,251.22,0.0,106.0,OKOYFIHH   ,0.0,0.0,12.0
6968,Luokittelemattomat,2020-09-21 11:49:15.223880592,2020-09-21,2020-09-21,2020-09-21,7.0,-13.15,238.07,0.0,162.0,           ,1.0,1.0,84.0
6969,Ruoka_paivittaistavarakauppa,2020-09-21 14:19:42.089552234,2020-09-21,2020-09-21,2020-09-21,7.0,-8.88,229.19,0.0,162.0,           ,1.0,1.0,85.0
6970,Matkailu,2020-09-21 16:50:08.955223876,2020-09-21,2020-09-21,2020-09-21,7.0,-36.12,193.07,0.0,162.0,           ,1.0,1.0,123.0
6971,Hyvinvointi,2020-09-23 09:18:48.358208950,2020-09-23,2020-09-23,2020-09-23,7.0,-64.38,128.69,706.0,129.0,OKOYFIHH   ,0.0,0.0,218.0
6972,Ruoka_paivittaistavarakauppa,2020-09-24 06:48:21.492537308,2020-09-24,2020-09-24,2020-09-24,7.0,-3.97,124.72,0.0,162.0,           ,1.0,1.0,95.0
6973,Ravintolat_kahvilat,2020-09-25 04:17:54.626865666,2020-09-25,2020-09-25,2020-09-25,7.0,-40.96,83.76,0.0,162.0,           ,1.0,1.0,85.0
6974,Ruoka_paivittaistavarakauppa,2020-09-25 23:17:00.895522382,2020-09-25,2020-09-25,2020-09-25,7.0,-5.93,77.83,0.0,162.0,           ,1.0,1.0,135.0
6975,Liikkuminen,2020-09-28 01:47:27.761194024,2020-09-28,2020-09-28,2020-09-28,7.0,-11.05,66.78,0.0,162.0,           ,1.0,1.0,42.0
6976,Luokittelemattomat,2020-09-28 15:45:40.298507456,2020-09-28,2020-09-28,2020-09-28,7.0,-26.14,40.64,0.0,162.0,           ,1.0,1.0,78.0
6977,Shoppailu,2020-09-28 18:16:07.164179098,2020-09-28,2020-09-28,2020-09-28,7.0,-5.49,35.15,0.0,162.0,           ,1.0,1.0,99.0
6978,Ravintolat_kahvilat,2020-09-28 20:46:34.029850740,2020-09-28,2020-09-28,2020-09-28,7.0,-1.2,33.95,0.0,162.0,           ,1.0,1.0,101.0
6979,Shoppailu,2020-09-29 13:15:13.432835814,2020-09-29,2020-09-29,2020-09-29,7.0,-10.11,23.84,0.0,162.0,           ,1.0,1.0,69.0
6980,Muut,2020-10-01 14:26:47.766990291,2020-10-01,2020-10-01,2020-10-01,7.0,-27.09,-3.25,706.0,106.0,NDEAFIHH   ,0.0,0.0,210.0
6981,Vakuutukset,2020-10-02 04:53:35.533980582,2020-10-02,2020-10-02,2020-10-02,7.0,-22.09,-25.34,706.0,129.0,DABAFIHH   ,0.0,0.0,218.0
6982,Ruoka_paivittaistavarakauppa,2020-10-02 19:20:23.300970873,2020-10-02,2020-10-02,2020-10-02,7.0,-0.82,-26.16,0.0,162.0,           ,1.0,1.0,102.0
6983,Lapset,2020-10-05 00:13:58.834951455,2020-10-05,2020-10-05,2020-10-05,7.0,-3.73,-29.89,0.0,162.0,           ,1.0,1.0,97.0
6984,Ruoka_paivittaistavarakauppa,2020-10-05 05:07:34.368932037,2020-10-05,2020-10-05,2020-10-05,7.0,-16.74,-46.63,0.0,162.0,           ,1.0,1.0,83.0
6985,Muut,2020-10-05 09:47:11.067961164,2020-10-05,2020-10-05,2020-10-05,7.0,-5.78,-52.41,0.0,162.0,           ,1.0,1.0,121.0
6986,Ruoka_paivittaistavarakauppa,2020-10-05 10:01:09.902912619,2020-10-05,2020-10-05,2020-10-05,7.0,-19.04,-71.45,0.0,162.0,           ,1.0,1.0,106.0
6987,Kulttuuri_viihde,2020-10-05 14:40:46.601941746,2020-10-05,2020-10-05,2020-10-05,7.0,-5.27,-76.72,0.0,162.0,           ,1.0,1.0,112.0
6988,Ruoka_paivittaistavarakauppa,2020-10-05 19:34:22.135922328,2020-10-05,2020-10-05,2020-10-05,7.0,-3.48,-80.2,0.0,162.0,           ,1.0,1.0,120.0
6989,Ravintolat_kahvilat,2020-10-07 00:27:57.669902910,2020-10-07,2020-10-07,2020-10-07,7.0,-0.48,-80.68,0.0,162.0,           ,1.0,1.0,92.0
6990,Ruoka_paivittaistavarakauppa,2020-10-07 05:21:33.203883492,2020-10-07,2020-10-07,2020-10-07,7.0,-9.05,-89.73,0.0,162.0,           ,1.0,1.0,40.0
6991,Luokittelemattomat,2020-10-08 14:54:45.436893201,2020-10-08,2020-10-08,2020-10-08,7.0,-1.37,-91.1,0.0,162.0,           ,1.0,1.0,134.0
6992,Ruoka_paivittaistavarakauppa,2020-10-08 19:48:20.970873783,2020-10-08,2020-10-08,2020-10-08,7.0,-7.6,-98.7,0.0,162.0,           ,1.0,1.0,92.0
6993,Ruoka_paivittaistavarakauppa,2020-10-09 00:41:56.504854365,2020-10-09,2020-10-09,2020-10-09,7.0,-2.22,-100.92,0.0,162.0,           ,1.0,1.0,107.0
6994,Muut,2020-10-09 10:15:08.737864074,2020-10-09,2020-10-09,2020-10-09,7.0,-4.72,-105.64,0.0,162.0,           ,1.0,1.0,116.0
6995,Ruoka_paivittaistavarakauppa,2020-10-12 00:55:55.339805820,2020-10-12,2020-10-12,2020-10-12,7.0,-2.89,-108.53,0.0,162.0,           ,1.0,1.0,61.0
6996,Luottojen_maksut,2020-10-12 05:35:32.038834947,2020-10-12,2020-10-12,2020-10-12,7.0,-1617.02,-1725.55,706.0,106.0,NDEAFIHH   ,0.0,0.0,209.0
6997,Ruoka_paivittaistavarakauppa,2020-10-12 10:29:07.572815529,2020-10-07,2020-10-12,2020-10-12,7.0,-3.02,-1728.57,0.0,162.0,           ,1.0,1.0,109.0
6998,Asuminen,2020-10-12 15:08:44.271844656,2020-10-12,2020-10-12,2020-10-12,7.0,-16.87,-1745.44,706.0,106.0,DABAFIHH   ,0.0,0.0,211.0
6999,Ruoka_paivittaistavarakauppa,2020-10-12 15:22:43.106796111,2020-10-12,2020-10-12,2020-10-09,7.0,-2.68,-1748.12,0.0,162.0,           ,1.0,1.0,129.0
7000,Luottojen_maksut,2020-10-12 20:02:19.805825238,2020-10-12,2020-10-12,2020-10-12,7.0,-8.83,-1756.95,0.0,106.0,NDEAFIHH   ,1.0,0.0,19.0
7001,Muut,2020-10-14 05:49:30.873786402,2020-10-14,2020-10-14,2020-10-14,7.0,-21.44,-1778.39,0.0,162.0,           ,1.0,1.0,61.0
7002,Ruoka_paivittaistavarakauppa,2020-10-15 01:09:54.174757275,2020-10-15,2020-10-15,2020-10-14,7.0,-17.76,-1796.15,0.0,162.0,           ,1.0,1.0,122.0
7003,Liikkuminen,2020-10-15 10:43:06.407766984,2020-10-15,2020-10-15,2020-10-15,7.0,-2.62,-1798.77,0.0,162.0,           ,1.0,1.0,114.0
7004,Ruoka_paivittaistavarakauppa,2020-10-16 06:03:29.708737857,2020-10-16,2020-10-16,2020-10-16,7.0,-15.78,-1814.55,0.0,162.0,           ,1.0,1.0,94.0
7005,Ruoka_paivittaistavarakauppa,2020-10-16 15:36:41.941747566,2020-10-16,2020-10-16,2020-10-16,7.0,-4.08,-1818.63,0.0,162.0,           ,1.0,1.0,55.0
7006,Ruoka_paivittaistavarakauppa,2020-10-16 20:16:18.640776693,2020-10-16,2020-10-16,2020-10-16,7.0,-25.41,-1844.04,0.0,162.0,           ,1.0,1.0,152.0
7007,Ruoka_paivittaistavarakauppa,2020-10-16 20:30:17.475728148,2020-10-16,2020-10-16,2020-10-16,7.0,-82.8,-1926.84,0.0,162.0,           ,1.0,1.0,104.0
7008,Ruoka_paivittaistavarakauppa,2020-10-19 01:23:53.009708730,2020-10-19,2020-10-19,2020-10-19,7.0,-3.15,-1929.99,0.0,162.0,           ,1.0,1.0,41.0
7009,Liikkuminen,2020-10-19 10:57:05.242718439,2020-10-19,2020-10-19,2020-10-19,7.0,-30.89,-1960.88,0.0,162.0,           ,1.0,1.0,165.0
7010,Hyvinvointi,2020-10-19 15:50:40.776699021,2020-10-19,2020-10-19,2020-10-19,7.0,-4.09,-1964.97,0.0,162.0,           ,1.0,1.0,106.0
7011,Luokittelemattomat,2020-10-20 06:17:28.543689312,2020-10-20,2020-10-20,2020-10-20,7.0,-1.37,-1966.34,0.0,162.0,           ,1.0,1.0,131.0
7012,Ruoka_paivittaistavarakauppa,2020-10-20 20:44:16.310679603,2020-10-20,2020-10-20,2020-10-19,7.0,-19.89,-1986.23,0.0,162.0,           ,1.0,1.0,106.0
7013,Ravintolat_kahvilat,2020-10-21 01:37:51.844660185,2020-10-21,2020-10-21,2020-10-21,7.0,-9.42,-1995.65,0.0,162.0,           ,1.0,1.0,123.0
7014,Lemmikit,2020-10-21 11:11:04.077669894,2020-10-21,2020-10-21,2020-10-21,7.0,-26.25,-2021.9,0.0,162.0,           ,1.0,1.0,61.0
7015,Ruoka_paivittaistavarakauppa,2020-10-22 20:58:15.145631058,2020-10-22,2020-10-22,2020-10-22,7.0,-3.03,-2024.93,0.0,162.0,           ,1.0,1.0,152.0
7016,Ruoka_paivittaistavarakauppa,2020-10-23 06:31:27.378640767,2020-10-23,2020-10-23,2020-10-23,7.0,-1.06,-2025.99,0.0,162.0,           ,1.0,1.0,42.0
7017,Ruoka_paivittaistavarakauppa,2020-10-23 11:25:02.912621349,2020-10-23,2020-10-23,2020-10-23,7.0,-2.09,-2028.08,0.0,162.0,           ,1.0,1.0,48.0
7018,Ruoka_paivittaistavarakauppa,2020-10-23 16:04:39.611650476,2020-10-23,2020-10-23,2020-10-23,7.0,-10.4,-2038.48,0.0,162.0,           ,1.0,1.0,108.0
7019,Ruoka_paivittaistavarakauppa,2020-10-26 01:51:50.679611640,2020-10-26,2020-10-26,2020-10-26,7.0,-6.29,-2044.77,0.0,162.0,           ,1.0,1.0,83.0
7020,Ruoka_paivittaistavarakauppa,2020-10-26 06:45:26.213592222,2020-10-26,2020-10-26,2020-10-26,7.0,-5.82,-2050.59,0.0,162.0,           ,1.0,1.0,97.0
7021,Ruoka_paivittaistavarakauppa,2020-10-26 16:18:38.446601931,2020-10-26,2020-10-26,2020-10-26,7.0,-1.51,-2052.1,0.0,162.0,           ,1.0,1.0,113.0
7022,Kulttuuri_viihde,2020-10-26 21:12:13.980582513,2020-10-26,2020-10-27,2020-10-26,7.0,-13.75,-2065.85,0.0,162.0,           ,1.0,1.0,108.0
7023,Ruoka_paivittaistavarakauppa,2020-10-27 11:39:01.747572804,2020-10-27,2020-10-27,2020-10-27,7.0,-3.84,-2069.69,0.0,162.0,           ,1.0,1.0,116.0
7024,Harrastukset,2020-10-28 02:05:49.514563095,2020-10-28,2020-10-28,2020-10-28,7.0,-2.85,-2072.54,0.0,162.0,           ,1.0,1.0,103.0
7025,Ruoka_paivittaistavarakauppa,2020-10-29 06:59:25.048543677,2020-10-29,2020-10-29,2020-10-29,7.0,-2.39,-2074.93,0.0,162.0,           ,1.0,1.0,40.0
7026,Liikkuminen,2020-10-29 16:32:37.281553386,2020-10-29,2020-10-30,2020-10-29,7.0,-5.71,-2080.64,0.0,162.0,           ,1.0,1.0,126.0
7027,Matkailu,2020-10-30 02:19:48.349514550,2020-10-30,2020-10-30,2020-10-30,7.0,-9.33,-2089.97,706.0,106.0,NDEAFIHH   ,0.0,0.0,208.0
7028,Matkailu,2020-10-30 11:53:00.582524259,2020-10-30,2020-10-30,2020-10-30,7.0,-22.93,-2112.9,0.0,162.0,           ,1.0,1.0,134.0
7029,Ruoka_paivittaistavarakauppa,2020-10-30 16:46:36.116504841,2020-10-30,2020-10-30,2020-10-30,7.0,-1.74,-2114.64,0.0,162.0,           ,1.0,1.0,40.0
7030,Luokittelemattomat,2020-10-30 21:26:12.815533968,2020-10-30,2020-10-30,2020-10-30,7.0,-26.86,-2141.5,0.0,162.0,           ,1.0,1.0,111.0
7031,Liikkuminen,2020-11-02 17:08:34.285714285,2020-11-02,2020-11-02,2020-11-02,7.0,-3.56,-2145.06,0.0,162.0,           ,1.0,1.0,156.0
7032,Ruoka_paivittaistavarakauppa,2020-11-04 10:17:08.571428570,2020-11-04,2020-11-04,2020-11-04,7.0,-6.33,-2151.39,0.0,162.0,           ,1.0,1.0,55.0
7033,Luokittelemattomat,2020-11-06 03:25:42.857142855,2020-11-06,2020-11-06,2020-11-06,7.0,-4.55,-2155.94,0.0,162.0,           ,1.0,1.0,135.0
7034,Muut,2020-11-06 20:34:17.142857140,2020-11-06,2020-11-06,2020-11-06,7.0,-20.67,-2176.61,0.0,162.0,           ,1.0,1.0,74.0
7035,Ruoka_paivittaistavarakauppa,2020-11-09 13:42:51.428571425,2020-11-09,2020-11-10,2020-11-09,7.0,-39.47,-2216.08,0.0,162.0,           ,1.0,1.0,102.0
7036,Ruoka_paivittaistavarakauppa,2020-11-11 06:51:25.714285710,2020-11-11,2020-11-11,2020-11-11,7.0,-3.52,-2219.6,0.0,162.0,           ,1.0,1.0,69.0
7037,Ruoka_paivittaistavarakauppa,2020-11-12 17:08:34.285714280,2020-11-12,2020-11-12,2020-11-12,7.0,-23.73,-2243.33,0.0,162.0,           ,1.0,1.0,48.0
7038,Ruoka_paivittaistavarakauppa,2020-11-12 23:59:59.999999995,2020-11-12,2020-11-13,2020-11-12,7.0,-1.3,-2244.63,0.0,162.0,           ,1.0,1.0,138.0
7039,Ruoka_paivittaistavarakauppa,2020-11-16 10:17:08.571428565,2020-11-16,2020-11-16,2020-11-16,7.0,-2.09,-2246.72,0.0,162.0,           ,1.0,1.0,126.0
7040,Ruoka_paivittaistavarakauppa,2020-11-18 03:25:42.857142850,2020-11-18,2020-11-18,2020-11-18,7.0,-13.88,-2260.6,0.0,162.0,           ,1.0,1.0,168.0
7041,Ruoka_paivittaistavarakauppa,2020-11-20 13:42:51.428571420,2020-11-20,2020-11-20,2020-11-20,7.0,-4.0,-2264.6,0.0,162.0,           ,1.0,1.0,93.0
7042,Tulot,2020-11-20 20:34:17.142857135,2020-11-20,2020-11-20,2020-11-20,7.0,3108.44,843.84,701.0,520.0,           ,1.0,1.0,201.0
7043,Hyvinvointijakauneus,2020-11-23 06:51:25.714285705,2020-11-23,2020-11-23,2020-11-23,7.0,-25.14,818.7,0.0,162.0,           ,1.0,1.0,144.0
7044,Saastot_sijoitukset,2020-11-24 23:59:59.999999990,2020-11-24,2020-11-24,2020-11-24,7.0,-14.86,803.84,0.0,162.0,           ,1.0,1.0,124.0
7045,Muut,2020-11-26 17:08:34.285714275,2020-11-26,2020-11-26,2020-11-26,7.0,-34.13,769.71,0.0,162.0,           ,1.0,1.0,156.0
7046,Ravintolat_kahvilat,2020-11-27 10:17:08.571428560,2020-11-27,2020-11-27,2020-11-27,7.0,-1.19,768.52,0.0,162.0,           ,1.0,1.0,100.0
7047,Ruoka_paivittaistavarakauppa,2020-11-30 03:25:42.857142845,2020-11-30,2020-11-30,2020-11-30,7.0,-4.02,764.5,0.0,162.0,           ,1.0,1.0,124.0
7048,Liikkuminen,2020-12-01 17:30:21.176470588,2020-12-01,2020-12-01,2020-12-01,7.0,-5.4,759.1,0.0,162.0,           ,1.0,1.0,123.0
7049,Ruoka_paivittaistavarakauppa,2020-12-02 11:00:42.352941176,2020-12-02,2020-12-02,2020-12-02,7.0,-23.87,735.23,0.0,162.0,           ,1.0,1.0,134.0
7050,Hyvinvointijakauneus,2020-12-03 04:31:03.529411764,2020-12-03,2020-12-03,2020-12-03,7.0,-42.1,693.13,0.0,162.0,           ,1.0,1.0,145.0
7051,Ruoka_paivittaistavarakauppa,2020-12-03 22:01:24.705882352,2020-12-03,2020-12-03,2020-12-03,7.0,-13.17,679.96,0.0,162.0,           ,1.0,1.0,134.0
7052,Ruoka_paivittaistavarakauppa,2020-12-04 09:02:07.058823528,2020-12-04,2020-12-04,2020-12-04,7.0,-39.2,640.76,0.0,162.0,           ,1.0,1.0,109.0
7053,Ravintolat_kahvilat,2020-12-04 15:31:45.882352940,2020-12-04,2020-12-04,2020-12-04,7.0,-6.24,634.52,0.0,162.0,           ,1.0,1.0,48.0
7054,Ruoka_paivittaistavarakauppa,2020-12-04 20:02:49.411764704,2020-12-04,2020-12-04,2020-12-04,7.0,-26.87,607.65,0.0,162.0,           ,1.0,1.0,92.0
7055,Ruoka_paivittaistavarakauppa,2020-12-07 02:32:28.235294116,2020-12-07,2020-12-08,2020-12-07,7.0,-17.66,589.99,0.0,162.0,           ,1.0,1.0,139.0
7056,Ruoka_paivittaistavarakauppa,2020-12-07 13:33:10.588235292,2020-12-07,2020-12-07,2020-12-07,7.0,-20.49,569.5,0.0,162.0,           ,1.0,1.0,85.0
7057,Liikkuminen,2020-12-08 07:03:31.764705880,2020-12-08,2020-12-08,2020-12-08,7.0,-15.37,554.13,0.0,162.0,           ,1.0,1.0,107.0
7058,Ruoka_paivittaistavarakauppa,2020-12-09 00:33:52.941176468,2020-12-09,2020-12-09,2020-12-09,7.0,-28.8,525.33,0.0,162.0,           ,1.0,1.0,123.0
7059,Liikkuminen,2020-12-09 18:04:14.117647056,2020-12-09,2020-12-09,2020-12-09,7.0,-84.49,440.84,0.0,162.0,           ,1.0,1.0,145.0
7060,Ruoka_paivittaistavarakauppa,2020-12-10 11:34:35.294117644,2020-12-10,2020-12-10,2020-12-10,7.0,-3.35,437.49,0.0,162.0,           ,1.0,1.0,102.0
7061,Ruoka_paivittaistavarakauppa,2020-12-11 05:04:56.470588232,2020-12-11,2020-12-11,2020-12-11,7.0,-11.94,425.55,0.0,162.0,           ,1.0,1.0,112.0
7062,Liikkuminen,2020-12-11 22:35:17.647058820,2020-12-11,2020-12-11,2020-12-11,7.0,-1.82,423.73,0.0,162.0,           ,1.0,1.0,156.0
7063,Ravintolat_kahvilat,2020-12-14 03:06:21.176470584,2020-12-14,2020-12-14,2020-12-14,7.0,-32.95,390.78,0.0,162.0,           ,1.0,1.0,113.0
7064,Liikkuminen,2020-12-14 09:35:59.999999996,2020-12-14,2020-12-14,2020-12-14,7.0,-80.35,310.43,0.0,162.0,           ,1.0,1.0,96.0
7065,Ruoka_paivittaistavarakauppa,2020-12-14 16:05:38.823529408,2020-12-14,2020-12-14,2020-12-14,7.0,-19.46,290.97,0.0,162.0,           ,1.0,1.0,153.0
7066,Ruoka_paivittaistavarakauppa,2020-12-14 20:36:42.352941172,2020-12-14,2020-12-14,2020-12-14,7.0,-50.8,240.17,0.0,162.0,           ,1.0,1.0,137.0
7067,Ruoka_paivittaistavarakauppa,2020-12-15 14:07:03.529411760,2020-12-15,2020-12-15,2020-12-15,7.0,-42.86,197.31,0.0,162.0,           ,1.0,1.0,94.0
7068,Harrastukset,2020-12-16 07:37:24.705882348,2020-12-16,2020-12-16,2020-12-16,7.0,-2.07,195.24,0.0,162.0,           ,1.0,1.0,44.0
7069,Shoppailu,2020-12-17 01:07:45.882352936,2020-12-17,2020-12-17,2020-12-17,7.0,-111.87,83.37,0.0,162.0,           ,1.0,1.0,98.0
7070,Kulttuuri_viihde,2020-12-17 18:38:07.058823524,2020-12-17,2020-12-17,2020-12-17,7.0,-5.98,77.39,0.0,162.0,           ,1.0,1.0,149.0
7071,Hyvinvointijakauneus,2020-12-18 05:38:49.411764700,2020-12-18,2020-12-18,2020-12-18,7.0,-13.71,63.68,0.0,162.0,           ,1.0,1.0,43.0
7072,Muut,2020-12-18 12:08:28.235294112,2020-12-18,2020-12-18,2020-12-18,7.0,-15.75,47.93,0.0,163.0,           ,1.0,1.0,174.0
7073,Liikkuminen,2020-12-21 03:40:14.117647052,2020-12-21,2020-12-21,2020-12-21,7.0,-24.31,23.62,0.0,162.0,           ,1.0,1.0,94.0
7074,Ruoka_paivittaistavarakauppa,2020-12-21 10:09:52.941176464,2020-12-21,2020-12-21,2020-12-21,7.0,-10.69,12.93,0.0,162.0,           ,1.0,1.0,84.0
7075,Ravintolat_kahvilat,2020-12-21 14:40:56.470588228,2020-12-21,2020-12-21,2020-12-21,7.0,-8.42,4.51,0.0,162.0,           ,1.0,1.0,40.0
7076,Ruoka_paivittaistavarakauppa,2020-12-21 16:39:31.764705876,2020-12-21,2020-12-21,2020-12-21,7.0,-3.94,0.57,0.0,162.0,           ,1.0,1.0,156.0
7077,Ruoka_paivittaistavarakauppa,2020-12-21 23:09:10.588235288,2020-12-21,2020-12-21,2020-12-21,7.0,-0.59,-0.02,0.0,162.0,           ,1.0,1.0,85.0
7078,Ruoka_paivittaistavarakauppa,2020-12-23 08:11:17.647058816,2020-12-23,2020-12-23,2020-12-23,7.0,-17.2,-17.22,0.0,162.0,           ,1.0,1.0,89.0
7079,Ruoka_paivittaistavarakauppa,2020-12-23 21:10:35.294117640,2020-12-23,2020-12-23,2020-12-23,7.0,-0.44,-17.66,0.0,162.0,           ,1.0,1.0,103.0
7080,Ruoka_paivittaistavarakauppa,2020-12-24 01:41:38.823529404,2020-12-24,2020-12-24,2020-12-24,7.0,-5.5,-23.16,0.0,162.0,           ,1.0,1.0,61.0
7081,Ruoka_paivittaistavarakauppa,2020-12-24 19:11:59.999999992,2020-12-24,2020-12-24,2020-12-24,7.0,-0.68,-23.84,0.0,162.0,           ,1.0,1.0,91.0
7082,Muut,2020-12-25 12:42:21.176470580,2020-12-25,2020-12-25,2020-12-25,7.0,-17.46,-41.3,0.0,162.0,           ,1.0,1.0,111.0
7083,Ruoka_paivittaistavarakauppa,2020-12-28 06:12:42.352941168,2020-12-28,2020-12-28,2020-12-28,7.0,-28.16,-69.46,0.0,162.0,           ,1.0,1.0,46.0
7084,Ravintolat_kahvilat,2020-12-28 10:43:45.882352932,2020-12-28,2020-12-28,2020-12-28,7.0,-7.27,-76.73,0.0,162.0,           ,1.0,1.0,55.0
7085,Luokittelemattomat,2020-12-28 17:13:24.705882344,2020-12-28,2020-12-28,2020-12-28,7.0,-7.23,-83.96,0.0,162.0,           ,1.0,1.0,105.0
7086,Ruoka_paivittaistavarakauppa,2020-12-28 23:43:03.529411756,2020-12-28,2020-12-29,2020-12-28,7.0,-2.87,-86.83,0.0,162.0,           ,1.0,1.0,84.0
7087,Ruoka_paivittaistavarakauppa,2020-12-29 21:44:28.235294108,2020-12-29,2020-12-29,2020-12-29,7.0,-4.53,-91.36,0.0,162.0,           ,1.0,1.0,48.0
7088,Ruoka_paivittaistavarakauppa,2020-12-30 15:14:49.411764696,2020-12-30,2020-12-30,2020-12-30,7.0,-0.78,-92.14,0.0,162.0,           ,1.0,1.0,113.0
7089,Hyvinvointijakauneus,2020-12-31 04:14:07.058823520,2020-12-31,2020-12-31,2020-12-31,7.0,-8.26,-100.4,0.0,162.0,           ,1.0,1.0,60.0
7090,Muut,2019-01-01 00:00:00.000000000,2019-01-01,2019-01-01,2019-01-01,8.0,-33.46,328.31,0.0,162.0,           ,1.0,1.0,156.0
7091,Ruoka_paivittaistavarakauppa,2019-01-01 08:36:04.161849710,2019-01-01,2019-01-01,2019-01-01,8.0,-43.89,284.42,0.0,162.0,           ,1.0,1.0,90.0
7092,Ruoka_paivittaistavarakauppa,2019-01-01 17:12:08.323699420,2019-01-01,2019-01-01,2019-01-01,8.0,-11.82,272.6,0.0,162.0,           ,1.0,1.0,128.0
7093,Asuminen,2019-01-02 01:48:12.485549130,2019-01-02,2019-01-02,2019-01-02,8.0,-24.28,248.32,706.0,129.0,NDEAFIHH   ,0.0,0.0,239.0
7094,Ravintolat_kahvilat,2019-01-02 10:24:16.647398840,2019-01-02,2019-01-02,2019-01-01,8.0,-13.86,234.46,0.0,162.0,           ,1.0,1.0,146.0
7095,Ruoka_paivittaistavarakauppa,2019-01-02 19:00:20.809248550,2019-01-02,2019-01-02,2019-01-02,8.0,-19.54,214.92,0.0,162.0,           ,1.0,1.0,90.0
7096,Ruoka_paivittaistavarakauppa,2019-01-03 03:36:24.971098260,2019-01-03,2019-01-03,2019-01-03,8.0,-5.02,209.9,0.0,162.0,           ,1.0,1.0,116.0
7097,Ruoka_paivittaistavarakauppa,2019-01-03 12:12:29.132947970,2019-01-03,2019-01-03,2019-01-03,8.0,-51.81,158.09,0.0,162.0,           ,1.0,1.0,113.0
7098,Luokittelemattomat,2019-01-03 20:48:33.294797680,2019-01-03,2019-01-03,2019-01-03,8.0,-24.43,133.66,706.0,106.0,OKOYFIHH   ,1.0,0.0,233.0
7099,Muut,2019-01-04 05:24:37.456647390,2019-01-04,2019-01-04,2019-01-04,8.0,-28.8,104.86,0.0,163.0,           ,1.0,1.0,191.0
7100,Ruoka_paivittaistavarakauppa,2019-01-04 07:12:49.942196520,2019-01-04,2019-01-04,2019-01-04,8.0,-5.39,99.47,0.0,162.0,           ,1.0,1.0,167.0
7101,Ravintolat_kahvilat,2019-01-04 14:00:41.618497100,2019-01-04,2019-01-04,2019-01-04,8.0,-12.71,86.76,0.0,162.0,           ,1.0,1.0,138.0
7102,Liikkuminen,2019-01-04 22:36:45.780346810,2019-01-04,2019-01-04,2019-01-04,8.0,-5.47,81.29,0.0,162.0,           ,1.0,1.0,78.0
7103,Ruoka_paivittaistavarakauppa,2019-01-07 00:24:58.265895940,2019-01-07,2019-01-07,2019-01-07,8.0,-34.98,46.31,0.0,162.0,           ,1.0,1.0,133.0
7104,Ravintolat_kahvilat,2019-01-07 02:13:10.751445070,2019-01-07,2019-01-09,2019-01-07,8.0,-6.82,39.49,0.0,162.0,           ,1.0,1.0,133.0
7105,Ruoka_paivittaistavarakauppa,2019-01-07 10:49:14.913294780,2019-01-07,2019-01-07,2019-01-07,8.0,-7.41,32.08,0.0,162.0,           ,1.0,1.0,112.0
7106,Ruoka_paivittaistavarakauppa,2019-01-07 15:48:54.104046230,2019-01-07,2019-01-09,2019-01-07,8.0,-16.49,15.59,0.0,162.0,           ,1.0,1.0,136.0
7107,Matkailu,2019-01-07 17:37:06.589595360,2019-01-07,2019-01-08,2019-01-07,8.0,-2.36,13.23,0.0,162.0,           ,1.0,1.0,68.0
7108,Matkailu,2019-01-08 04:01:23.236994200,2019-01-08,2019-01-08,2019-01-08,8.0,-5.23,8.0,0.0,162.0,           ,1.0,1.0,103.0
7109,Lemmikit,2019-01-08 09:01:02.427745650,2019-01-08,2019-01-08,2019-01-08,8.0,-23.53,-15.53,0.0,162.0,           ,1.0,1.0,147.0
7110,Ruoka_paivittaistavarakauppa,2019-01-08 12:37:27.398843910,2019-01-08,2019-01-08,2019-01-08,8.0,-48.72,-64.25,0.0,162.0,           ,1.0,1.0,126.0
7111,Asuminen,2019-01-08 16:13:52.369942170,2019-01-08,2019-01-08,2019-01-08,8.0,-30.72,-94.97,706.0,129.0,OKOYFIHH   ,0.0,0.0,243.0
7112,Muut,2019-01-08 19:25:19.075144490,2019-01-08,2019-01-08,2019-01-08,8.0,-11.29,-106.26,0.0,163.0,           ,1.0,1.0,192.0
7113,Ruoka_paivittaistavarakauppa,2019-01-08 21:13:31.560693620,2019-01-08,2019-01-08,2019-01-08,8.0,-1.7,-107.96,0.0,162.0,           ,1.0,1.0,52.0
7114,Luokittelemattomat,2019-01-09 14:25:39.884393040,2019-01-09,2019-01-09,2019-01-09,8.0,-82.66,-190.62,706.0,129.0,OKOYFIHH   ,0.0,0.0,238.0
7115,Ruoka_paivittaistavarakauppa,2019-01-09 23:01:44.046242750,2019-01-09,2019-01-09,2019-01-09,8.0,-3.45,-194.07,0.0,162.0,           ,1.0,1.0,109.0
7116,Ruoka_paivittaistavarakauppa,2019-01-10 05:49:35.722543330,2019-01-10,2019-01-10,2019-01-10,8.0,-3.05,-197.12,0.0,162.0,           ,1.0,1.0,113.0
7117,Ruoka_paivittaistavarakauppa,2019-01-10 07:37:48.208092460,2019-01-10,2019-01-10,2019-01-10,8.0,-4.83,-201.95,0.0,162.0,           ,1.0,1.0,39.0
7118,Tulot,2019-01-10 11:14:13.179190720,2019-01-10,2019-01-10,2019-01-10,8.0,266.88,64.93,0.0,574.0,           ,1.0,1.0,219.0
7119,Asuminen,2019-01-10 13:02:25.664739850,2019-01-10,2019-01-10,2019-01-10,8.0,-19.91,45.02,706.0,129.0,OKOYFIHH   ,0.0,0.0,238.0
7120,Terveys,2019-01-11 00:49:56.531791880,2019-01-11,2019-01-11,2019-01-11,8.0,-69.08,-24.06,706.0,129.0,DABAFIHH   ,0.0,0.0,241.0
7121,Ruoka_paivittaistavarakauppa,2019-01-11 09:26:00.693641590,2019-01-11,2019-01-11,2019-01-11,8.0,-10.45,-34.51,0.0,162.0,           ,1.0,1.0,87.0
7122,Ruoka_paivittaistavarakauppa,2019-01-11 18:02:04.855491300,2019-01-11,2019-01-11,2019-01-11,8.0,-1.89,-36.4,0.0,162.0,           ,1.0,1.0,40.0
7123,Kulttuuri_viihde,2019-01-11 19:50:17.341040430,2019-01-11,2019-01-11,2019-01-11,8.0,-27.43,-63.83,0.0,162.0,           ,1.0,1.0,82.0
7124,Ruoka_paivittaistavarakauppa,2019-01-14 02:38:09.017341010,2019-01-14,2019-01-14,2019-01-14,8.0,-1.11,-64.94,0.0,162.0,           ,1.0,1.0,129.0
7125,Kulttuuri_viihde,2019-01-14 04:26:21.502890140,2019-01-14,2019-01-14,2019-01-14,8.0,-0.57,-65.51,0.0,162.0,           ,1.0,1.0,124.0
7126,Luottojen_maksut,2019-01-14 06:14:33.988439270,2019-01-14,2019-01-14,2019-01-14,8.0,-0.72,-66.23,0.0,106.0,NDEAFIHH   ,0.0,0.0,12.0
7127,Ruoka_paivittaistavarakauppa,2019-01-14 14:50:38.150288980,2019-01-14,2019-01-14,2019-01-14,8.0,-4.22,-70.45,0.0,162.0,           ,1.0,1.0,144.0
7128,Ruoka_paivittaistavarakauppa,2019-01-14 16:38:50.635838110,2019-01-14,2019-01-14,2019-01-14,8.0,-25.31,-95.76,0.0,162.0,           ,1.0,1.0,150.0
7129,Hyvinvointijakauneus,2019-01-14 21:38:29.826589560,2019-01-14,2019-01-14,2019-01-14,8.0,-28.15,-123.91,706.0,129.0,DABAFIHH   ,0.0,0.0,244.0
7130,Ruoka_paivittaistavarakauppa,2019-01-14 23:26:42.312138690,2019-01-14,2019-01-14,2019-01-14,8.0,-0.9,-124.81,0.0,162.0,           ,1.0,1.0,146.0
7131,Ruoka_paivittaistavarakauppa,2019-01-15 08:02:46.473988400,2019-01-15,2019-01-15,2019-01-15,8.0,-0.89,-125.7,0.0,162.0,           ,1.0,1.0,146.0
7132,Asuminen,2019-01-16 03:03:07.283236950,2019-01-16,2019-01-16,2019-01-16,8.0,-14.76,-140.46,706.0,129.0,OKOYFIHH   ,0.0,0.0,242.0
7133,Ruoka_paivittaistavarakauppa,2019-01-16 18:27:03.121387240,2019-01-16,2019-01-16,2019-01-16,8.0,-8.68,-149.14,0.0,162.0,           ,1.0,1.0,52.0
7134,Hyvinvointijakauneus,2019-01-17 01:14:54.797687820,2019-01-17,2019-01-17,2019-01-17,8.0,-6.47,-155.61,0.0,162.0,           ,1.0,1.0,39.0
7135,Ruoka_paivittaistavarakauppa,2019-01-17 06:39:32.254335210,2019-01-17,2019-01-17,2019-01-17,8.0,-7.9,-163.51,0.0,162.0,           ,1.0,1.0,179.0
7136,Ravintolat_kahvilat,2019-01-17 09:50:58.959537530,2019-01-17,2019-01-17,2019-01-17,8.0,-0.1,-163.61,0.0,162.0,           ,1.0,1.0,157.0
7137,Ruoka_paivittaistavarakauppa,2019-01-18 04:51:19.768786080,2019-01-18,2019-01-18,2019-01-18,8.0,-5.84,-169.45,0.0,162.0,           ,1.0,1.0,118.0
7138,Liikkuminen,2019-01-18 11:39:11.445086660,2019-01-18,2019-01-18,2019-01-18,8.0,-51.09,-220.54,706.0,106.0,DABAFIHH   ,0.0,0.0,236.0
7139,Ruoka_paivittaistavarakauppa,2019-01-18 13:27:23.930635790,2019-01-18,2019-01-18,2019-01-18,8.0,-1.59,-222.13,0.0,162.0,           ,1.0,1.0,52.0
7140,Asuminen,2019-01-18 15:15:36.416184920,2019-01-18,2019-01-18,2019-01-18,8.0,-38.56,-260.69,706.0,129.0,DABAFIHH   ,0.0,0.0,237.0
7141,Ravintolat_kahvilat,2019-01-18 20:15:15.606936370,2019-01-18,2019-01-18,2019-01-18,8.0,-1.85,-262.54,0.0,162.0,           ,1.0,1.0,120.0
7142,Ravintolat_kahvilat,2019-01-18 22:03:28.092485500,2019-01-18,2019-01-18,2019-01-18,8.0,-8.84,-271.38,0.0,162.0,           ,1.0,1.0,182.0
7143,Muut,2019-01-20 01:39:53.063583760,2019-01-20,2019-01-20,2019-01-20,8.0,-6.48,-277.86,0.0,163.0,           ,1.0,1.0,190.0
7144,Luottojen_maksut,2019-01-20 08:27:44.739884340,2019-01-20,2019-01-20,2019-01-20,8.0,-7.56,-285.42,0.0,106.0,OKOYFIHH   ,0.0,0.0,10.0
7145,Ravintolat_kahvilat,2019-01-21 03:28:05.549132890,2019-01-21,2019-01-22,2019-01-21,8.0,-1.51,-286.93,0.0,162.0,           ,1.0,1.0,113.0
7146,Ravintolat_kahvilat,2019-01-21 10:15:57.225433470,2019-01-21,2019-01-21,2019-01-21,8.0,-6.44,-293.37,0.0,162.0,           ,1.0,1.0,78.0
7147,Ruoka_paivittaistavarakauppa,2019-01-21 17:03:48.901734050,2019-01-21,2019-01-21,2019-01-21,8.0,-24.23,-317.6,0.0,162.0,           ,1.0,1.0,135.0
7148,Ruoka_paivittaistavarakauppa,2019-01-21 18:52:01.387283180,2019-01-21,2019-01-21,2019-01-21,8.0,-1.99,-319.59,0.0,162.0,           ,1.0,1.0,157.0
7149,Ruoka_paivittaistavarakauppa,2019-01-21 23:51:40.578034630,2019-01-21,2019-01-21,2019-01-21,8.0,-0.79,-320.38,0.0,162.0,           ,1.0,1.0,135.0
7150,Tulot,2019-01-22 22:28:26.358381440,2019-01-22,2019-01-22,2019-01-22,8.0,545.47,225.09,701.0,520.0,           ,1.0,1.0,223.0
7151,Ruoka_paivittaistavarakauppa,2019-01-23 05:16:18.034682020,2019-01-23,2019-01-23,2019-01-23,8.0,-5.78,219.31,0.0,162.0,           ,1.0,1.0,179.0
7152,Luokittelemattomat,2019-01-23 13:52:22.196531730,2019-01-23,2019-01-25,2019-01-23,8.0,-44.46,174.85,0.0,106.0,OKOYFIHH   ,1.0,0.0,22.0
7153,Ruoka_paivittaistavarakauppa,2019-01-23 20:40:13.872832310,2019-01-23,2019-01-23,2019-01-23,8.0,-9.11,165.74,0.0,162.0,           ,1.0,1.0,40.0
7154,Ruoka_paivittaistavarakauppa,2019-01-24 02:04:51.329479700,2019-01-24,2019-01-24,2019-01-24,8.0,-5.34,160.4,0.0,162.0,           ,1.0,1.0,125.0
7155,Muut,2019-01-24 07:04:30.520231150,2019-01-24,2019-01-24,2019-01-24,8.0,-1.87,158.53,706.0,129.0,OKOYFIHH   ,1.0,0.0,247.0
7156,Ravintolat_kahvilat,2019-01-24 08:52:43.005780280,2019-01-24,2019-01-24,2019-01-24,8.0,-2.35,156.18,0.0,162.0,           ,1.0,1.0,157.0
7157,Ruoka_paivittaistavarakauppa,2019-01-24 15:40:34.682080860,2019-01-24,2019-01-24,2019-01-24,8.0,-63.61,92.57,0.0,162.0,           ,1.0,1.0,51.0
7158,Ruoka_paivittaistavarakauppa,2019-01-24 19:16:59.653179120,2019-01-24,2019-01-24,2019-01-24,8.0,-5.17,87.4,0.0,162.0,           ,1.0,1.0,75.0
7159,Asuminen,2019-01-25 00:16:38.843930570,2019-01-25,2019-01-25,2019-01-25,8.0,-12.23,75.17,0.0,162.0,           ,1.0,1.0,53.0
7160,Tulot,2019-01-25 12:04:09.710982600,2019-01-25,2019-01-25,2019-01-25,8.0,526.73,601.9,701.0,510.0,           ,1.0,1.0,221.0
7161,Ruoka_paivittaistavarakauppa,2019-01-25 17:28:47.167629990,2019-01-25,2019-01-25,2019-01-25,8.0,-7.71,594.19,0.0,162.0,           ,1.0,1.0,126.0
7162,Luokittelemattomat,2019-01-28 03:53:03.815028830,2019-01-28,2019-01-28,2019-01-28,8.0,-22.65,571.54,0.0,162.0,           ,1.0,1.0,160.0
7163,Ruoka_paivittaistavarakauppa,2019-01-28 05:41:16.300577960,2019-01-28,2019-01-28,2019-01-28,8.0,-18.58,552.96,0.0,162.0,           ,1.0,1.0,117.0
7164,Lemmikit,2019-01-28 07:29:28.786127090,2019-01-28,2019-01-28,2019-01-28,8.0,-6.91,546.05,0.0,162.0,           ,1.0,1.0,80.0
7165,Shoppailu,2019-01-28 10:40:55.491329410,2019-01-28,2019-01-28,2019-01-28,8.0,-15.59,530.46,0.0,162.0,           ,1.0,1.0,87.0
7166,Liikkuminen,2019-01-28 12:29:07.976878540,2019-01-28,2019-01-28,2019-01-28,8.0,-8.53,521.93,0.0,162.0,           ,1.0,1.0,117.0
7167,Tulot,2019-01-28 14:17:20.462427670,2019-01-28,2019-01-28,2019-01-28,8.0,272.82,794.75,0.0,574.0,           ,1.0,1.0,219.0
7168,Liikkuminen,2019-01-28 16:05:32.947976800,2019-01-28,2019-01-28,2019-01-28,8.0,-22.79,771.96,0.0,162.0,           ,1.0,1.0,128.0
7169,Ravintolat_kahvilat,2019-01-28 17:53:45.433525930,2019-01-28,2019-01-28,2019-01-28,8.0,-14.04,757.92,0.0,162.0,           ,1.0,1.0,124.0
7170,Vakuutukset,2019-01-28 21:05:12.138728250,2019-01-28,2019-01-28,2019-01-28,8.0,-28.77,729.15,706.0,129.0,OKOYFIHH   ,0.0,0.0,243.0
7171,Tulot,2019-01-28 22:53:24.624277380,2019-01-28,2019-01-28,2019-01-28,8.0,16.91,746.06,710.0,506.0,           ,1.0,1.0,255.0
7172,Asuminen,2019-01-29 09:17:41.271676220,2019-01-29,2019-01-29,2019-01-29,8.0,-148.03,598.03,0.0,162.0,           ,1.0,1.0,39.0
7173,Asuminen,2019-01-29 19:41:57.919075060,2019-01-29,2019-01-29,2019-01-29,8.0,-48.52,549.51,0.0,162.0,           ,1.0,1.0,41.0
7174,Ravintolat_kahvilat,2019-01-30 00:41:37.109826510,2019-01-30,2019-01-30,2019-01-30,8.0,-13.07,536.44,0.0,162.0,           ,1.0,1.0,129.0
7175,Lemmikit,2019-01-30 02:29:49.595375640,2019-01-30,2019-01-30,2019-01-30,8.0,-34.49,501.95,0.0,162.0,           ,1.0,1.0,116.0
7176,Liikkuminen,2019-01-31 11:05:53.757225350,2019-01-31,2019-01-31,2019-01-31,8.0,-20.73,481.22,0.0,162.0,           ,1.0,1.0,114.0
7177,Liikkuminen,2019-02-01 11:06:26.776859504,2019-02-01,2019-02-01,2019-02-01,8.0,-25.18,456.04,706.0,106.0,OKOYFIHH   ,1.0,0.0,235.0
7178,Muut,2019-02-01 20:25:47.107438016,2019-02-01,2019-02-01,2019-02-01,8.0,-1.27,454.77,0.0,162.0,           ,1.0,1.0,75.0
7179,Ravintolat_kahvilat,2019-02-01 22:12:53.553719008,2019-02-01,2019-02-01,2019-02-01,8.0,-1.17,453.6,0.0,162.0,           ,1.0,1.0,135.0
7180,Liikkuminen,2019-02-04 02:10:54.545454544,2019-02-04,2019-02-05,2019-02-04,8.0,-38.09,415.51,0.0,162.0,           ,1.0,1.0,135.0
7181,Asuminen,2019-02-04 05:45:07.438016528,2019-02-04,2019-02-04,2019-02-04,8.0,-7.6,407.91,0.0,106.0,OKOYFIHH   ,0.0,0.0,11.0
7182,Kulttuuri_viihde,2019-02-04 07:32:13.884297520,2019-02-04,2019-02-04,2019-02-04,8.0,-3.45,404.46,0.0,162.0,           ,1.0,1.0,135.0
7183,Muut,2019-02-04 09:19:20.330578512,2019-02-04,2019-02-04,2019-02-04,8.0,-38.97,365.49,0.0,162.0,           ,1.0,1.0,97.0
7184,Lemmikit,2019-02-04 16:51:34.214876032,2019-02-04,2019-02-04,2019-02-04,8.0,-302.97,62.52,706.0,106.0,OKOYFIHH   ,0.0,0.0,233.0
7185,Ruoka_paivittaistavarakauppa,2019-02-04 18:38:40.661157024,2019-02-04,2019-02-05,2019-02-04,8.0,-12.26,50.26,0.0,162.0,           ,1.0,1.0,52.0
7186,Luokittelemattomat,2019-02-05 03:58:00.991735536,2019-02-05,2019-02-05,2019-02-05,8.0,-7.47,42.79,0.0,162.0,           ,1.0,1.0,52.0
7187,Ruoka_paivittaistavarakauppa,2019-02-05 13:17:21.322314048,2019-02-05,2019-02-05,2019-02-05,8.0,-8.39,34.4,0.0,162.0,           ,1.0,1.0,132.0
7188,Asuminen,2019-02-05 15:04:27.768595040,2019-02-05,2019-02-05,2019-02-05,8.0,-21.19,13.21,706.0,129.0,OKOYFIHH   ,0.0,0.0,238.0
7189,Harrastukset,2019-02-07 00:23:48.099173552,2019-02-07,2019-02-07,2019-02-07,8.0,-5.81,7.4,0.0,162.0,           ,1.0,1.0,128.0
7190,Ruoka_paivittaistavarakauppa,2019-02-07 11:30:14.876033056,2019-02-07,2019-02-07,2019-02-07,8.0,-0.95,6.45,0.0,162.0,           ,1.0,1.0,153.0
7191,Asuminen,2019-02-07 20:49:35.206611568,2019-02-07,2019-02-07,2019-02-07,8.0,-56.55,-50.1,706.0,106.0,NDEAFIHH   ,0.0,0.0,234.0
7192,Ruoka_paivittaistavarakauppa,2019-02-07 22:36:41.652892560,2019-02-07,2019-02-07,2019-02-07,8.0,-2.77,-52.87,0.0,162.0,           ,1.0,1.0,138.0
7193,Kulttuuri_viihde,2019-02-08 09:43:08.429752064,2019-02-08,2019-02-08,2019-02-08,8.0,-0.58,-53.45,0.0,162.0,           ,1.0,1.0,115.0
7194,Ruoka_paivittaistavarakauppa,2019-02-11 04:21:49.090909088,2019-02-11,2019-02-11,2019-02-11,8.0,-1.11,-54.56,0.0,162.0,           ,1.0,1.0,41.0
7195,Ruoka_paivittaistavarakauppa,2019-02-11 06:08:55.537190080,2019-02-11,2019-02-11,2019-02-11,8.0,-2.9,-57.46,0.0,162.0,           ,1.0,1.0,157.0
7196,Ruoka_paivittaistavarakauppa,2019-02-11 07:56:01.983471072,2019-02-11,2019-02-11,2019-02-11,8.0,-4.38,-61.84,0.0,162.0,           ,1.0,1.0,143.0
7197,Luottojen_maksut,2019-02-11 11:54:02.975206608,2019-02-11,2019-02-11,2019-02-11,8.0,-8.27,-70.11,0.0,162.0,           ,1.0,1.0,98.0
7198,Vakuutukset,2019-02-11 13:41:09.421487600,2019-02-11,2019-02-11,2019-02-11,8.0,-93.43,-163.54,706.0,129.0,OKOYFIHH   ,0.0,0.0,238.0
7199,Lemmikit,2019-02-11 15:28:15.867768592,2019-02-11,2019-02-11,2019-02-11,8.0,-18.8,-182.34,0.0,162.0,           ,1.0,1.0,141.0
7200,Ruoka_paivittaistavarakauppa,2019-02-11 17:15:22.314049584,2019-02-11,2019-02-11,2019-02-11,8.0,-0.6,-182.94,0.0,162.0,           ,1.0,1.0,176.0
7201,Ruoka_paivittaistavarakauppa,2019-02-11 19:02:28.760330576,2019-02-11,2019-02-11,2019-02-11,8.0,-5.68,-188.62,0.0,162.0,           ,1.0,1.0,126.0
7202,Ruoka_paivittaistavarakauppa,2019-02-12 00:47:36.198347104,2019-02-12,2019-02-12,2019-02-12,8.0,-2.77,-191.39,0.0,162.0,           ,1.0,1.0,187.0
7203,Ruoka_paivittaistavarakauppa,2019-02-12 02:34:42.644628096,2019-02-12,2019-02-12,2019-02-12,8.0,-4.76,-196.15,0.0,162.0,           ,1.0,1.0,163.0
7204,Ruoka_paivittaistavarakauppa,2019-02-12 21:13:23.305785120,2019-02-12,2019-02-12,2019-02-11,8.0,-14.3,-210.45,0.0,162.0,           ,1.0,1.0,98.0
7205,Asuminen,2019-02-14 06:32:43.636363632,2019-02-14,2019-02-14,2019-02-14,8.0,-3.98,-214.43,0.0,162.0,           ,1.0,1.0,85.0
7206,Ruoka_paivittaistavarakauppa,2019-02-14 10:06:56.528925616,2019-02-14,2019-02-14,2019-02-14,8.0,-3.36,-217.79,0.0,162.0,           ,1.0,1.0,101.0
7207,Hyvinvointijakauneus,2019-02-14 19:26:16.859504128,2019-02-14,2019-02-14,2019-02-14,8.0,-2.0,-219.79,0.0,162.0,           ,1.0,1.0,109.0
7208,Muut,2019-02-14 23:00:29.752066112,2019-02-11,2019-02-14,2019-02-14,8.0,-10.12,-229.91,0.0,162.0,           ,1.0,1.0,125.0
7209,Ruoka_paivittaistavarakauppa,2019-02-15 08:19:50.082644624,2019-02-15,2019-02-15,2019-02-13,8.0,-6.65,-236.56,0.0,162.0,           ,1.0,1.0,40.0
7210,Ruoka_paivittaistavarakauppa,2019-02-18 02:58:30.743801648,2019-02-18,2019-02-18,2019-02-18,8.0,-5.35,-241.91,0.0,162.0,           ,1.0,1.0,108.0
7211,Ruoka_paivittaistavarakauppa,2019-02-18 04:45:37.190082640,2019-02-18,2019-02-18,2019-02-18,8.0,-30.79,-272.7,0.0,162.0,           ,1.0,1.0,97.0
7212,Ruoka_paivittaistavarakauppa,2019-02-18 14:04:57.520661152,2019-02-18,2019-02-18,2019-02-18,8.0,-5.83,-278.53,0.0,162.0,           ,1.0,1.0,63.0
7213,Saastot_sijoitukset,2019-02-18 15:52:03.966942144,2019-02-18,2019-02-18,2019-02-18,8.0,-1.76,-280.29,0.0,162.0,           ,1.0,1.0,101.0
7214,Muut,2019-02-18 17:39:10.413223136,2019-02-18,2019-02-18,2019-02-18,8.0,-9.81,-290.1,0.0,162.0,           ,1.0,1.0,107.0
7215,Ruoka_paivittaistavarakauppa,2019-02-18 19:50:04.958677680,2019-02-18,2019-02-18,2019-02-18,8.0,-1.5,-291.6,0.0,162.0,           ,1.0,1.0,52.0
7216,Liikkuminen,2019-02-19 01:11:24.297520656,2019-02-19,2019-02-19,2019-02-19,8.0,-44.59,-336.19,0.0,162.0,           ,1.0,1.0,136.0
7217,Muut,2019-02-19 12:17:51.074380160,2019-02-19,2019-02-20,2019-02-19,8.0,-5.28,-341.47,0.0,162.0,           ,1.0,1.0,116.0
7218,Lapset,2019-02-19 23:24:17.851239664,2019-02-19,2019-02-19,2019-02-19,8.0,-1.78,-343.25,0.0,162.0,           ,1.0,1.0,97.0
7219,Ravintolat_kahvilat,2019-02-20 06:56:31.735537184,2019-02-20,2019-02-20,2019-02-20,8.0,-4.73,-347.98,0.0,162.0,           ,1.0,1.0,131.0
7220,Ruoka_paivittaistavarakauppa,2019-02-20 10:30:44.628099168,2019-02-20,2019-02-20,2019-02-20,8.0,-15.48,-363.46,0.0,162.0,           ,1.0,1.0,164.0
7221,Kulttuuri_viihde,2019-02-21 21:37:11.404958672,2019-02-21,2019-02-21,2019-02-21,8.0,-10.09,-373.55,0.0,162.0,           ,1.0,1.0,120.0
7222,Luottojen_maksut,2019-02-22 05:09:25.289256192,2019-02-22,2019-02-22,2019-02-22,8.0,-1.6,-375.15,0.0,162.0,           ,1.0,1.0,52.0
7223,Lemmikit,2019-02-22 08:43:38.181818176,2019-02-22,2019-02-22,2019-02-22,8.0,-4.05,-379.2,0.0,162.0,           ,1.0,1.0,71.0
7224,Luokittelemattomat,2019-02-22 16:15:52.066115696,2019-02-22,2019-02-22,2019-02-22,8.0,-1.15,-380.35,0.0,162.0,           ,1.0,1.0,87.0
7225,Liikkuminen,2019-02-22 18:02:58.512396688,2019-02-22,2019-02-22,2019-02-22,8.0,-2.31,-382.66,0.0,162.0,           ,1.0,1.0,64.0
7226,Ravintolat_kahvilat,2019-02-25 01:35:12.396694208,2019-02-25,2019-02-25,2019-02-25,8.0,-1.1,-383.76,0.0,162.0,           ,1.0,1.0,179.0
7227,Ruoka_paivittaistavarakauppa,2019-02-25 03:22:18.842975200,2019-02-25,2019-02-25,2019-02-25,8.0,-3.02,-386.78,0.0,162.0,           ,1.0,1.0,146.0
7228,Ravintolat_kahvilat,2019-02-25 12:41:39.173553712,2019-02-25,2019-02-25,2019-02-25,8.0,-2.47,-389.25,0.0,162.0,           ,1.0,1.0,121.0
7229,Luottojen_maksut,2019-02-25 14:28:45.619834704,2019-02-25,2019-02-26,2019-02-25,8.0,-1.5,-390.75,0.0,162.0,           ,1.0,1.0,52.0
7230,Ravintolat_kahvilat,2019-02-25 23:48:05.950413216,2019-02-25,2019-02-25,2019-02-25,8.0,-2.77,-393.52,0.0,162.0,           ,1.0,1.0,78.0
7231,Lemmikit,2019-02-26 10:54:32.727272720,2019-02-26,2019-02-26,2019-02-26,8.0,-14.25,-407.77,0.0,162.0,           ,1.0,1.0,52.0
7232,Ruoka_paivittaistavarakauppa,2019-02-26 22:00:59.504132224,2019-02-26,2019-02-26,2019-02-26,8.0,-10.1,-417.87,0.0,162.0,           ,1.0,1.0,128.0
7233,Ruoka_paivittaistavarakauppa,2019-02-27 09:07:26.280991728,2019-02-27,2019-02-27,2019-02-27,8.0,-11.46,-429.33,0.0,162.0,           ,1.0,1.0,128.0
7234,Ruoka_paivittaistavarakauppa,2019-02-27 20:13:53.057851232,2019-02-27,2019-02-28,2019-02-27,8.0,-0.81,-430.14,0.0,162.0,           ,1.0,1.0,168.0
7235,Kulttuuri_viihde,2019-02-28 07:20:19.834710736,2019-02-28,2019-02-28,2019-02-28,8.0,-20.72,-450.86,706.0,129.0,OKOYFIHH   ,0.0,0.0,241.0
7236,Harrastukset,2019-02-28 18:26:46.611570240,2019-02-28,2019-02-28,2019-02-28,8.0,-3.35,-454.21,0.0,162.0,           ,1.0,1.0,174.0
7237,Ruoka_paivittaistavarakauppa,2019-03-01 00:23:36.393442620,2019-03-01,2019-03-01,2019-02-28,8.0,-5.59,-459.8,0.0,162.0,           ,1.0,1.0,57.0
7238,Ruoka_paivittaistavarakauppa,2019-03-01 08:07:52.131147540,2019-03-01,2019-03-01,2019-02-26,8.0,-1.75,-461.55,0.0,162.0,           ,1.0,1.0,105.0
7239,Ruoka_paivittaistavarakauppa,2019-03-01 16:15:44.262295080,2019-03-01,2019-03-01,2019-03-01,8.0,-3.98,-465.53,0.0,162.0,           ,1.0,1.0,187.0
7240,Ruoka_paivittaistavarakauppa,2019-03-04 00:47:12.786885240,2019-03-04,2019-03-04,2019-03-04,8.0,-3.67,-469.2,0.0,162.0,           ,1.0,1.0,126.0
7241,Luokittelemattomat,2019-03-04 01:10:49.180327860,2019-03-04,2019-03-04,2019-03-04,8.0,-81.61,-550.81,706.0,129.0,OKOYFIHH   ,0.0,0.0,242.0
7242,Liikkuminen,2019-03-04 08:31:28.524590160,2019-03-04,2019-03-05,2019-03-04,8.0,-8.22,-559.03,0.0,162.0,           ,1.0,1.0,52.0
7243,Ruoka_paivittaistavarakauppa,2019-03-04 08:55:04.918032780,2019-03-04,2019-03-04,2019-03-04,8.0,-17.91,-576.94,0.0,162.0,           ,1.0,1.0,57.0
7244,Luokittelemattomat,2019-03-04 09:18:41.311475400,2019-03-04,2019-03-04,2019-03-04,8.0,-6.58,-583.52,0.0,162.0,           ,1.0,1.0,180.0
7245,Ruoka_paivittaistavarakauppa,2019-03-04 16:39:20.655737700,2019-03-04,2019-03-05,2019-03-04,8.0,-1.37,-584.89,0.0,162.0,           ,1.0,1.0,75.0
7246,Ruoka_paivittaistavarakauppa,2019-03-04 17:02:57.049180320,2019-03-04,2019-03-04,2019-03-04,8.0,-12.22,-597.11,0.0,162.0,           ,1.0,1.0,114.0
7247,Luokittelemattomat,2019-03-04 17:26:33.442622940,2019-03-04,2019-03-04,2019-03-04,8.0,-5.21,-602.32,0.0,162.0,           ,1.0,1.0,117.0
7248,Ruoka_paivittaistavarakauppa,2019-03-05 01:34:25.573770480,2019-03-05,2019-03-05,2019-03-05,8.0,-2.58,-604.9,0.0,162.0,           ,1.0,1.0,164.0
7249,Lemmikit,2019-03-05 01:58:01.967213100,2019-03-05,2019-03-05,2019-03-05,8.0,-14.88,-619.78,0.0,162.0,           ,1.0,1.0,150.0
7250,Ruoka_paivittaistavarakauppa,2019-03-05 09:42:17.704918020,2019-03-05,2019-03-05,2019-03-05,8.0,-10.02,-629.8,0.0,162.0,           ,1.0,1.0,87.0
7251,Luokittelemattomat,2019-03-05 17:50:09.836065560,2019-03-05,2019-03-07,2019-03-05,8.0,-3.15,-632.95,0.0,162.0,           ,1.0,1.0,146.0
7252,Asuminen,2019-03-06 10:05:54.098360640,2019-03-06,2019-03-06,2019-03-06,8.0,-6.66,-639.61,706.0,129.0,OKOYFIHH   ,0.0,0.0,245.0
7253,Matkailu,2019-03-06 18:13:46.229508180,2019-03-06,2019-03-06,2019-03-06,8.0,-11.68,-651.29,0.0,100.0,           ,1.0,1.0,0.0
7254,Kulttuuri_viihde,2019-03-07 02:21:38.360655720,2019-03-07,2019-03-07,2019-03-07,8.0,-7.03,-658.32,0.0,162.0,           ,1.0,1.0,162.0
7255,Hyvinvointi,2019-03-07 10:29:30.491803260,2019-03-07,2019-03-07,2019-03-07,8.0,-21.56,-679.88,0.0,162.0,           ,1.0,1.0,149.0
7256,Ruoka_paivittaistavarakauppa,2019-03-07 18:37:22.622950800,2019-03-07,2019-03-07,2019-03-07,8.0,-8.07,-687.95,0.0,162.0,           ,1.0,1.0,67.0
7257,Ravintolat_kahvilat,2019-03-08 02:45:14.754098340,2019-03-08,2019-03-08,2019-03-08,8.0,-1.76,-689.71,0.0,162.0,           ,1.0,1.0,155.0
7258,Ruoka_paivittaistavarakauppa,2019-03-08 03:08:51.147540960,2019-03-08,2019-03-08,2019-03-08,8.0,-1.0,-690.71,0.0,162.0,           ,1.0,1.0,121.0
7259,Ruoka_paivittaistavarakauppa,2019-03-08 10:53:06.885245880,2019-03-08,2019-03-08,2019-03-08,8.0,-3.44,-694.15,0.0,162.0,           ,1.0,1.0,94.0
7260,Liikkuminen,2019-03-08 11:16:43.278688500,2019-03-08,2019-03-08,2019-03-08,8.0,-9.38,-703.53,0.0,162.0,           ,1.0,1.0,172.0
7261,Ruoka_paivittaistavarakauppa,2019-03-08 19:00:59.016393420,2019-03-08,2019-03-08,2019-03-08,8.0,-3.21,-706.74,0.0,162.0,           ,1.0,1.0,57.0
7262,Kulttuuri_viihde,2019-03-11 03:32:27.540983580,2019-03-11,2019-03-11,2019-03-13,8.0,-5.22,-711.96,0.0,162.0,           ,1.0,1.0,39.0
7263,Shoppailu,2019-03-11 03:56:03.934426200,2019-03-11,2019-03-11,2019-03-11,8.0,-13.48,-725.44,0.0,162.0,           ,1.0,1.0,78.0
7264,Ruoka_paivittaistavarakauppa,2019-03-11 11:40:19.672131120,2019-03-11,2019-03-11,2019-03-11,8.0,-4.0,-729.44,0.0,162.0,           ,1.0,1.0,39.0
7265,Liikkuminen,2019-03-11 12:03:56.065573740,2019-03-11,2019-03-11,2019-03-11,8.0,-19.52,-748.96,0.0,162.0,           ,1.0,1.0,169.0
7266,Liikkuminen,2019-03-11 19:24:35.409836040,2019-03-11,2019-03-11,2019-03-11,8.0,-6.77,-755.73,0.0,162.0,           ,1.0,1.0,120.0
7267,Ruoka_paivittaistavarakauppa,2019-03-11 20:11:48.196721280,2019-03-11,2019-03-11,2019-03-11,8.0,-4.84,-760.57,0.0,162.0,           ,1.0,1.0,68.0
7268,Ruoka_paivittaistavarakauppa,2019-03-12 04:19:40.327868820,2019-03-12,2019-03-12,2019-03-12,8.0,-40.06,-800.63,0.0,162.0,           ,1.0,1.0,172.0
7269,Ruoka_paivittaistavarakauppa,2019-03-12 04:43:16.721311440,2019-03-12,2019-03-12,2019-03-12,8.0,-5.4,-806.03,0.0,162.0,           ,1.0,1.0,124.0
7270,Ravintolat_kahvilat,2019-03-12 12:27:32.459016360,2019-03-12,2019-03-12,2019-03-12,8.0,-4.82,-810.85,0.0,162.0,           ,1.0,1.0,168.0
7271,Ruoka_paivittaistavarakauppa,2019-03-12 12:51:08.852458980,2019-03-12,2019-03-12,2019-03-12,8.0,-3.74,-814.59,0.0,162.0,           ,1.0,1.0,41.0
7272,Kulttuuri_viihde,2019-03-12 19:48:11.803278660,2019-03-08,2019-03-12,2019-03-12,8.0,-36.13,-850.72,0.0,106.0,OKOYFIHH   ,0.0,0.0,10.0
7273,Luottojen_maksut,2019-03-12 20:35:24.590163900,2019-03-12,2019-03-12,2019-03-12,8.0,-11.71,-862.43,706.0,129.0,NDEAFIHH   ,0.0,0.0,237.0
7274,Ruoka_paivittaistavarakauppa,2019-03-13 05:06:53.114754060,2019-03-13,2019-03-13,2019-03-13,8.0,-13.79,-876.22,0.0,162.0,           ,1.0,1.0,144.0
7275,Ruoka_paivittaistavarakauppa,2019-03-14 13:38:21.639344220,2019-03-14,2019-03-14,2019-03-14,8.0,-4.76,-880.98,0.0,162.0,           ,1.0,1.0,103.0
7276,Ruoka_paivittaistavarakauppa,2019-03-14 21:46:13.770491760,2019-03-14,2019-03-14,2019-03-14,8.0,-1.65,-882.63,0.0,162.0,           ,1.0,1.0,142.0
7277,Ruoka_paivittaistavarakauppa,2019-03-15 05:30:29.508196680,2019-03-15,2019-03-15,2019-03-15,8.0,-1.01,-883.64,0.0,162.0,           ,1.0,1.0,157.0
7278,Ruoka_paivittaistavarakauppa,2019-03-15 13:14:45.245901600,2019-03-15,2019-03-15,2019-03-15,8.0,-0.31,-883.95,0.0,162.0,           ,1.0,1.0,144.0
7279,Ravintolat_kahvilat,2019-03-15 20:59:00.983606520,2019-03-15,2019-03-15,2019-03-15,8.0,-4.32,-888.27,0.0,162.0,           ,1.0,1.0,112.0
7280,Luokittelemattomat,2019-03-15 21:22:37.377049140,2019-03-15,2019-03-15,2019-03-15,8.0,-58.98,-947.25,706.0,129.0,OKOYFIHH   ,0.0,0.0,244.0
7281,Ruoka_paivittaistavarakauppa,2019-03-18 05:54:05.901639300,2019-03-18,2019-03-18,2019-03-18,8.0,-10.24,-957.49,0.0,162.0,           ,1.0,1.0,124.0
7282,Liikkuminen,2019-03-18 06:17:42.295081920,2019-03-18,2019-03-18,2019-03-18,8.0,-10.09,-967.58,0.0,162.0,           ,1.0,1.0,131.0
7283,Kulttuuri_viihde,2019-03-18 06:41:18.688524540,2019-03-18,2019-03-18,2019-03-18,8.0,-3.7,-971.28,0.0,162.0,           ,1.0,1.0,123.0
7284,Ruoka_paivittaistavarakauppa,2019-03-18 07:28:31.475409780,2019-03-18,2019-03-18,2019-03-18,8.0,-1.04,-972.32,0.0,162.0,           ,1.0,1.0,84.0
7285,Ruoka_paivittaistavarakauppa,2019-03-18 14:01:58.032786840,2019-03-18,2019-03-18,2019-03-18,8.0,-7.06,-979.38,0.0,162.0,           ,1.0,1.0,39.0
7286,Muut,2019-03-18 14:25:34.426229460,2019-03-18,2019-03-18,2019-03-18,8.0,-1.14,-980.52,0.0,162.0,           ,1.0,1.0,87.0
7287,Ruoka_paivittaistavarakauppa,2019-03-18 14:49:10.819672080,2019-03-18,2019-03-18,2019-03-18,8.0,-8.23,-988.75,0.0,162.0,           ,1.0,1.0,141.0
7288,Ravintolat_kahvilat,2019-03-18 22:09:50.163934380,2019-03-18,2019-03-18,2019-03-18,8.0,-8.14,-996.89,0.0,162.0,           ,1.0,1.0,98.0
7289,Hyvinvointijakauneus,2019-03-18 22:33:26.557377000,2019-03-18,2019-03-18,2019-03-18,8.0,-0.55,-997.44,0.0,162.0,           ,1.0,1.0,134.0
7290,Muut,2019-03-18 22:57:02.950819620,2019-03-18,2019-03-18,2019-03-18,8.0,-56.45,-1053.89,0.0,162.0,           ,1.0,1.0,128.0
7291,Ruoka_paivittaistavarakauppa,2019-03-18 23:44:15.737704860,2019-03-18,2019-03-19,2019-03-18,8.0,-12.47,-1066.36,0.0,162.0,           ,1.0,1.0,127.0
7292,Ravintolat_kahvilat,2019-03-19 07:04:55.081967160,2019-03-19,2019-03-19,2019-03-19,8.0,-1.09,-1067.45,0.0,162.0,           ,1.0,1.0,78.0
7293,Ravintolat_kahvilat,2019-03-19 15:12:47.213114700,2019-03-19,2019-03-19,2019-03-19,8.0,-2.2,-1069.65,0.0,162.0,           ,1.0,1.0,68.0
7294,Asuminen,2019-03-19 15:36:23.606557320,2019-03-19,2019-03-19,2019-03-19,8.0,-22.09,-1091.74,706.0,129.0,OKOYFIHH   ,0.0,0.0,244.0
7295,Ruoka_paivittaistavarakauppa,2019-03-19 23:20:39.344262240,2019-03-19,2019-03-19,2019-03-19,8.0,-2.03,-1093.77,0.0,162.0,           ,1.0,1.0,157.0
7296,Ruoka_paivittaistavarakauppa,2019-03-20 00:31:28.524590100,2019-03-20,2019-03-20,2019-03-20,8.0,-0.98,-1094.75,0.0,162.0,           ,1.0,1.0,126.0
7297,Saastot_sijoitukset,2019-03-20 07:52:07.868852400,2019-03-20,2019-03-20,2019-03-20,8.0,-9.63,-1104.38,706.0,129.0,OKOYFIHH   ,0.0,0.0,239.0
7298,Tulot,2019-03-20 15:59:59.999999940,2019-03-20,2019-03-21,2019-03-20,8.0,1654.8,550.42,710.0,506.0,           ,1.0,1.0,255.0
7299,Asuminen,2019-03-21 08:15:44.262295020,2019-03-21,2019-03-21,2019-03-21,8.0,-168.83,381.59,706.0,129.0,OKOYFIHH   ,0.0,0.0,245.0
7300,Ravintolat_kahvilat,2019-03-21 16:23:36.393442560,2019-03-21,2019-03-21,2019-03-21,8.0,-5.42,376.17,0.0,162.0,           ,1.0,1.0,121.0
7301,Tulot,2019-03-22 00:07:52.131147480,2019-03-22,2019-03-22,2019-03-22,8.0,204.84,581.01,710.0,570.0,           ,1.0,1.0,258.0
7302,Liikkuminen,2019-03-22 08:39:20.655737640,2019-03-22,2019-03-22,2019-03-22,8.0,-51.21,529.8,0.0,162.0,           ,1.0,1.0,143.0
7303,Ruoka_paivittaistavarakauppa,2019-03-22 16:47:12.786885180,2019-03-22,2019-03-22,2019-03-22,8.0,-7.53,522.27,0.0,162.0,           ,1.0,1.0,125.0
7304,Muut,2019-03-25 00:55:04.918032720,2019-03-25,2019-03-25,2019-03-25,8.0,-20.76,501.51,0.0,162.0,           ,1.0,1.0,127.0
7305,Ruoka_paivittaistavarakauppa,2019-03-25 01:18:41.311475340,2019-03-25,2019-03-25,2019-03-25,8.0,-1.27,500.24,0.0,162.0,           ,1.0,1.0,116.0
7306,Shoppailu,2019-03-25 09:02:57.049180260,2019-03-25,2019-03-25,2019-03-25,8.0,-5.27,494.97,0.0,162.0,           ,1.0,1.0,121.0
7307,Asuminen,2019-03-25 09:26:33.442622880,2019-03-25,2019-03-25,2019-03-25,8.0,-42.67,452.3,706.0,129.0,OKOYFIHH   ,0.0,0.0,237.0
7308,Ravintolat_kahvilat,2019-03-25 17:10:49.180327800,2019-03-25,2019-03-25,2019-03-25,8.0,-14.56,437.74,0.0,162.0,           ,1.0,1.0,77.0
7309,Asuminen,2019-03-25 17:34:25.573770420,2019-03-25,2019-03-25,2019-03-25,8.0,-11.63,426.11,0.0,162.0,           ,1.0,1.0,162.0
7310,Liikkuminen,2019-03-26 01:42:17.704917960,2019-03-26,2019-03-26,2019-03-26,8.0,-15.22,410.89,0.0,162.0,           ,1.0,1.0,124.0
7311,Ruoka_paivittaistavarakauppa,2019-03-26 09:50:09.836065500,2019-03-26,2019-03-26,2019-03-26,8.0,-75.82,335.07,0.0,162.0,           ,1.0,1.0,109.0
7312,Ruoka_paivittaistavarakauppa,2019-03-26 17:58:01.967213040,2019-03-26,2019-03-26,2019-03-26,8.0,-25.34,309.73,0.0,162.0,           ,1.0,1.0,114.0
7313,Ruoka_paivittaistavarakauppa,2019-03-27 02:05:54.098360580,2019-03-27,2019-03-27,2019-03-27,8.0,-5.17,304.56,0.0,162.0,           ,1.0,1.0,130.0
7314,Lemmikit,2019-03-27 10:13:46.229508120,2019-03-27,2019-03-27,2019-03-27,8.0,-6.57,297.99,0.0,162.0,           ,1.0,1.0,139.0
7315,Ruoka_paivittaistavarakauppa,2019-03-27 18:21:38.360655660,2019-03-27,2019-03-27,2019-03-27,8.0,-1.03,296.96,0.0,162.0,           ,1.0,1.0,103.0
7316,Saastot_sijoitukset,2019-03-27 18:45:14.754098280,2019-03-27,2019-03-27,2019-03-27,8.0,-1.98,294.98,0.0,162.0,           ,1.0,1.0,143.0
7317,Ravintolat_kahvilat,2019-03-29 02:29:30.491803200,2019-03-29,2019-03-29,2019-03-29,8.0,-13.41,281.57,0.0,162.0,           ,1.0,1.0,152.0
7318,Shoppailu,2019-03-29 02:53:06.885245820,2019-03-29,2019-03-29,2019-03-29,8.0,-35.28,246.29,0.0,162.0,           ,1.0,1.0,181.0
7319,Ruoka_paivittaistavarakauppa,2019-03-29 03:16:43.278688440,2019-03-29,2019-03-29,2019-03-29,8.0,-5.22,241.07,0.0,162.0,           ,1.0,1.0,114.0
7320,Ruoka_paivittaistavarakauppa,2019-03-29 03:40:19.672131060,2019-03-29,2019-03-29,2019-03-29,8.0,-18.7,222.37,0.0,162.0,           ,1.0,1.0,107.0
7321,Asuminen,2019-03-29 10:37:22.622950740,2019-03-29,2019-03-29,2019-03-29,8.0,-39.14,183.23,0.0,162.0,           ,1.0,1.0,135.0
7322,Ruoka_paivittaistavarakauppa,2019-03-29 11:00:59.016393360,2019-03-29,2019-03-29,2019-03-29,8.0,-57.45,125.78,0.0,162.0,           ,1.0,1.0,78.0
7323,Luottojen_maksut,2019-03-29 11:24:35.409835980,2019-03-29,2019-03-29,2019-03-29,8.0,-21.47,104.31,0.0,162.0,           ,1.0,1.0,126.0
7324,Liikkuminen,2019-03-29 11:48:11.803278600,2019-03-29,2019-03-29,2019-03-29,8.0,-7.23,97.08,0.0,162.0,           ,1.0,1.0,40.0
7325,Lemmikit,2019-03-29 19:08:51.147540900,2019-03-29,2019-03-29,2019-03-29,8.0,-5.66,91.42,0.0,162.0,           ,1.0,1.0,121.0
7326,Ravintolat_kahvilat,2019-03-29 19:32:27.540983520,2019-03-29,2019-03-29,2019-03-29,8.0,-4.61,86.81,0.0,162.0,           ,1.0,1.0,55.0
7327,Ruoka_paivittaistavarakauppa,2019-03-29 19:56:03.934426140,2019-03-29,2019-03-29,2019-03-29,8.0,-13.24,73.57,0.0,162.0,           ,1.0,1.0,133.0
7328,Vakuutukset,2019-04-01 12:31:18.260869565,2019-04-01,2019-04-01,2019-04-01,8.0,-47.73,25.84,706.0,129.0,NDEAFIHH   ,0.0,0.0,240.0
7329,Luottojen_maksut,2019-04-02 01:02:36.521739130,2019-04-02,2019-04-02,2019-04-02,8.0,-9.85,15.99,0.0,106.0,OKOYFIHH   ,1.0,0.0,25.0
7330,Muut,2019-04-02 13:33:54.782608695,2019-04-02,2019-04-02,2019-04-02,8.0,-1.9,14.09,0.0,162.0,           ,1.0,1.0,99.0
7331,Ravintolat_kahvilat,2019-04-03 02:05:13.043478260,2019-04-03,2019-04-03,2019-04-03,8.0,-13.07,1.02,0.0,162.0,           ,1.0,1.0,152.0
7332,Matkailu,2019-04-03 14:36:31.304347825,2019-04-03,2019-04-03,2019-04-03,8.0,-3.64,-2.62,0.0,162.0,           ,1.0,1.0,52.0
7333,Lapset,2019-04-04 03:07:49.565217390,2019-04-04,2019-04-04,2019-04-04,8.0,-1.79,-4.41,0.0,162.0,           ,1.0,1.0,154.0
7334,Ravintolat_kahvilat,2019-04-04 15:39:07.826086955,2019-04-04,2019-04-04,2019-04-04,8.0,-1.46,-5.87,0.0,162.0,           ,1.0,1.0,168.0
7335,Luokittelemattomat,2019-04-05 04:10:26.086956520,2019-04-05,2019-04-05,2019-04-05,8.0,-11.53,-17.4,0.0,162.0,           ,1.0,1.0,168.0
7336,Matkailu,2019-04-05 16:41:44.347826085,2019-04-05,2019-04-05,2019-04-05,8.0,-3.74,-21.14,0.0,170.0,           ,1.0,1.0,196.0
7337,Tulot,2019-04-06 17:44:20.869565215,2019-04-06,2019-04-06,2019-04-06,8.0,239.73,218.59,0.0,505.0,           ,1.0,1.0,203.0
7338,Ruoka_paivittaistavarakauppa,2019-04-08 05:13:02.608695650,2019-04-08,2019-04-08,2019-04-08,8.0,-5.8,212.79,0.0,162.0,           ,1.0,1.0,105.0
7339,Ruoka_paivittaistavarakauppa,2019-04-08 06:15:39.130434780,2019-04-08,2019-04-08,2019-04-08,8.0,-8.6,204.19,0.0,162.0,           ,1.0,1.0,130.0
7340,Ruoka_paivittaistavarakauppa,2019-04-08 07:18:15.652173910,2019-04-08,2019-04-08,2019-04-08,8.0,-15.96,188.23,0.0,162.0,           ,1.0,1.0,181.0
7341,Tulot,2019-04-08 18:46:57.391304345,2019-04-08,2019-04-09,2019-04-08,8.0,-12.07,176.16,0.0,162.0,           ,1.0,1.0,40.0
7342,Ruoka_paivittaistavarakauppa,2019-04-08 19:49:33.913043475,2019-04-08,2019-04-08,2019-04-08,8.0,-4.89,171.27,0.0,162.0,           ,1.0,1.0,100.0
7343,Liikkuminen,2019-04-09 08:20:52.173913040,2019-04-09,2019-04-09,2019-04-09,8.0,-7.51,163.76,0.0,162.0,           ,1.0,1.0,105.0
7344,Ravintolat_kahvilat,2019-04-09 20:52:10.434782605,2019-04-09,2019-04-09,2019-04-09,8.0,-9.68,154.08,0.0,162.0,           ,1.0,1.0,107.0
7345,Asuminen,2019-04-10 09:23:28.695652170,2019-04-10,2019-04-10,2019-04-10,8.0,-18.66,135.42,0.0,162.0,           ,1.0,1.0,90.0
7346,Matkailu,2019-04-10 22:57:23.478260865,2019-04-10,2019-04-10,2019-04-10,8.0,-4.91,130.51,0.0,170.0,           ,1.0,1.0,196.0
7347,Lemmikit,2019-04-11 10:26:05.217391300,2019-04-11,2019-04-11,2019-04-11,8.0,-8.04,122.47,0.0,162.0,           ,1.0,1.0,176.0
7348,Ruoka_paivittaistavarakauppa,2019-04-11 12:31:18.260869560,2019-04-11,2019-04-11,2019-04-11,8.0,-5.93,116.54,0.0,162.0,           ,1.0,1.0,179.0
7349,Muut,2019-04-11 21:54:46.956521735,2019-04-11,2019-04-11,2019-04-11,8.0,-6.65,109.89,0.0,162.0,           ,1.0,1.0,128.0
7350,Ruoka_paivittaistavarakauppa,2019-04-12 01:02:36.521739125,2019-04-12,2019-04-12,2019-04-12,8.0,-5.27,104.62,0.0,162.0,           ,1.0,1.0,66.0
7351,Tulot,2019-04-12 11:28:41.739130430,2019-04-12,2019-04-12,2019-04-12,8.0,9.91,114.53,710.0,588.0,           ,0.0,1.0,260.0
7352,Lemmikit,2019-04-12 23:59:59.999999995,2019-04-12,2019-04-12,2019-04-12,8.0,-1.05,113.48,0.0,162.0,           ,1.0,1.0,40.0
7353,Ruoka_paivittaistavarakauppa,2019-04-15 02:05:13.043478255,2019-04-15,2019-04-15,2019-04-15,8.0,-19.97,93.51,0.0,162.0,           ,1.0,1.0,64.0
7354,Ruoka_paivittaistavarakauppa,2019-04-15 13:33:54.782608690,2019-04-15,2019-04-15,2019-04-15,8.0,-29.61,63.9,0.0,162.0,           ,1.0,1.0,129.0
7355,Harrastukset,2019-04-15 14:36:31.304347820,2019-04-15,2019-04-15,2019-04-15,8.0,-13.45,50.45,0.0,106.0,OKOYFIHH   ,0.0,0.0,23.0
7356,Liikkuminen,2019-04-16 03:07:49.565217385,2019-04-16,2019-04-16,2019-04-16,8.0,-14.05,36.4,0.0,162.0,           ,1.0,1.0,39.0
7357,Luokittelemattomat,2019-04-16 15:39:07.826086950,2019-04-16,2019-04-16,2019-04-16,8.0,-20.32,16.08,0.0,162.0,           ,1.0,1.0,81.0
7358,Matkailu,2019-04-17 04:10:26.086956515,2019-04-17,2019-04-17,2019-04-17,8.0,-4.4,11.68,0.0,170.0,           ,1.0,1.0,196.0
7359,Tulot,2019-04-18 05:13:02.608695645,2019-04-18,2019-04-18,2019-04-18,8.0,222.95,234.63,710.0,588.0,           ,0.0,1.0,262.0
7360,Ravintolat_kahvilat,2019-04-18 17:44:20.869565210,2019-04-18,2019-04-18,2019-04-18,8.0,-12.09,222.54,0.0,162.0,           ,1.0,1.0,52.0
7361,Ravintolat_kahvilat,2019-04-19 06:15:39.130434775,2019-04-19,2019-04-19,2019-04-19,8.0,-1.77,220.77,0.0,162.0,           ,1.0,1.0,85.0
7362,Ruoka_paivittaistavarakauppa,2019-04-19 16:41:44.347826080,2019-04-19,2019-04-19,2019-04-19,8.0,-12.91,207.86,0.0,162.0,           ,1.0,1.0,57.0
7363,Muut,2019-04-19 18:46:57.391304340,2019-04-19,2019-04-19,2019-04-19,8.0,-49.73,158.13,0.0,163.0,           ,1.0,1.0,190.0
7364,Luokittelemattomat,2019-04-21 19:49:33.913043470,2019-04-21,2019-04-21,2019-04-21,8.0,-44.98,113.15,0.0,106.0,OKOYFIHH   ,1.0,0.0,28.0
7365,Ruoka_paivittaistavarakauppa,2019-04-22 07:18:15.652173905,2019-04-22,2019-04-22,2019-04-22,8.0,-15.82,97.33,0.0,162.0,           ,1.0,1.0,78.0
7366,Ravintolat_kahvilat,2019-04-22 08:20:52.173913035,2019-04-22,2019-04-22,2019-04-22,8.0,-6.84,90.49,0.0,162.0,           ,1.0,1.0,39.0
7367,Luokittelemattomat,2019-04-22 09:23:28.695652165,2019-04-22,2019-04-22,2019-04-22,8.0,-5.09,85.4,0.0,162.0,           ,1.0,1.0,101.0
7368,Ruoka_paivittaistavarakauppa,2019-04-22 20:52:10.434782600,2019-04-22,2019-04-22,2019-04-22,8.0,-28.45,56.95,0.0,162.0,           ,1.0,1.0,168.0
7369,Luokittelemattomat,2019-04-22 21:54:46.956521730,2019-04-22,2019-04-22,2019-04-22,8.0,-3.57,53.38,0.0,162.0,           ,1.0,1.0,97.0
7370,Tulot,2019-04-23 10:26:05.217391295,2019-04-23,2019-04-23,2019-04-23,8.0,118.57,171.95,710.0,588.0,           ,0.0,1.0,260.0
7371,Tulot,2019-04-23 11:28:41.739130425,2019-04-23,2019-04-23,2019-04-23,8.0,207.65,379.6,710.0,588.0,           ,0.0,1.0,261.0
7372,Ravintolat_kahvilat,2019-04-23 22:57:23.478260860,2019-04-23,2019-04-23,2019-04-23,8.0,-2.51,377.09,0.0,162.0,           ,1.0,1.0,127.0
7373,Matkailu,2019-04-25 12:31:18.260869555,2019-04-25,2019-04-25,2019-04-25,8.0,-2.43,374.66,0.0,103.0,           ,0.0,1.0,1.0
7374,Tulot,2019-04-25 23:59:59.999999990,2019-04-25,2019-04-25,2019-04-25,8.0,0.69,375.35,710.0,588.0,           ,0.0,1.0,260.0
7375,Tulot,2019-04-26 02:05:13.043478250,2019-04-26,2019-04-26,2019-04-26,8.0,21.79,397.14,710.0,588.0,           ,0.0,1.0,259.0
7376,Ruoka_paivittaistavarakauppa,2019-04-26 13:33:54.782608685,2019-04-26,2019-04-26,2019-04-26,8.0,-143.18,253.96,0.0,162.0,           ,1.0,1.0,57.0
7377,Liikkuminen,2019-04-26 14:36:31.304347815,2019-04-26,2019-04-26,2019-04-26,8.0,-18.59,235.37,706.0,129.0,OKOYFIHH   ,0.0,0.0,237.0
7378,Ruoka_paivittaistavarakauppa,2019-04-29 01:02:36.521739120,2019-04-29,2019-04-29,2019-04-29,8.0,-8.28,227.09,0.0,162.0,           ,1.0,1.0,149.0
7379,Ruoka_paivittaistavarakauppa,2019-04-29 03:07:49.565217380,2019-04-29,2019-04-29,2019-04-29,8.0,-11.1,215.99,0.0,162.0,           ,1.0,1.0,106.0
7380,Ravintolat_kahvilat,2019-04-29 04:10:26.086956510,2019-04-29,2019-04-29,2019-04-29,8.0,-24.06,191.93,0.0,162.0,           ,1.0,1.0,85.0
7381,Ravintolat_kahvilat,2019-04-29 05:13:02.608695640,2019-04-29,2019-04-29,2019-04-29,8.0,-11.0,180.93,0.0,162.0,           ,1.0,1.0,131.0
7382,Tulot,2019-04-29 15:39:07.826086945,2019-04-29,2019-04-29,2019-04-29,8.0,26.08,207.01,710.0,588.0,           ,0.0,1.0,259.0
7383,Hyvinvointi,2019-04-29 16:41:44.347826075,2019-04-29,2019-04-29,2019-04-29,8.0,-5.32,201.69,0.0,162.0,           ,1.0,1.0,130.0
7384,Ruoka_paivittaistavarakauppa,2019-04-30 17:44:20.869565205,2019-04-30,2019-04-30,2019-04-30,8.0,-41.67,160.02,0.0,162.0,           ,1.0,1.0,117.0
7385,Tulot,2019-05-02 03:03:16.363636363,2019-05-02,2019-05-02,2019-05-02,8.0,63.16,223.18,701.0,520.0,           ,1.0,1.0,223.0
7386,Tulot,2019-05-03 06:06:32.727272726,2019-05-03,2019-05-03,2019-05-03,8.0,0.32,223.5,710.0,588.0,           ,0.0,1.0,261.0
7387,Tulot,2019-05-03 09:09:49.090909089,2019-05-03,2019-05-03,2019-05-03,8.0,53.16,276.66,710.0,588.0,           ,0.0,1.0,263.0
7388,Luokittelemattomat,2019-05-06 12:13:05.454545452,2019-05-06,2019-05-06,2019-05-06,8.0,-5.89,270.77,0.0,162.0,           ,1.0,1.0,120.0
7389,Asuminen,2019-05-06 15:16:21.818181815,2019-05-06,2019-05-06,2019-05-06,8.0,-36.82,233.95,706.0,129.0,DABAFIHH   ,0.0,0.0,237.0
7390,Tulot,2019-05-07 18:19:38.181818178,2019-05-07,2019-05-07,2019-05-07,8.0,143.97,377.92,710.0,588.0,           ,0.0,1.0,259.0
7391,Ruoka_paivittaistavarakauppa,2019-05-09 21:22:54.545454541,2019-05-09,2019-05-09,2019-05-09,8.0,-10.83,367.09,0.0,162.0,           ,1.0,1.0,126.0
7392,Liikkuminen,2019-05-10 00:26:10.909090904,2019-05-10,2019-05-10,2019-05-10,8.0,-10.19,356.9,0.0,162.0,           ,1.0,1.0,68.0
7393,Ruoka_paivittaistavarakauppa,2019-05-10 03:29:27.272727267,2019-05-10,2019-05-10,2019-05-10,8.0,-29.63,327.27,0.0,162.0,           ,1.0,1.0,166.0
7394,Ruoka_paivittaistavarakauppa,2019-05-13 06:32:43.636363630,2019-05-13,2019-05-13,2019-05-13,8.0,-11.91,315.36,0.0,162.0,           ,1.0,1.0,112.0
7395,Liikkuminen,2019-05-13 09:35:59.999999993,2019-05-13,2019-05-13,2019-05-13,8.0,-10.56,304.8,0.0,162.0,           ,1.0,1.0,107.0
7396,Saastot_sijoitukset,2019-05-13 12:39:16.363636356,2019-05-13,2019-05-13,2019-05-13,8.0,-14.38,290.42,0.0,162.0,           ,1.0,1.0,75.0
7397,Harrastukset,2019-05-15 15:42:32.727272719,2019-05-15,2019-05-15,2019-05-15,8.0,-83.73,206.69,706.0,129.0,OKOYFIHH   ,0.0,0.0,237.0
7398,Tulot,2019-05-16 18:45:49.090909082,2019-05-16,2019-05-16,2019-05-16,8.0,528.11,734.8,710.0,588.0,           ,0.0,1.0,259.0
7399,Ravintolat_kahvilat,2019-05-17 03:55:38.181818171,2019-05-17,2019-05-17,2019-05-17,8.0,-4.32,730.48,0.0,103.0,           ,0.0,1.0,1.0
7400,Ruoka_paivittaistavarakauppa,2019-05-17 21:49:05.454545445,2019-05-17,2019-05-17,2019-05-17,8.0,-10.44,720.04,0.0,162.0,           ,1.0,1.0,98.0
7401,Asuminen,2019-05-20 10:02:10.909090897,2019-05-20,2019-05-20,2019-05-20,8.0,-43.73,676.31,706.0,147.0,OKOYFIHH   ,0.0,0.0,248.0
7402,Tulot,2019-05-21 06:58:54.545454534,2019-05-21,2019-05-21,2019-05-21,8.0,0.55,676.86,710.0,588.0,           ,0.0,1.0,263.0
7403,Liikkuminen,2019-05-21 16:08:43.636363623,2019-05-21,2019-05-21,2019-05-21,8.0,-16.43,660.43,0.0,162.0,           ,1.0,1.0,129.0
7404,Ruoka_paivittaistavarakauppa,2019-05-22 00:52:21.818181808,2019-05-22,2019-05-22,2019-05-22,8.0,-9.27,651.16,0.0,162.0,           ,1.0,1.0,75.0
7405,Asuminen,2019-05-23 13:05:27.272727260,2019-05-23,2019-05-23,2019-05-23,8.0,-24.84,626.32,706.0,147.0,OKOYFIHH   ,0.0,0.0,252.0
7406,Ravintolat_kahvilat,2019-05-23 19:11:59.999999986,2019-05-23,2019-05-23,2019-05-23,8.0,-2.84,623.48,0.0,162.0,           ,1.0,1.0,145.0
7407,Ravintolat_kahvilat,2019-05-24 22:15:16.363636349,2019-05-24,2019-05-24,2019-05-24,8.0,-24.13,599.35,0.0,162.0,           ,1.0,1.0,133.0
7408,Ruoka_paivittaistavarakauppa,2019-05-27 04:21:49.090909075,2019-05-27,2019-05-27,2019-05-27,8.0,-19.43,579.92,0.0,162.0,           ,1.0,1.0,109.0
7409,Asuminen,2019-05-28 01:18:32.727272712,2019-05-28,2019-05-28,2019-05-28,8.0,-2.91,577.01,0.0,162.0,           ,1.0,1.0,157.0
7410,Ruoka_paivittaistavarakauppa,2019-05-29 07:25:05.454545438,2019-05-29,2019-05-29,2019-05-29,8.0,-3.83,573.18,0.0,162.0,           ,1.0,1.0,97.0
7411,Ravintolat_kahvilat,2019-05-31 10:28:21.818181801,2019-05-31,2019-05-31,2019-05-31,8.0,-1.1,572.08,0.0,162.0,           ,1.0,1.0,109.0
7412,Kulttuuri_viihde,2019-06-03 14:36:31.304347824,2019-06-03,2019-06-03,2019-06-03,8.0,-99.28,472.8,0.0,162.0,           ,1.0,1.0,124.0
7413,Tulot,2019-06-03 17:44:20.869565216,2019-06-03,2019-06-03,2019-06-03,8.0,61.79,534.59,701.0,520.0,           ,1.0,1.0,223.0
7414,Terveys,2019-06-03 20:52:10.434782608,2019-06-03,2019-06-03,2019-06-03,8.0,-25.39,509.2,0.0,192.0,           ,1.0,1.0,200.0
7415,Tulot,2019-06-04 11:28:41.739130432,2019-06-04,2019-06-05,2019-06-04,8.0,418.81,928.01,701.0,520.0,           ,1.0,1.0,224.0
7416,Luokittelemattomat,2019-06-05 08:20:52.173913040,2019-06-05,2019-06-05,2019-06-05,8.0,-85.9,842.11,706.0,129.0,OKOYFIHH   ,0.0,0.0,237.0
7417,Matkailu,2019-06-06 05:13:02.608695648,2019-06-06,2019-06-06,2019-06-06,8.0,-25.38,816.73,706.0,147.0,OKOYFIHH   ,0.0,0.0,248.0
7418,Vakuutukset,2019-06-07 02:05:13.043478256,2019-06-07,2019-06-07,2019-06-07,8.0,-152.06,664.67,706.0,129.0,OKOYFIHH   ,0.0,0.0,246.0
7419,Ruoka_paivittaistavarakauppa,2019-06-07 19:49:33.913043472,2019-06-07,2019-06-07,2019-06-07,8.0,-43.28,621.39,0.0,162.0,           ,1.0,1.0,114.0
7420,Luokittelemattomat,2019-06-07 22:57:23.478260864,2019-06-07,2019-06-07,2019-06-07,8.0,-304.34,317.05,706.0,129.0,OKOYFIHH   ,0.0,0.0,244.0
7421,Ruoka_paivittaistavarakauppa,2019-06-10 13:33:54.782608688,2019-06-10,2019-06-10,2019-06-10,8.0,-26.6,290.45,0.0,162.0,           ,1.0,1.0,42.0
7422,Asuminen,2019-06-11 10:26:05.217391296,2019-06-11,2019-06-11,2019-06-11,8.0,-38.65,251.8,706.0,129.0,NDEAFIHH   ,0.0,0.0,241.0
7423,Tulot,2019-06-11 16:41:44.347826080,2019-06-11,2019-06-11,2019-06-11,8.0,91.33,343.13,0.0,574.0,           ,1.0,1.0,218.0
7424,Asuminen,2019-06-13 04:10:26.086956512,2019-06-13,2019-06-13,2019-06-13,8.0,-10.33,332.8,0.0,106.0,OKOYFIHH   ,0.0,0.0,26.0
7425,Ruoka_paivittaistavarakauppa,2019-06-13 07:18:15.652173904,2019-06-13,2019-06-13,2019-06-13,8.0,-29.7,303.1,0.0,162.0,           ,1.0,1.0,135.0
7426,Tulot,2019-06-13 21:54:46.956521728,2019-06-13,2019-06-13,2019-06-13,8.0,57.11,360.21,710.0,588.0,           ,0.0,1.0,259.0
7427,Lemmikit,2019-06-14 01:02:36.521739120,2019-06-14,2019-06-17,2019-06-14,8.0,-51.6,308.61,0.0,106.0,OKOYFIHH   ,0.0,0.0,10.0
7428,Shoppailu,2019-06-17 15:39:07.826086944,2019-06-17,2019-06-17,2019-06-17,8.0,-19.32,289.29,0.0,162.0,           ,1.0,1.0,99.0
7429,Shoppailu,2019-06-17 18:46:57.391304336,2019-06-17,2019-06-17,2019-06-17,8.0,-24.92,264.37,0.0,162.0,           ,1.0,1.0,154.0
7430,Ruoka_paivittaistavarakauppa,2019-06-18 09:23:28.695652160,2019-06-18,2019-06-18,2019-06-18,8.0,-15.8,248.57,0.0,162.0,           ,1.0,1.0,42.0
7431,Tulot,2019-06-18 12:31:18.260869552,2019-06-18,2019-06-20,2019-06-18,8.0,202.27,450.84,701.0,520.0,           ,1.0,1.0,223.0
7432,Ruoka_paivittaistavarakauppa,2019-06-19 06:15:39.130434768,2019-06-19,2019-06-19,2019-06-19,8.0,-13.62,437.22,0.0,162.0,           ,1.0,1.0,146.0
7433,Terveys,2019-06-20 03:07:49.565217376,2019-06-20,2019-06-20,2019-06-20,8.0,-22.43,414.79,0.0,162.0,           ,1.0,1.0,147.0
7434,Ravintolat_kahvilat,2019-06-20 23:59:59.999999984,2019-06-20,2019-06-20,2019-06-20,8.0,-10.56,404.23,0.0,162.0,           ,1.0,1.0,114.0
7435,Asuminen,2019-06-21 17:44:20.869565200,2019-06-21,2019-06-21,2019-06-21,8.0,-17.68,386.55,706.0,129.0,DABAFIHH   ,0.0,0.0,239.0
7436,Ravintolat_kahvilat,2019-06-21 20:52:10.434782592,2019-06-21,2019-06-21,2019-06-21,8.0,-307.64,78.91,706.0,147.0,OKOYFIHH   ,0.0,0.0,252.0
7437,Luokittelemattomat,2019-06-24 08:20:52.173913024,2019-06-24,2019-06-24,2019-06-24,8.0,-10.83,68.08,0.0,162.0,           ,1.0,1.0,57.0
7438,Lapset,2019-06-24 11:28:41.739130416,2019-06-24,2019-06-24,2019-06-24,8.0,-17.6,50.48,0.0,162.0,           ,1.0,1.0,182.0
7439,Asuminen,2019-06-24 14:36:31.304347808,2019-06-24,2019-06-24,2019-06-24,8.0,-53.25,-2.77,706.0,129.0,DABAFIHH   ,0.0,0.0,242.0
7440,Liikkuminen,2019-06-27 02:05:13.043478240,2019-06-27,2019-06-27,2019-06-27,8.0,-13.91,-16.68,0.0,162.0,           ,1.0,1.0,126.0
7441,Ruoka_paivittaistavarakauppa,2019-06-27 19:49:33.913043456,2019-06-27,2019-06-27,2019-06-27,8.0,-5.85,-22.53,0.0,162.0,           ,1.0,1.0,141.0
7442,Tulot,2019-06-27 22:57:23.478260848,2019-06-27,2019-06-28,2019-06-27,8.0,146.94,124.41,710.0,506.0,           ,1.0,1.0,254.0
7443,Matkailu,2019-06-28 05:13:02.608695632,2019-06-28,2019-06-28,2019-06-28,8.0,-21.6,102.81,706.0,147.0,OKOYFIHH   ,0.0,0.0,253.0
7444,Matkailu,2019-06-28 13:33:54.782608672,2019-06-28,2019-06-28,2019-06-28,8.0,-9.21,93.6,706.0,147.0,OKOYFIHH   ,0.0,0.0,249.0
7445,Ruoka_paivittaistavarakauppa,2019-06-28 16:41:44.347826064,2019-06-28,2019-06-28,2019-06-28,8.0,-8.77,84.83,0.0,162.0,           ,1.0,1.0,87.0
7446,Asuminen,2019-07-01 22:12:32.238805970,2019-07-01,2019-07-01,2019-07-01,8.0,-3.08,81.75,706.0,147.0,NDEAFIHH   ,0.0,0.0,249.0
7447,Ruoka_paivittaistavarakauppa,2019-07-02 20:25:04.477611940,2019-07-02,2019-07-02,2019-07-02,8.0,-3.43,78.32,0.0,162.0,           ,1.0,1.0,136.0
7448,Lapset,2019-07-03 18:37:36.716417910,2019-07-03,2019-07-03,2019-07-03,8.0,-73.6,4.72,0.0,162.0,           ,1.0,1.0,148.0
7449,Ruoka_paivittaistavarakauppa,2019-07-04 16:50:08.955223880,2019-07-04,2019-07-04,2019-07-04,8.0,-1.26,3.46,0.0,162.0,           ,1.0,1.0,144.0
7450,Matkailu,2019-07-05 13:15:13.432835820,2019-07-05,2019-07-05,2019-07-05,8.0,-17.83,-14.37,706.0,129.0,OKOYFIHH   ,0.0,0.0,237.0
7451,Lemmikit,2019-07-05 15:02:41.194029850,2019-07-05,2019-07-05,2019-07-05,8.0,-0.95,-15.32,0.0,162.0,           ,1.0,1.0,117.0
7452,Hyvinvointijakauneus,2019-07-08 09:40:17.910447760,2019-07-08,2019-07-08,2019-07-08,8.0,-1.41,-16.73,0.0,162.0,           ,1.0,1.0,101.0
7453,Ruoka_paivittaistavarakauppa,2019-07-08 11:27:45.671641790,2019-07-08,2019-07-08,2019-07-08,8.0,-1.68,-18.41,0.0,162.0,           ,1.0,1.0,146.0
7454,Ruoka_paivittaistavarakauppa,2019-07-09 07:52:50.149253730,2019-07-09,2019-07-09,2019-07-09,8.0,-2.61,-21.02,0.0,162.0,           ,1.0,1.0,119.0
7455,Muut,2019-07-10 06:05:22.388059700,2019-07-10,2019-07-10,2019-07-10,8.0,-14.03,-35.05,0.0,163.0,           ,1.0,1.0,192.0
7456,Harrastukset,2019-07-11 02:30:26.865671640,2019-07-11,2019-07-11,2019-07-11,8.0,-16.73,-51.78,706.0,129.0,OKOYFIHH   ,0.0,0.0,238.0
7457,Hyvinvointijakauneus,2019-07-12 00:42:59.104477610,2019-07-12,2019-07-12,2019-07-12,8.0,-24.04,-75.82,0.0,106.0,OKOYFIHH   ,0.0,0.0,24.0
7458,Tulot,2019-07-12 04:17:54.626865670,2019-07-12,2019-07-12,2019-07-12,8.0,5.83,-69.99,701.0,510.0,           ,1.0,1.0,222.0
7459,Muut,2019-07-13 22:55:31.343283580,2019-07-13,2019-07-13,2019-07-13,8.0,-20.37,-90.36,0.0,163.0,           ,1.0,1.0,190.0
7460,Ruoka_paivittaistavarakauppa,2019-07-15 19:20:35.820895520,2019-07-15,2019-07-15,2019-07-15,8.0,-1.86,-92.22,0.0,162.0,           ,1.0,1.0,121.0
7461,Kulttuuri_viihde,2019-07-15 21:08:03.582089550,2019-07-15,2019-07-15,2019-07-15,8.0,-6.64,-98.86,0.0,162.0,           ,1.0,1.0,39.0
7462,Vakuutukset,2019-07-16 13:58:12.537313430,2019-07-16,2019-07-16,2019-07-16,8.0,-21.24,-120.1,706.0,129.0,NDEAFIHH   ,0.0,0.0,237.0
7463,Ruoka_paivittaistavarakauppa,2019-07-16 15:45:40.298507460,2019-07-16,2019-07-16,2019-07-16,8.0,-5.48,-125.58,0.0,162.0,           ,1.0,1.0,105.0
7464,Muut,2019-07-16 17:33:08.059701490,2019-07-16,2019-07-17,2019-07-16,8.0,-5.2,-130.78,706.0,147.0,NDEAFIHH   ,0.0,0.0,249.0
7465,Ruoka_paivittaistavarakauppa,2019-07-19 10:23:17.014925370,2019-07-19,2019-07-19,2019-07-19,8.0,-24.31,-155.09,0.0,162.0,           ,1.0,1.0,65.0
7466,Hyvinvointi,2019-07-19 12:10:44.776119400,2019-07-19,2019-07-19,2019-07-19,8.0,-2.67,-157.76,0.0,162.0,           ,1.0,1.0,168.0
7467,Tulot,2019-07-22 06:48:21.492537310,2019-07-22,2019-07-22,2019-07-22,8.0,9.92,-147.84,710.0,506.0,           ,1.0,1.0,256.0
7468,Ruoka_paivittaistavarakauppa,2019-07-22 08:35:49.253731340,2019-07-22,2019-07-22,2019-07-22,8.0,-10.78,-158.62,0.0,162.0,           ,1.0,1.0,155.0
7469,Muut,2019-07-23 05:00:53.731343280,2019-07-23,2019-07-23,2019-07-23,8.0,-2.57,-161.19,0.0,103.0,           ,0.0,1.0,2.0
7470,Asuminen,2019-07-24 03:13:25.970149250,2019-07-24,2019-07-24,2019-07-24,8.0,-14.62,-175.81,706.0,147.0,OKOYFIHH   ,0.0,0.0,249.0
7471,Luottojen_maksut,2019-07-25 01:25:58.208955220,2019-07-25,2019-07-25,2019-07-25,8.0,-6.82,-182.63,706.0,147.0,NDEAFIHH   ,0.0,0.0,248.0
7472,Liikkuminen,2019-07-26 20:03:34.925373130,2019-07-26,2019-07-26,2019-07-26,8.0,-10.91,-193.54,0.0,162.0,           ,1.0,1.0,164.0
7473,Ruoka_paivittaistavarakauppa,2019-07-26 21:51:02.686567160,2019-07-26,2019-07-26,2019-07-26,8.0,-3.13,-196.67,0.0,162.0,           ,1.0,1.0,150.0
7474,Hyvinvointijakauneus,2019-07-26 23:38:30.447761190,2019-07-26,2019-07-26,2019-07-26,8.0,-21.55,-218.22,0.0,162.0,           ,1.0,1.0,113.0
7475,Ruoka_paivittaistavarakauppa,2019-07-29 12:53:43.880597010,2019-07-29,2019-07-29,2019-07-29,8.0,-5.03,-223.25,0.0,162.0,           ,1.0,1.0,115.0
7476,Matkailu,2019-07-29 16:28:39.402985070,2019-07-29,2019-07-29,2019-07-29,8.0,-3.27,-226.52,0.0,162.0,           ,1.0,1.0,129.0
7477,Muut,2019-07-29 18:16:07.164179100,2019-07-29,2019-07-29,2019-07-29,8.0,-0.35,-226.87,0.0,162.0,           ,1.0,1.0,98.0
7478,Ruoka_paivittaistavarakauppa,2019-07-30 14:41:11.641791040,2019-07-30,2019-07-30,2019-07-30,8.0,-3.01,-229.88,0.0,162.0,           ,1.0,1.0,134.0
7479,Tulot,2019-08-01 15:20:24.742268041,2019-08-01,2019-08-01,2019-08-01,8.0,932.17,702.29,701.0,520.0,           ,1.0,1.0,226.0
7480,Ravintolat_kahvilat,2019-08-02 06:40:49.484536082,2019-08-02,2019-08-02,2019-08-02,8.0,-267.99,434.3,0.0,100.0,           ,1.0,1.0,0.0
7481,Asuminen,2019-08-02 13:21:38.969072164,2019-08-02,2019-08-02,2019-08-02,8.0,-12.83,421.47,706.0,129.0,NDEAFIHH   ,0.0,0.0,238.0
7482,Luottojen_maksut,2019-08-02 22:01:14.226804123,2019-08-02,2019-08-02,2019-08-02,8.0,-54.27,367.2,706.0,147.0,OKOYFIHH   ,0.0,0.0,248.0
7483,Matkailu,2019-08-05 04:42:03.711340205,2019-08-05,2019-08-05,2019-08-05,8.0,-38.24,328.96,706.0,147.0,OKOYFIHH   ,0.0,0.0,249.0
7484,Tulot,2019-08-05 11:22:53.195876287,2019-08-05,2019-08-05,2019-08-05,8.0,37.83,366.79,701.0,520.0,           ,1.0,1.0,224.0
7485,Hyvinvointi,2019-08-05 20:02:28.453608246,2019-08-05,2019-08-05,2019-08-05,8.0,-18.9,347.89,0.0,162.0,           ,1.0,1.0,179.0
7486,Shoppailu,2019-08-06 18:03:42.680412369,2019-08-06,2019-08-06,2019-08-06,8.0,-5.14,342.75,0.0,162.0,           ,1.0,1.0,142.0
7487,Ruoka_paivittaistavarakauppa,2019-08-07 02:43:17.938144328,2019-08-07,2019-08-07,2019-08-07,8.0,-20.94,321.81,0.0,162.0,           ,1.0,1.0,125.0
7488,Muut,2019-08-08 00:44:32.164948451,2019-08-08,2019-08-08,2019-08-08,8.0,-58.47,263.34,0.0,163.0,           ,1.0,1.0,191.0
7489,Ruoka_paivittaistavarakauppa,2019-08-08 09:24:07.422680410,2019-08-08,2019-08-08,2019-08-08,8.0,-9.8,253.54,0.0,162.0,           ,1.0,1.0,146.0
7490,Tulot,2019-08-08 16:04:56.907216492,2019-08-08,2019-08-09,2019-08-08,8.0,3.05,256.59,710.0,588.0,           ,0.0,1.0,260.0
7491,Luokittelemattomat,2019-08-09 07:25:21.649484533,2019-08-09,2019-08-09,2019-08-09,8.0,-158.07,98.52,0.0,106.0,OKOYFIHH   ,0.0,0.0,23.0
7492,Muut,2019-08-09 22:45:46.391752574,2019-08-09,2019-08-09,2019-08-09,8.0,-17.31,81.21,0.0,163.0,           ,1.0,1.0,192.0
7493,Asuminen,2019-08-12 03:27:50.103092779,2019-08-12,2019-08-12,2019-08-12,8.0,-31.22,49.99,706.0,129.0,OKOYFIHH   ,0.0,0.0,237.0
7494,Vakuutukset,2019-08-12 05:26:35.876288656,2019-08-12,2019-08-12,2019-08-12,8.0,-11.0,38.99,706.0,147.0,NDEAFIHH   ,0.0,0.0,248.0
7495,Vakuutukset,2019-08-12 12:07:25.360824738,2019-08-12,2019-08-12,2019-08-12,8.0,-7.72,31.27,706.0,129.0,OKOYFIHH   ,0.0,0.0,238.0
7496,Ravintolat_kahvilat,2019-08-12 14:06:11.134020615,2019-08-12,2019-08-12,2019-08-12,8.0,-119.68,-88.41,706.0,129.0,DABAFIHH   ,0.0,0.0,243.0
7497,Vakuutukset,2019-08-12 18:48:14.845360820,2019-08-12,2019-08-12,2019-08-12,8.0,-58.78,-147.19,706.0,129.0,OKOYFIHH   ,0.0,0.0,237.0
7498,Luokittelemattomat,2019-08-12 20:47:00.618556697,2019-08-12,2019-08-12,2019-08-12,8.0,-12.68,-159.87,706.0,129.0,OKOYFIHH   ,0.0,0.0,237.0
7499,Asuminen,2019-08-15 16:49:29.072164943,2019-08-15,2019-08-16,2019-08-15,8.0,-879.3,-1039.17,706.0,129.0,NDEAFIHH   ,0.0,0.0,238.0
7500,Hyvinvointijakauneus,2019-08-16 01:29:04.329896902,2019-08-16,2019-08-16,2019-08-16,8.0,-1.23,-1040.4,0.0,162.0,           ,1.0,1.0,128.0
7501,Matkailu,2019-08-16 06:11:08.041237107,2019-08-16,2019-08-16,2019-08-16,8.0,-0.66,-1041.06,0.0,103.0,           ,0.0,1.0,2.0
7502,Ruoka_paivittaistavarakauppa,2019-08-16 08:09:53.814432984,2019-08-16,2019-08-16,2019-08-16,8.0,-3.62,-1044.68,0.0,162.0,           ,1.0,1.0,157.0
7503,Luokittelemattomat,2019-08-16 10:08:39.587628861,2019-08-16,2019-08-16,2019-08-16,8.0,-1.0,-1045.68,0.0,162.0,           ,1.0,1.0,57.0
7504,Asuminen,2019-08-16 14:50:43.298969066,2019-08-16,2019-08-16,2019-08-16,8.0,-38.18,-1083.86,0.0,106.0,OKOYFIHH   ,0.0,0.0,16.0
7505,Luottojen_maksut,2019-08-16 21:31:32.783505148,2019-08-16,2019-08-16,2019-08-16,8.0,-12.61,-1096.47,706.0,147.0,OKOYFIHH   ,0.0,0.0,248.0
7506,Asuminen,2019-08-16 23:30:18.556701025,2019-08-16,2019-08-16,2019-08-16,8.0,-9.36,-1105.83,706.0,129.0,DABAFIHH   ,0.0,0.0,237.0
7507,Matkailu,2019-08-19 12:51:57.525773189,2019-08-19,2019-08-19,2019-08-19,8.0,-3.71,-1109.54,0.0,162.0,           ,1.0,1.0,113.0
7508,Ruoka_paivittaistavarakauppa,2019-08-20 04:12:22.268041230,2019-08-20,2019-08-20,2019-08-20,8.0,-9.38,-1118.92,0.0,162.0,           ,1.0,1.0,145.0
7509,Ruoka_paivittaistavarakauppa,2019-08-20 10:53:11.752577312,2019-08-20,2019-08-20,2019-08-20,8.0,-1.79,-1120.71,0.0,162.0,           ,1.0,1.0,128.0
7510,Hyvinvointijakauneus,2019-08-20 19:32:47.010309271,2019-08-20,2019-08-20,2019-08-20,8.0,-5.9,-1126.61,0.0,162.0,           ,1.0,1.0,153.0
7511,Ruoka_paivittaistavarakauppa,2019-08-21 02:13:36.494845353,2019-08-21,2019-08-21,2019-08-21,8.0,-11.46,-1138.07,0.0,162.0,           ,1.0,1.0,119.0
7512,Ruoka_paivittaistavarakauppa,2019-08-22 00:14:50.721649476,2019-08-22,2019-08-22,2019-08-22,8.0,-2.18,-1140.25,0.0,162.0,           ,1.0,1.0,112.0
7513,Muut,2019-08-22 17:34:01.237113394,2019-08-22,2019-08-22,2019-08-22,8.0,-1.59,-1141.84,0.0,103.0,           ,0.0,1.0,1.0
7514,Ruoka_paivittaistavarakauppa,2019-08-23 06:55:40.206185558,2019-08-23,2019-08-23,2019-08-23,8.0,-7.95,-1149.79,0.0,162.0,           ,1.0,1.0,78.0
7515,Asuminen,2019-08-23 08:54:25.979381435,2019-08-23,2019-08-23,2019-08-23,8.0,-14.62,-1164.41,706.0,147.0,OKOYFIHH   ,0.0,0.0,252.0
7516,Muut,2019-08-23 15:35:15.463917517,2019-08-23,2019-08-23,2019-08-23,8.0,-7.4,-1171.81,706.0,147.0,OKOYFIHH   ,0.0,0.0,248.0
7517,Muut,2019-08-25 20:17:19.175257722,2019-08-25,2019-08-25,2019-08-25,8.0,-18.11,-1189.92,0.0,163.0,           ,1.0,1.0,190.0
7518,Vakuutukset,2019-08-26 11:37:43.917525763,2019-08-26,2019-08-26,2019-08-26,8.0,-9.65,-1199.57,0.0,106.0,SBANFIHH   ,0.0,0.0,12.0
7519,Ruoka_paivittaistavarakauppa,2019-08-26 13:36:29.690721640,2019-08-26,2019-08-26,2019-08-26,8.0,-12.88,-1212.45,0.0,162.0,           ,1.0,1.0,135.0
7520,Saastot_sijoitukset,2019-08-26 22:16:04.948453599,2019-08-26,2019-08-26,2019-08-26,8.0,-3.92,-1216.37,0.0,162.0,           ,1.0,1.0,62.0
7521,Lapset,2019-08-27 04:56:54.432989681,2019-08-27,2019-08-27,2019-08-27,8.0,-10.9,-1227.27,0.0,162.0,           ,1.0,1.0,116.0
7522,Kulttuuri_viihde,2019-08-27 18:18:33.402061845,2019-08-27,2019-08-27,2019-08-27,8.0,-11.39,-1238.66,0.0,162.0,           ,1.0,1.0,74.0
7523,Ravintolat_kahvilat,2019-08-28 02:58:08.659793804,2019-08-28,2019-08-28,2019-08-28,8.0,-13.7,-1252.36,0.0,106.0,OKOYFIHH   ,0.0,0.0,10.0
7524,Matkailu,2019-08-30 00:59:22.886597927,2019-08-30,2019-08-30,2019-08-30,8.0,-10.1,-1262.46,706.0,129.0,NDEAFIHH   ,0.0,0.0,238.0
7525,Ruoka_paivittaistavarakauppa,2019-08-30 09:38:58.144329886,2019-08-30,2019-08-30,2019-08-30,8.0,-5.46,-1267.92,0.0,162.0,           ,1.0,1.0,122.0
7526,Tulot,2019-08-30 16:19:47.628865968,2019-08-30,2019-08-30,2019-08-30,8.0,678.81,-589.11,701.0,520.0,           ,1.0,1.0,223.0
7527,Luottojen_maksut,2019-09-02 21:42:51.428571428,2019-09-02,2019-09-02,2019-09-02,8.0,-22.86,-611.97,0.0,172.0,           ,1.0,1.0,198.0
7528,Muut,2019-09-02 22:51:25.714285714,2019-09-02,2019-09-02,2019-08-30,8.0,-4.24,-616.21,0.0,192.0,           ,0.0,1.0,201.0
7529,Tulot,2019-09-03 19:25:42.857142856,2019-09-03,2019-09-03,2019-09-03,8.0,996.23,380.02,701.0,520.0,           ,1.0,1.0,225.0
7530,Luokittelemattomat,2019-09-03 20:34:17.142857142,2019-09-03,2019-09-03,2019-09-03,8.0,-123.96,256.06,0.0,172.0,           ,1.0,1.0,197.0
7531,Matkailu,2019-09-05 15:59:59.999999998,2019-09-05,2019-09-05,2019-09-05,8.0,-14.46,241.6,706.0,147.0,OKOYFIHH   ,0.0,0.0,249.0
7532,Asuminen,2019-09-05 18:17:08.571428570,2019-09-05,2019-09-05,2019-09-05,8.0,-8.99,232.61,706.0,129.0,DABAFIHH   ,0.0,0.0,237.0
7533,Tulot,2019-09-06 17:08:34.285714284,2019-09-06,2019-09-06,2019-09-06,8.0,87.61,320.22,701.0,520.0,           ,1.0,1.0,224.0
7534,Ruoka_paivittaistavarakauppa,2019-09-09 13:42:51.428571426,2019-09-09,2019-09-09,2019-09-09,8.0,-17.7,302.52,0.0,162.0,           ,1.0,1.0,68.0
7535,Ravintolat_kahvilat,2019-09-09 14:51:25.714285712,2019-09-09,2019-09-09,2019-09-09,8.0,-5.46,297.06,0.0,162.0,           ,1.0,1.0,108.0
7536,Ravintolat_kahvilat,2019-09-10 12:34:17.142857140,2019-09-10,2019-09-10,2019-09-10,8.0,-7.36,289.7,0.0,162.0,           ,1.0,1.0,108.0
7537,Tulot,2019-09-11 11:25:42.857142854,2019-09-11,2019-09-11,2019-09-11,8.0,47.07,336.77,710.0,506.0,           ,1.0,1.0,254.0
7538,Matkailu,2019-09-12 10:17:08.571428568,2019-09-12,2019-09-12,2019-09-12,8.0,-11.38,325.39,0.0,106.0,DABAFIHH   ,0.0,0.0,30.0
7539,Ruoka_paivittaistavarakauppa,2019-09-13 09:08:34.285714282,2019-09-13,2019-09-13,2019-09-13,8.0,-59.48,265.91,0.0,162.0,           ,1.0,1.0,106.0
7540,Matkailu,2019-09-16 04:34:17.142857138,2019-09-16,2019-09-16,2019-09-16,8.0,-43.25,222.66,706.0,147.0,OKOYFIHH   ,0.0,0.0,248.0
7541,Luottojen_maksut,2019-09-16 05:42:51.428571424,2019-09-16,2019-09-16,2019-09-16,8.0,-15.9,206.76,706.0,147.0,OKOYFIHH   ,0.0,0.0,251.0
7542,Shoppailu,2019-09-16 06:51:25.714285710,2019-09-16,2019-09-16,2019-09-16,8.0,-18.12,188.64,0.0,162.0,           ,1.0,1.0,104.0
7543,Liikkuminen,2019-09-16 07:59:59.999999996,2019-09-16,2019-09-16,2019-09-16,8.0,-3.84,184.8,0.0,162.0,           ,1.0,1.0,117.0
7544,Ravintolat_kahvilat,2019-09-18 03:25:42.857142852,2019-09-18,2019-09-18,2019-09-18,8.0,-3.75,181.05,0.0,103.0,           ,0.0,1.0,3.0
7545,Ruoka_paivittaistavarakauppa,2019-09-19 02:17:08.571428566,2019-09-19,2019-09-19,2019-09-19,8.0,-22.44,158.61,0.0,162.0,           ,1.0,1.0,68.0
7546,Ruoka_paivittaistavarakauppa,2019-09-20 01:08:34.285714280,2019-09-20,2019-09-20,2019-09-20,8.0,-4.88,153.73,0.0,162.0,           ,1.0,1.0,135.0
7547,Harrastukset,2019-09-20 23:59:59.999999994,2019-09-20,2019-09-20,2019-09-20,8.0,-8.97,144.76,706.0,147.0,OKOYFIHH   ,0.0,0.0,250.0
7548,Matkailu,2019-09-23 19:25:42.857142850,2019-09-23,2019-09-23,2019-09-23,8.0,-2.98,141.78,0.0,162.0,           ,1.0,1.0,180.0
7549,Ravintolat_kahvilat,2019-09-23 20:34:17.142857136,2019-09-23,2019-09-23,2019-09-23,8.0,-1.43,140.35,0.0,162.0,           ,1.0,1.0,113.0
7550,Luottojen_maksut,2019-09-23 21:42:51.428571422,2019-09-23,2019-09-25,2019-09-23,8.0,-37.9,102.45,706.0,147.0,NDEAFIHH   ,0.0,0.0,248.0
7551,Ruoka_paivittaistavarakauppa,2019-09-23 22:51:25.714285708,2019-09-23,2019-09-23,2019-09-23,8.0,-14.46,87.99,0.0,162.0,           ,1.0,1.0,189.0
7552,Luottojen_maksut,2019-09-24 18:17:08.571428564,2019-09-24,2019-09-24,2019-09-24,8.0,-9.23,78.76,0.0,162.0,           ,1.0,1.0,52.0
7553,Ruoka_paivittaistavarakauppa,2019-09-27 14:51:25.714285706,2019-09-27,2019-09-27,2019-09-27,8.0,-8.71,70.05,0.0,162.0,           ,1.0,1.0,151.0
7554,Vakuutukset,2019-09-27 15:59:59.999999992,2019-09-27,2019-09-27,2019-09-27,8.0,-10.05,60.0,706.0,147.0,OKOYFIHH   ,0.0,0.0,249.0
7555,Muut,2019-09-27 17:08:34.285714278,2019-09-27,2019-09-27,2019-09-27,8.0,-2.75,57.25,0.0,162.0,           ,1.0,1.0,168.0
7556,Lapset,2019-09-30 12:34:17.142857134,2019-09-30,2019-09-30,2019-09-30,8.0,-8.4,48.85,0.0,162.0,           ,1.0,1.0,84.0
7557,Muut,2019-09-30 13:42:51.428571420,2019-09-30,2019-09-30,2019-09-30,8.0,-13.15,35.7,0.0,163.0,           ,1.0,1.0,190.0
7558,Tulot,2019-10-01 12:30:15.126050420,2019-10-01,2019-10-01,2019-10-01,8.0,516.42,552.12,701.0,520.0,           ,1.0,1.0,223.0
7559,Tulot,2019-10-02 01:00:30.252100840,2019-10-02,2019-10-02,2019-10-02,8.0,648.0,1200.12,701.0,520.0,           ,1.0,1.0,223.0
7560,Ruoka_paivittaistavarakauppa,2019-10-02 13:30:45.378151260,2019-10-02,2019-10-02,2019-10-02,8.0,-9.46,1190.66,0.0,162.0,           ,1.0,1.0,89.0
7561,Ravintolat_kahvilat,2019-10-03 02:01:00.504201680,2019-10-03,2019-10-03,2019-10-03,8.0,-2.01,1188.65,0.0,162.0,           ,1.0,1.0,119.0
7562,Ruoka_paivittaistavarakauppa,2019-10-03 14:31:15.630252100,2019-10-03,2019-10-03,2019-10-03,8.0,-36.73,1151.92,0.0,192.0,           ,0.0,1.0,200.0
7563,Tulot,2019-10-03 16:32:16.134453780,2019-10-03,2019-10-03,2019-10-03,8.0,82.92,1234.84,701.0,520.0,           ,1.0,1.0,225.0
7564,Ruoka_paivittaistavarakauppa,2019-10-04 03:01:30.756302520,2019-10-04,2019-10-04,2019-10-04,8.0,-38.51,1196.33,0.0,162.0,           ,1.0,1.0,176.0
7565,Ruoka_paivittaistavarakauppa,2019-10-04 04:02:01.008403360,2019-10-04,2019-10-04,2019-10-04,8.0,-4.18,1192.15,0.0,162.0,           ,1.0,1.0,41.0
7566,Ruoka_paivittaistavarakauppa,2019-10-04 15:31:45.882352940,2019-10-04,2019-10-04,2019-10-04,8.0,-14.2,1177.95,0.0,162.0,           ,1.0,1.0,158.0
7567,Muut,2019-10-07 05:02:31.260504200,2019-10-07,2019-10-07,2019-10-07,8.0,-115.02,1062.93,0.0,163.0,           ,1.0,1.0,190.0
7568,Ruoka_paivittaistavarakauppa,2019-10-07 06:03:01.512605040,2019-10-07,2019-10-10,2019-10-07,8.0,-9.62,1053.31,0.0,162.0,           ,1.0,1.0,186.0
7569,Ruoka_paivittaistavarakauppa,2019-10-07 17:32:46.386554620,2019-10-07,2019-10-09,2019-10-07,8.0,-4.82,1048.49,0.0,162.0,           ,1.0,1.0,58.0
7570,Ruoka_paivittaistavarakauppa,2019-10-07 18:33:16.638655460,2019-10-07,2019-10-07,2019-10-07,8.0,-29.5,1018.99,0.0,162.0,           ,1.0,1.0,169.0
7571,Shoppailu,2019-10-07 20:34:17.142857140,2019-10-07,2019-10-07,2019-10-07,8.0,-74.27,944.72,0.0,162.0,           ,1.0,1.0,160.0
7572,Ravintolat_kahvilat,2019-10-08 07:03:31.764705880,2019-10-08,2019-10-08,2019-10-08,8.0,-3.36,941.36,0.0,162.0,           ,1.0,1.0,65.0
7573,Saastot_sijoitukset,2019-10-08 19:33:46.890756300,2019-10-08,2019-10-08,2019-10-08,8.0,-125.05,816.31,0.0,162.0,           ,1.0,1.0,97.0
7574,Ruoka_paivittaistavarakauppa,2019-10-09 08:04:02.016806720,2019-10-09,2019-10-09,2019-10-09,8.0,-52.56,763.75,0.0,162.0,           ,1.0,1.0,109.0
7575,Ravintolat_kahvilat,2019-10-10 09:04:32.268907560,2019-10-10,2019-10-11,2019-10-10,8.0,-4.96,758.79,0.0,162.0,           ,1.0,1.0,78.0
7576,Matkailu,2019-10-10 21:34:47.394957980,2019-10-10,2019-10-10,2019-10-10,8.0,-32.29,726.5,706.0,147.0,OKOYFIHH   ,0.0,0.0,249.0
7577,Asuminen,2019-10-10 23:35:47.899159660,2019-10-10,2019-10-10,2019-10-10,8.0,-2.66,723.84,706.0,106.0,DABAFIHH   ,0.0,0.0,233.0
7578,Ruoka_paivittaistavarakauppa,2019-10-11 10:05:02.521008400,2019-10-11,2019-10-11,2019-10-11,8.0,-14.09,709.75,0.0,162.0,           ,1.0,1.0,165.0
7579,Tulot,2019-10-11 11:05:32.773109240,2019-10-11,2019-10-11,2019-10-11,8.0,19.88,729.63,701.0,520.0,           ,1.0,1.0,224.0
7580,Harrastukset,2019-10-11 22:35:17.647058820,2019-10-11,2019-10-11,2019-10-11,8.0,-56.38,673.25,0.0,162.0,           ,1.0,1.0,130.0
7581,Ruoka_paivittaistavarakauppa,2019-10-14 12:06:03.025210080,2019-10-14,2019-10-14,2019-10-14,8.0,-27.32,645.93,0.0,192.0,           ,0.0,1.0,200.0
7582,Vakuutukset,2019-10-14 13:06:33.277310920,2019-10-14,2019-10-14,2019-10-14,8.0,-87.23,558.7,706.0,129.0,SBANFIHH   ,0.0,0.0,241.0
7583,Luokittelemattomat,2019-10-14 14:07:03.529411760,2019-10-14,2019-10-14,2019-10-14,8.0,-19.49,539.21,0.0,162.0,           ,1.0,1.0,64.0
7584,Shoppailu,2019-10-15 00:36:18.151260500,2019-10-15,2019-10-16,2019-10-15,8.0,-48.53,490.68,0.0,192.0,           ,0.0,1.0,202.0
7585,Lapset,2019-10-15 01:36:48.403361340,2019-10-15,2019-10-15,2019-10-15,8.0,-1.78,488.9,0.0,162.0,           ,1.0,1.0,127.0
7586,Asuminen,2019-10-15 02:37:18.655462180,2019-10-15,2019-10-15,2019-10-15,8.0,-84.89,404.01,0.0,162.0,           ,1.0,1.0,157.0
7587,Ruoka_paivittaistavarakauppa,2019-10-16 03:37:48.907563020,2019-10-16,2019-10-16,2019-10-16,8.0,-62.85,341.16,0.0,162.0,           ,1.0,1.0,135.0
7588,Liikkuminen,2019-10-16 15:07:33.781512600,2019-10-16,2019-10-16,2019-10-16,8.0,-14.45,326.71,0.0,162.0,           ,1.0,1.0,108.0
7589,Lapset,2019-10-16 16:08:04.033613440,2019-10-16,2019-10-18,2019-10-16,8.0,-15.7,311.01,0.0,162.0,           ,1.0,1.0,138.0
7590,Tulot,2019-10-17 18:09:04.537815120,2019-10-17,2019-10-17,2019-10-17,8.0,21.91,332.92,710.0,588.0,           ,0.0,1.0,259.0
7591,Ravintolat_kahvilat,2019-10-18 04:38:19.159663860,2019-10-18,2019-10-18,2019-10-18,8.0,-69.87,263.05,0.0,192.0,           ,0.0,1.0,200.0
7592,Luokittelemattomat,2019-10-18 05:38:49.411764700,2019-10-18,2019-10-18,2019-10-18,8.0,-45.34,217.71,0.0,162.0,           ,1.0,1.0,57.0
7593,Ravintolat_kahvilat,2019-10-18 17:08:34.285714280,2019-10-18,2019-10-18,2019-10-18,8.0,-3.25,214.46,0.0,162.0,           ,1.0,1.0,135.0
7594,Luottojen_maksut,2019-10-21 06:39:19.663865540,2019-10-21,2019-10-21,2019-10-21,8.0,-2.95,211.51,0.0,162.0,           ,1.0,1.0,168.0
7595,Ruoka_paivittaistavarakauppa,2019-10-21 07:39:49.915966380,2019-10-21,2019-10-21,2019-10-21,8.0,-23.27,188.24,0.0,162.0,           ,1.0,1.0,113.0
7596,Matkailu,2019-10-21 08:40:20.168067220,2019-10-21,2019-10-21,2019-10-21,8.0,-9.27,178.97,706.0,105.0,OKOYFIHH   ,1.0,0.0,232.0
7597,Liikkuminen,2019-10-21 19:09:34.789915960,2019-10-21,2019-10-21,2019-10-21,8.0,-8.65,170.32,0.0,162.0,           ,1.0,1.0,97.0
7598,Ruoka_paivittaistavarakauppa,2019-10-21 20:10:05.042016800,2019-10-21,2019-10-21,2019-10-21,8.0,-22.7,147.62,0.0,162.0,           ,1.0,1.0,101.0
7599,Lapset,2019-10-21 21:10:35.294117640,2019-10-21,2019-10-21,2019-10-21,8.0,-1.23,146.39,0.0,162.0,           ,1.0,1.0,41.0
7600,Ruoka_paivittaistavarakauppa,2019-10-23 09:40:50.420168060,2019-10-23,2019-10-23,2019-10-23,8.0,-1.77,144.62,0.0,162.0,           ,1.0,1.0,182.0
7601,Tulot,2019-10-24 10:41:20.672268900,2019-10-24,2019-10-24,2019-10-24,8.0,-39.87,104.75,0.0,162.0,           ,1.0,1.0,133.0
7602,Liikkuminen,2019-10-24 22:11:05.546218480,2019-10-24,2019-10-25,2019-10-24,8.0,-27.74,77.01,0.0,162.0,           ,1.0,1.0,178.0
7603,Liikkuminen,2019-10-24 23:11:35.798319320,2019-10-24,2019-10-24,2019-10-24,8.0,-29.48,47.53,0.0,162.0,           ,1.0,1.0,119.0
7604,Ruoka_paivittaistavarakauppa,2019-10-25 00:12:06.050420160,2019-10-25,2019-10-25,2019-10-25,8.0,-4.78,42.75,0.0,162.0,           ,1.0,1.0,52.0
7605,Ruoka_paivittaistavarakauppa,2019-10-25 11:41:50.924369740,2019-10-25,2019-10-25,2019-10-25,8.0,-11.89,30.86,0.0,162.0,           ,1.0,1.0,117.0
7606,Kulttuuri_viihde,2019-10-25 12:42:21.176470580,2019-10-25,2019-10-25,2019-10-25,8.0,-17.37,13.49,0.0,162.0,           ,1.0,1.0,61.0
7607,Ruoka_paivittaistavarakauppa,2019-10-28 01:12:36.302521000,2019-10-28,2019-10-28,2019-10-23,8.0,-3.64,9.85,0.0,162.0,           ,1.0,1.0,105.0
7608,Ruoka_paivittaistavarakauppa,2019-10-28 02:13:06.554621840,2019-10-28,2019-10-28,2019-10-28,8.0,-1.72,8.13,0.0,162.0,           ,1.0,1.0,45.0
7609,Ruoka_paivittaistavarakauppa,2019-10-28 13:42:51.428571420,2019-10-28,2019-10-28,2019-10-28,8.0,-22.65,-14.52,0.0,162.0,           ,1.0,1.0,96.0
7610,Ruoka_paivittaistavarakauppa,2019-10-28 14:43:21.680672260,2019-10-28,2019-10-28,2019-10-28,8.0,-17.25,-31.77,0.0,162.0,           ,1.0,1.0,136.0
7611,Ruoka_paivittaistavarakauppa,2019-10-28 15:43:51.932773100,2019-10-28,2019-10-28,2019-10-28,8.0,-14.54,-46.31,0.0,162.0,           ,1.0,1.0,113.0
7612,Ruoka_paivittaistavarakauppa,2019-10-29 03:13:36.806722680,2019-10-29,2019-10-29,2019-10-29,8.0,-0.94,-47.25,0.0,162.0,           ,1.0,1.0,168.0
7613,Ruoka_paivittaistavarakauppa,2019-10-30 04:14:07.058823520,2019-10-30,2019-10-30,2019-10-30,8.0,-6.54,-53.79,0.0,162.0,           ,1.0,1.0,106.0
7614,Luokittelemattomat,2019-10-30 05:14:37.310924360,2019-10-30,2019-10-30,2019-10-30,8.0,-4.15,-57.94,0.0,162.0,           ,1.0,1.0,103.0
7615,Ruoka_paivittaistavarakauppa,2019-10-30 16:44:22.184873940,2019-10-30,2019-10-30,2019-10-30,8.0,-5.92,-63.86,0.0,162.0,           ,1.0,1.0,122.0
7616,Ruoka_paivittaistavarakauppa,2019-10-30 17:44:52.436974780,2019-10-30,2019-10-30,2019-10-30,8.0,-13.94,-77.8,0.0,162.0,           ,1.0,1.0,181.0
7617,Tulot,2019-11-01 17:20:57.831325301,2019-11-01,2019-11-01,2019-11-01,8.0,159.67,81.87,701.0,520.0,           ,1.0,1.0,223.0
7618,Muut,2019-11-02 10:41:55.662650602,2019-11-02,2019-11-02,2019-11-02,8.0,-31.33,50.54,0.0,163.0,           ,1.0,1.0,191.0
7619,Kulttuuri_viihde,2019-11-03 04:02:53.493975903,2019-11-03,2019-11-03,2019-11-03,8.0,-3.65,46.89,0.0,106.0,OKOYFIHH   ,0.0,0.0,18.0
7620,Ravintolat_kahvilat,2019-11-04 01:26:44.819277107,2019-11-04,2019-11-04,2019-11-04,8.0,-4.28,42.61,0.0,162.0,           ,1.0,1.0,45.0
7621,Tulot,2019-11-04 14:44:49.156626505,2019-11-04,2019-11-04,2019-11-04,8.0,-3.51,39.1,0.0,162.0,           ,1.0,1.0,98.0
7622,Ruoka_paivittaistavarakauppa,2019-11-04 21:23:51.325301204,2019-11-04,2019-11-04,2019-11-04,8.0,-14.27,24.83,0.0,162.0,           ,1.0,1.0,188.0
7623,Ruoka_paivittaistavarakauppa,2019-11-05 08:05:46.987951806,2019-11-05,2019-11-05,2019-11-05,8.0,-6.08,18.75,0.0,162.0,           ,1.0,1.0,134.0
7624,Saastot_sijoitukset,2019-11-05 18:47:42.650602408,2019-11-05,2019-11-06,2019-11-05,8.0,-8.95,9.8,0.0,162.0,           ,1.0,1.0,179.0
7625,Tulot,2019-11-07 05:29:38.313253010,2019-11-07,2019-11-07,2019-11-07,8.0,285.8,295.6,701.0,520.0,           ,1.0,1.0,228.0
7626,Ravintolat_kahvilat,2019-11-08 12:08:40.481927709,2019-11-08,2019-11-08,2019-11-07,8.0,-2.2,293.4,0.0,192.0,           ,0.0,1.0,200.0
7627,Ravintolat_kahvilat,2019-11-08 16:11:33.975903612,2019-11-08,2019-11-08,2019-11-08,8.0,-4.44,288.96,0.0,162.0,           ,1.0,1.0,148.0
7628,Saastot_sijoitukset,2019-11-08 22:50:36.144578311,2019-11-08,2019-11-08,2019-11-08,8.0,-8.2,280.76,0.0,162.0,           ,1.0,1.0,106.0
7629,Muut,2019-11-11 02:53:29.638554214,2019-11-11,2019-11-11,2019-11-11,8.0,-4.99,275.77,706.0,147.0,OKOYFIHH   ,0.0,0.0,252.0
7630,Ruoka_paivittaistavarakauppa,2019-11-11 06:56:23.132530117,2019-11-11,2019-11-11,2019-11-11,8.0,-1.62,274.15,0.0,162.0,           ,1.0,1.0,108.0
7631,Lemmikit,2019-11-11 09:32:31.807228913,2019-11-11,2019-11-11,2019-11-11,8.0,-20.28,253.87,0.0,162.0,           ,1.0,1.0,60.0
7632,Ruoka_paivittaistavarakauppa,2019-11-11 20:14:27.469879515,2019-11-11,2019-11-11,2019-11-11,8.0,-12.4,241.47,0.0,162.0,           ,1.0,1.0,135.0
7633,Ruoka_paivittaistavarakauppa,2019-11-12 13:35:25.301204816,2019-11-12,2019-11-14,2019-11-12,8.0,-46.19,195.28,0.0,162.0,           ,1.0,1.0,98.0
7634,Lemmikit,2019-11-13 17:38:18.795180719,2019-11-13,2019-11-13,2019-11-13,8.0,-2.74,192.54,0.0,162.0,           ,1.0,1.0,156.0
7635,Ravintolat_kahvilat,2019-11-15 00:17:20.963855418,2019-11-15,2019-11-15,2019-11-15,8.0,-2.08,190.46,0.0,162.0,           ,1.0,1.0,182.0
7636,Ravintolat_kahvilat,2019-11-15 04:20:14.457831321,2019-11-15,2019-11-15,2019-11-15,8.0,-2.54,187.92,0.0,162.0,           ,1.0,1.0,108.0
7637,Ravintolat_kahvilat,2019-11-15 10:59:16.626506020,2019-11-15,2019-11-15,2019-11-15,8.0,-4.32,183.6,0.0,162.0,           ,1.0,1.0,97.0
7638,Ruoka_paivittaistavarakauppa,2019-11-15 21:41:12.289156622,2019-11-15,2019-11-15,2019-11-15,8.0,-18.86,164.74,0.0,162.0,           ,1.0,1.0,114.0
7639,Saastot_sijoitukset,2019-11-18 08:23:07.951807224,2019-11-18,2019-11-18,2019-11-18,8.0,-79.11,85.63,0.0,162.0,           ,1.0,1.0,75.0
7640,Muut,2019-11-19 01:44:05.783132525,2019-11-19,2019-11-19,2019-11-19,8.0,-0.64,84.99,0.0,103.0,           ,0.0,1.0,1.0
7641,Ruoka_paivittaistavarakauppa,2019-11-19 12:26:01.445783127,2019-11-19,2019-11-19,2019-11-19,8.0,-1.9,83.09,0.0,162.0,           ,1.0,1.0,103.0
7642,Ruoka_paivittaistavarakauppa,2019-11-19 15:02:10.120481923,2019-11-19,2019-11-19,2019-11-19,8.0,-3.2,79.89,0.0,162.0,           ,1.0,1.0,75.0
7643,Muut,2019-11-19 19:05:03.614457826,2019-11-19,2019-11-19,2019-11-19,8.0,-1.36,78.53,0.0,103.0,           ,0.0,1.0,1.0
7644,Ruoka_paivittaistavarakauppa,2019-11-19 23:07:57.108433729,2019-11-19,2019-11-19,2019-11-19,8.0,-1.47,77.06,0.0,162.0,           ,1.0,1.0,78.0
7645,Ravintolat_kahvilat,2019-11-21 05:46:59.277108428,2019-11-21,2019-11-21,2019-11-21,8.0,-9.04,68.02,0.0,162.0,           ,1.0,1.0,99.0
7646,Ruoka_paivittaistavarakauppa,2019-11-22 16:28:54.939759030,2019-11-22,2019-11-22,2019-11-22,8.0,-4.54,63.48,0.0,162.0,           ,1.0,1.0,57.0
7647,Matkailu,2019-11-25 03:10:50.602409632,2019-11-25,2019-11-25,2019-11-25,8.0,-1.49,61.99,0.0,162.0,           ,1.0,1.0,138.0
7648,Saastot_sijoitukset,2019-11-25 09:49:52.771084331,2019-11-25,2019-11-25,2019-11-25,8.0,-24.61,37.38,0.0,192.0,           ,0.0,1.0,200.0
7649,Ruoka_paivittaistavarakauppa,2019-11-25 13:52:46.265060234,2019-11-25,2019-11-25,2019-11-25,8.0,-30.83,6.55,0.0,162.0,           ,1.0,1.0,161.0
7650,Ruoka_paivittaistavarakauppa,2019-11-25 20:31:48.433734933,2019-11-25,2019-11-25,2019-11-25,8.0,-0.66,5.89,0.0,162.0,           ,1.0,1.0,40.0
7651,Ruoka_paivittaistavarakauppa,2019-11-26 07:13:44.096385535,2019-11-26,2019-11-26,2019-11-25,8.0,-17.83,-11.94,0.0,162.0,           ,1.0,1.0,163.0
7652,Asuminen,2019-11-27 00:34:41.927710836,2019-11-27,2019-11-27,2019-11-27,8.0,-15.36,-27.3,706.0,147.0,NDEAFIHH   ,0.0,0.0,249.0
7653,Ruoka_paivittaistavarakauppa,2019-11-27 17:55:39.759036137,2019-11-27,2019-11-27,2019-11-27,8.0,-6.22,-33.52,0.0,162.0,           ,1.0,1.0,48.0
7654,Ravintolat_kahvilat,2019-11-29 04:37:35.421686739,2019-11-29,2019-11-29,2019-11-28,8.0,-6.23,-39.75,0.0,162.0,           ,1.0,1.0,115.0
7655,Liikkuminen,2019-11-29 11:16:37.590361438,2019-11-29,2019-11-29,2019-11-29,8.0,-3.1,-42.85,0.0,162.0,           ,1.0,1.0,145.0
7656,Ruoka_paivittaistavarakauppa,2019-11-29 15:19:31.084337341,2019-11-29,2019-11-29,2019-11-29,8.0,-4.12,-46.97,0.0,162.0,           ,1.0,1.0,170.0
7657,Muut,2019-11-29 21:58:33.253012040,2019-11-29,2019-11-29,2019-11-29,8.0,-25.44,-72.41,706.0,147.0,OKOYFIHH   ,0.0,0.0,252.0
7658,Ruoka_paivittaistavarakauppa,2019-12-02 17:54:55.774647886,2019-12-02,2019-12-02,2019-12-02,8.0,-21.99,-94.4,0.0,162.0,           ,1.0,1.0,106.0
7659,Liikkuminen,2019-12-02 20:57:27.887323943,2019-12-02,2019-12-02,2019-12-02,8.0,-66.5,-160.9,0.0,162.0,           ,1.0,1.0,114.0
7660,Muut,2019-12-03 14:52:23.661971829,2019-12-03,2019-12-03,2019-12-03,8.0,-9.54,-170.44,706.0,147.0,OKOYFIHH   ,0.0,0.0,248.0
7661,Ruoka_paivittaistavarakauppa,2019-12-04 11:49:51.549295772,2019-12-04,2019-12-04,2019-12-04,8.0,-11.08,-181.52,0.0,162.0,           ,1.0,1.0,64.0
7662,Liikkuminen,2019-12-05 08:47:19.436619715,2019-12-05,2019-12-05,2019-12-05,8.0,-9.0,-190.52,0.0,162.0,           ,1.0,1.0,39.0
7663,Saastot_sijoitukset,2019-12-06 02:42:15.211267601,2019-12-06,2019-12-06,2019-12-06,8.0,-33.76,-224.28,0.0,192.0,           ,0.0,1.0,200.0
7664,Ravintolat_kahvilat,2019-12-06 05:44:47.323943658,2019-12-06,2019-12-06,2019-12-06,8.0,-14.6,-238.88,0.0,162.0,           ,1.0,1.0,101.0
7665,Tulot,2019-12-06 17:34:38.873239430,2019-12-06,2019-12-06,2019-12-06,8.0,850.15,611.27,701.0,520.0,           ,1.0,1.0,224.0
7666,Luottojen_maksut,2019-12-09 20:37:10.985915487,2019-12-09,2019-12-09,2019-12-09,8.0,-187.62,423.65,0.0,172.0,           ,1.0,1.0,198.0
7667,Ravintolat_kahvilat,2019-12-09 23:39:43.098591544,2019-12-09,2019-12-09,2019-12-09,8.0,-18.24,405.41,0.0,192.0,           ,0.0,1.0,200.0
7668,Luokittelemattomat,2019-12-10 14:32:06.760563373,2019-12-10,2019-12-10,2019-12-10,8.0,-32.96,372.45,706.0,147.0,OKOYFIHH   ,0.0,0.0,248.0
7669,Hyvinvointijakauneus,2019-12-12 08:27:02.535211259,2019-12-12,2019-12-12,2019-12-12,8.0,-61.46,310.99,0.0,162.0,           ,1.0,1.0,75.0
7670,Hyvinvointi,2019-12-12 11:29:34.647887316,2019-12-12,2019-12-12,2019-12-12,8.0,-34.08,276.91,0.0,162.0,           ,1.0,1.0,162.0
7671,Luottojen_maksut,2019-12-16 02:21:58.309859145,2019-12-16,2019-12-16,2019-12-16,8.0,-39.33,237.58,0.0,172.0,           ,1.0,1.0,199.0
7672,Muut,2019-12-16 05:24:30.422535202,2019-12-16,2019-12-16,2019-12-16,8.0,-1.52,236.06,0.0,103.0,           ,0.0,1.0,1.0
7673,Ruoka_paivittaistavarakauppa,2019-12-16 14:11:49.859154917,2019-12-16,2019-12-16,2019-12-16,8.0,-13.18,222.88,0.0,162.0,           ,1.0,1.0,115.0
7674,Hyvinvointijakauneus,2019-12-16 17:14:21.971830974,2019-12-16,2019-12-16,2019-12-16,8.0,-1.8,221.08,0.0,162.0,           ,1.0,1.0,124.0
7675,Ruoka_paivittaistavarakauppa,2019-12-16 20:16:54.084507031,2019-12-16,2019-12-18,2019-12-16,8.0,-53.29,167.79,0.0,162.0,           ,1.0,1.0,145.0
7676,Ruoka_paivittaistavarakauppa,2019-12-16 23:19:26.197183088,2019-12-16,2019-12-16,2019-12-16,8.0,-14.6,153.19,0.0,162.0,           ,1.0,1.0,138.0
7677,Luokittelemattomat,2019-12-18 08:06:45.633802803,2019-12-18,2019-12-18,2019-12-18,8.0,-3.34,149.85,0.0,106.0,NDEAFIHH   ,0.0,0.0,11.0
7678,Ruoka_paivittaistavarakauppa,2019-12-18 11:09:17.746478860,2019-12-18,2019-12-18,2019-12-18,8.0,-16.0,133.85,0.0,162.0,           ,1.0,1.0,113.0
7679,Lapset,2019-12-20 02:01:41.408450689,2019-12-20,2019-12-20,2019-12-20,8.0,-10.99,122.86,0.0,162.0,           ,1.0,1.0,179.0
7680,Luokittelemattomat,2019-12-20 05:04:13.521126746,2019-12-20,2019-12-20,2019-12-20,8.0,-12.36,110.5,0.0,106.0,DABAFIHH   ,0.0,0.0,19.0
7681,Ruoka_paivittaistavarakauppa,2019-12-20 22:59:09.295774632,2019-12-20,2019-12-20,2019-12-20,8.0,-3.46,107.04,0.0,162.0,           ,1.0,1.0,117.0
7682,Luokittelemattomat,2019-12-23 10:49:00.845070404,2019-12-23,2019-12-23,2019-12-23,8.0,-43.99,63.05,0.0,162.0,           ,1.0,1.0,97.0
7683,Lapset,2019-12-23 16:54:05.070422518,2019-12-23,2019-12-23,2019-12-23,8.0,-23.99,39.06,0.0,162.0,           ,1.0,1.0,115.0
7684,Ruoka_paivittaistavarakauppa,2019-12-23 19:56:37.183098575,2019-12-23,2019-12-23,2019-12-23,8.0,-13.92,25.14,0.0,162.0,           ,1.0,1.0,99.0
7685,Tulot,2019-12-24 13:51:32.957746461,2019-12-24,2019-12-24,2019-12-24,8.0,53.17,78.31,0.0,505.0,           ,1.0,1.0,203.0
7686,Ravintolat_kahvilat,2019-12-25 07:46:28.732394347,2019-12-25,2019-12-25,2019-12-25,8.0,-6.42,71.89,0.0,162.0,           ,1.0,1.0,122.0
7687,Lapset,2019-12-26 01:41:24.507042233,2019-12-26,2019-12-26,2019-12-26,8.0,-15.11,56.78,0.0,162.0,           ,1.0,1.0,147.0
7688,Ravintolat_kahvilat,2019-12-27 04:43:56.619718290,2019-12-27,2019-12-27,2019-12-27,8.0,-2.85,53.93,0.0,162.0,           ,1.0,1.0,90.0
7689,Ruoka_paivittaistavarakauppa,2019-12-27 22:38:52.394366176,2019-12-27,2019-12-27,2019-12-27,8.0,-23.39,30.54,0.0,162.0,           ,1.0,1.0,108.0
7690,Ruoka_paivittaistavarakauppa,2019-12-30 13:31:16.056338005,2019-12-30,2020-01-01,2019-12-30,8.0,-1.09,29.45,0.0,162.0,           ,1.0,1.0,126.0
7691,Liikkuminen,2019-12-30 16:33:48.169014062,2019-12-30,2019-12-30,2019-12-30,8.0,-20.94,8.51,0.0,162.0,           ,1.0,1.0,125.0
7692,Ruoka_paivittaistavarakauppa,2019-12-30 19:36:20.281690119,2019-12-30,2019-12-30,2019-12-30,8.0,-1.4,7.11,0.0,162.0,           ,1.0,1.0,168.0
7693,Tulot,2020-01-02 00:23:36.393442622,2020-01-02,2020-01-02,2020-01-02,8.0,339.1,346.21,701.0,520.0,           ,1.0,1.0,223.0
7694,Ravintolat_kahvilat,2020-01-03 00:47:12.786885244,2020-01-03,2020-01-03,2020-01-03,8.0,-2.71,343.5,0.0,162.0,           ,1.0,1.0,122.0
7695,Ruoka_paivittaistavarakauppa,2020-01-06 01:10:49.180327866,2020-01-06,2020-01-06,2020-01-06,8.0,-28.61,314.89,0.0,162.0,           ,1.0,1.0,139.0
7696,Luokittelemattomat,2020-01-06 01:34:25.573770488,2020-01-06,2020-01-06,2020-01-06,8.0,-30.96,283.93,0.0,162.0,           ,1.0,1.0,52.0
7697,Ravintolat_kahvilat,2020-01-06 01:58:01.967213110,2020-01-06,2020-01-06,2020-01-06,8.0,-47.75,236.18,0.0,162.0,           ,1.0,1.0,157.0
7698,Ravintolat_kahvilat,2020-01-07 02:21:38.360655732,2020-01-07,2020-01-07,2020-01-07,8.0,-11.97,224.21,0.0,162.0,           ,1.0,1.0,115.0
7699,Saastot_sijoitukset,2020-01-09 02:45:14.754098354,2020-01-09,2020-01-09,2020-01-09,8.0,-25.86,198.35,706.0,147.0,OKOYFIHH   ,0.0,0.0,248.0
7700,Tulot,2020-01-10 03:08:51.147540976,2020-01-10,2020-01-10,2020-01-10,8.0,133.21,331.56,701.0,521.0,           ,1.0,1.0,229.0
7701,Luottojen_maksut,2020-01-10 03:32:27.540983598,2020-01-10,2020-01-10,2020-01-10,8.0,-40.38,291.18,706.0,147.0,OKOYFIHH   ,0.0,0.0,248.0
7702,Ruoka_paivittaistavarakauppa,2020-01-10 03:56:03.934426220,2020-01-10,2020-01-10,2020-01-10,8.0,-38.82,252.36,0.0,162.0,           ,1.0,1.0,175.0
7703,Ruoka_paivittaistavarakauppa,2020-01-13 04:19:40.327868842,2020-01-13,2020-01-13,2020-01-13,8.0,-33.87,218.49,0.0,162.0,           ,1.0,1.0,57.0
7704,Luottojen_maksut,2020-01-13 04:43:16.721311464,2020-01-13,2020-01-14,2020-01-13,8.0,-5.86,212.63,0.0,162.0,           ,1.0,1.0,179.0
7705,Liikkuminen,2020-01-13 05:06:53.114754086,2020-01-13,2020-01-13,2020-01-13,8.0,-10.91,201.72,0.0,162.0,           ,1.0,1.0,142.0
7706,Muut,2020-01-15 05:30:29.508196708,2020-01-15,2020-01-15,2020-01-15,8.0,-33.43,168.29,706.0,147.0,OKOYFIHH   ,0.0,0.0,248.0
7707,Ruoka_paivittaistavarakauppa,2020-01-16 05:54:05.901639330,2020-01-16,2020-01-16,2020-01-16,8.0,-0.58,167.71,0.0,162.0,           ,1.0,1.0,163.0
7708,Muut,2020-01-17 06:17:42.295081952,2020-01-17,2020-01-17,2020-01-17,8.0,-10.74,156.97,0.0,162.0,           ,1.0,1.0,105.0
7709,Ruoka_paivittaistavarakauppa,2020-01-17 06:41:18.688524574,2020-01-17,2020-01-17,2020-01-17,8.0,-13.02,143.95,0.0,162.0,           ,1.0,1.0,97.0
7710,Muut,2020-01-17 07:28:31.475409818,2020-01-17,2020-01-17,2020-01-17,8.0,-1.16,142.79,0.0,103.0,           ,0.0,1.0,1.0
7711,Ravintolat_kahvilat,2020-01-20 07:04:55.081967196,2020-01-20,2020-01-20,2020-01-20,8.0,-10.41,132.38,0.0,162.0,           ,1.0,1.0,105.0
7712,Ravintolat_kahvilat,2020-01-20 07:52:07.868852440,2020-01-20,2020-01-20,2020-01-20,8.0,-18.21,114.17,706.0,147.0,OKOYFIHH   ,0.0,0.0,248.0
7713,Asuminen,2020-01-22 08:15:44.262295062,2020-01-22,2020-01-22,2020-01-22,8.0,-20.53,93.64,0.0,162.0,           ,1.0,1.0,39.0
7714,Lemmikit,2020-01-22 08:39:20.655737684,2020-01-22,2020-01-23,2020-01-21,8.0,-2.46,91.18,0.0,162.0,           ,1.0,1.0,116.0
7715,Luokittelemattomat,2020-01-22 09:26:33.442622928,2020-01-22,2020-01-22,2020-01-22,8.0,-44.34,46.84,0.0,162.0,           ,1.0,1.0,177.0
7716,Ruoka_paivittaistavarakauppa,2020-01-23 09:02:57.049180306,2020-01-23,2020-01-23,2020-01-23,8.0,-10.24,36.6,0.0,162.0,           ,1.0,1.0,115.0
7717,Ruoka_paivittaistavarakauppa,2020-01-27 09:50:09.836065550,2020-01-27,2020-01-27,2020-01-27,8.0,-17.88,18.72,0.0,162.0,           ,1.0,1.0,149.0
7718,Ruoka_paivittaistavarakauppa,2020-01-27 10:13:46.229508172,2020-01-27,2020-01-27,2020-01-27,8.0,-1.83,16.89,0.0,162.0,           ,1.0,1.0,70.0
7719,Vakuutukset,2020-01-28 10:37:22.622950794,2020-01-28,2020-01-30,2020-01-28,8.0,-7.51,9.38,706.0,147.0,OKOYFIHH   ,0.0,0.0,248.0
7720,Ruoka_paivittaistavarakauppa,2020-01-28 11:00:59.016393416,2020-01-28,2020-01-28,2020-01-28,8.0,-11.12,-1.74,0.0,162.0,           ,1.0,1.0,149.0
7721,Ruoka_paivittaistavarakauppa,2020-01-29 11:24:35.409836038,2020-01-29,2020-01-29,2020-01-29,8.0,-1.4,-3.14,0.0,162.0,           ,1.0,1.0,52.0
7722,Lapset,2020-01-29 11:48:11.803278660,2020-01-29,2020-01-29,2020-01-29,8.0,-1.12,-4.26,0.0,162.0,           ,1.0,1.0,129.0
7723,Tulot,2020-02-03 08:22:19.534883720,2020-02-03,2020-02-03,2020-02-03,8.0,285.8,281.54,701.0,520.0,           ,1.0,1.0,227.0
7724,Hyvinvointijakauneus,2020-02-03 16:44:39.069767440,2020-02-03,2020-02-04,2020-02-03,8.0,-38.23,243.31,0.0,162.0,           ,1.0,1.0,98.0
7725,Ruoka_paivittaistavarakauppa,2020-02-04 01:06:58.604651160,2020-02-04,2020-02-04,2020-02-04,8.0,-8.5,234.81,0.0,162.0,           ,1.0,1.0,57.0
7726,Ruoka_paivittaistavarakauppa,2020-02-06 09:29:18.139534880,2020-02-06,2020-02-06,2020-02-06,8.0,-1.17,233.64,0.0,162.0,           ,1.0,1.0,117.0
7727,Liikkuminen,2020-02-07 17:51:37.674418600,2020-02-07,2020-02-07,2020-02-07,8.0,-70.22,163.42,0.0,162.0,           ,1.0,1.0,40.0
7728,Terveys,2020-02-10 02:13:57.209302320,2020-02-10,2020-02-10,2020-02-10,8.0,-31.76,131.66,0.0,162.0,           ,1.0,1.0,78.0
7729,Ruoka_paivittaistavarakauppa,2020-02-10 10:36:16.744186040,2020-02-10,2020-02-10,2020-02-10,8.0,-35.69,95.97,0.0,162.0,           ,1.0,1.0,168.0
7730,Ruoka_paivittaistavarakauppa,2020-02-11 03:20:55.813953480,2020-02-11,2020-02-11,2020-02-11,8.0,-3.3,92.67,0.0,162.0,           ,1.0,1.0,114.0
7731,Ruoka_paivittaistavarakauppa,2020-02-11 18:58:36.279069760,2020-02-11,2020-02-11,2020-02-11,8.0,-33.61,59.06,0.0,162.0,           ,1.0,1.0,153.0
7732,Liikkuminen,2020-02-14 11:43:15.348837200,2020-02-14,2020-02-14,2020-02-14,8.0,-16.9,42.16,0.0,162.0,           ,1.0,1.0,168.0
7733,Ruoka_paivittaistavarakauppa,2020-02-17 04:27:54.418604640,2020-02-17,2020-02-17,2020-02-17,8.0,-9.34,32.82,0.0,162.0,           ,1.0,1.0,98.0
7734,Ruoka_paivittaistavarakauppa,2020-02-17 20:05:34.883720920,2020-02-17,2020-02-17,2020-02-17,8.0,-19.02,13.8,0.0,162.0,           ,1.0,1.0,114.0
7735,Asuminen,2020-02-18 12:50:13.953488360,2020-02-18,2020-02-18,2020-02-18,8.0,-29.6,-15.8,0.0,162.0,           ,1.0,1.0,103.0
7736,Ruoka_paivittaistavarakauppa,2020-02-19 21:12:33.488372080,2020-02-19,2020-02-19,2020-02-19,8.0,-2.78,-18.58,0.0,162.0,           ,1.0,1.0,40.0
7737,Luokittelemattomat,2020-02-21 05:34:53.023255800,2020-02-21,2020-02-21,2020-02-21,8.0,-7.7,-26.28,0.0,162.0,           ,1.0,1.0,72.0
7738,Liikkuminen,2020-02-21 13:57:12.558139520,2020-02-21,2020-02-21,2020-02-21,8.0,-4.62,-30.9,0.0,162.0,           ,1.0,1.0,154.0
7739,Luokittelemattomat,2020-02-24 22:19:32.093023240,2020-02-24,2020-02-26,2020-02-24,8.0,-2.1,-33.0,0.0,162.0,           ,1.0,1.0,85.0
7740,Muut,2020-02-26 06:41:51.627906960,2020-02-26,2020-02-26,2020-02-26,8.0,-69.57,-102.57,0.0,163.0,           ,1.0,1.0,190.0
7741,Muut,2020-02-27 15:04:11.162790680,2020-02-27,2020-02-27,2020-02-27,8.0,-10.97,-113.54,0.0,163.0,           ,1.0,1.0,190.0
7742,Muut,2020-02-27 23:26:30.697674400,2020-02-27,2020-02-27,2020-02-27,8.0,-19.74,-133.28,0.0,162.0,           ,1.0,1.0,160.0
7743,Ruoka_paivittaistavarakauppa,2020-02-28 07:48:50.232558120,2020-02-28,2020-02-28,2020-02-28,8.0,-1.98,-135.26,0.0,162.0,           ,1.0,1.0,64.0
7744,Luokittelemattomat,2020-03-02 02:48:38.918918918,2020-03-02,2020-03-04,2020-03-02,8.0,-99.03,-234.29,0.0,162.0,           ,1.0,1.0,44.0
7745,Liikkuminen,2020-03-02 16:12:58.378378377,2020-03-02,2020-03-02,2020-03-02,8.0,-19.25,-253.54,0.0,106.0,OKOYFIHH   ,0.0,0.0,30.0
7746,Ravintolat_kahvilat,2020-03-03 05:37:17.837837836,2020-03-03,2020-03-03,2020-03-03,8.0,-6.27,-259.81,0.0,106.0,NDEAFIHH   ,0.0,0.0,10.0
7747,Tulot,2020-03-03 13:24:19.459459459,2020-03-03,2020-03-03,2020-03-03,8.0,799.5,539.69,701.0,520.0,           ,1.0,1.0,223.0
7748,Shoppailu,2020-03-03 19:01:37.297297295,2020-03-03,2020-03-03,2020-03-03,8.0,-14.48,525.21,0.0,162.0,           ,1.0,1.0,39.0
7749,Luokittelemattomat,2020-03-04 08:25:56.756756754,2020-03-04,2020-03-04,2020-03-04,8.0,-6.99,518.22,0.0,162.0,           ,1.0,1.0,114.0
7750,Ruoka_paivittaistavarakauppa,2020-03-04 21:50:16.216216213,2020-03-04,2020-03-04,2020-03-04,8.0,-12.34,505.88,0.0,162.0,           ,1.0,1.0,52.0
7751,Ravintolat_kahvilat,2020-03-05 00:38:55.135135131,2020-03-05,2020-03-05,2020-03-05,8.0,-5.5,500.38,0.0,162.0,           ,1.0,1.0,144.0
7752,Liikkuminen,2020-03-05 03:27:34.054054049,2020-03-05,2020-03-05,2020-03-04,8.0,-65.2,435.18,0.0,162.0,           ,1.0,1.0,127.0
7753,Ruoka_paivittaistavarakauppa,2020-03-05 11:14:35.675675672,2020-03-05,2020-03-06,2020-03-05,8.0,-12.2,422.98,0.0,162.0,           ,1.0,1.0,135.0
7754,Asuminen,2020-03-06 14:03:14.594594590,2020-03-06,2020-03-06,2020-03-06,8.0,-38.23,384.75,0.0,162.0,           ,1.0,1.0,113.0
7755,Asuminen,2020-03-06 16:51:53.513513508,2020-03-06,2020-03-06,2020-03-06,8.0,-14.02,370.73,0.0,162.0,           ,1.0,1.0,97.0
7756,Ruoka_paivittaistavarakauppa,2020-03-09 06:16:12.972972967,2020-03-09,2020-03-09,2020-03-09,8.0,-3.99,366.74,0.0,162.0,           ,1.0,1.0,168.0
7757,Ruoka_paivittaistavarakauppa,2020-03-09 09:04:51.891891885,2020-03-09,2020-03-09,2020-03-09,8.0,-4.93,361.81,0.0,162.0,           ,1.0,1.0,153.0
7758,Ruoka_paivittaistavarakauppa,2020-03-09 19:40:32.432432426,2020-03-09,2020-03-09,2020-03-09,8.0,-42.12,319.69,0.0,162.0,           ,1.0,1.0,124.0
7759,Hyvinvointi,2020-03-09 22:29:11.351351344,2020-03-09,2020-03-09,2020-03-09,8.0,-4.18,315.51,0.0,162.0,           ,1.0,1.0,52.0
7760,Liikkuminen,2020-03-10 11:53:30.810810803,2020-03-10,2020-03-11,2020-03-10,8.0,-56.42,259.09,0.0,162.0,           ,1.0,1.0,39.0
7761,Ruoka_paivittaistavarakauppa,2020-03-11 01:17:50.270270262,2020-03-11,2020-03-11,2020-03-11,8.0,-14.9,244.19,0.0,162.0,           ,1.0,1.0,133.0
7762,Ravintolat_kahvilat,2020-03-12 04:06:29.189189180,2020-03-12,2020-03-12,2020-03-12,8.0,-2.26,241.93,0.0,162.0,           ,1.0,1.0,148.0
7763,Ruoka_paivittaistavarakauppa,2020-03-12 14:42:09.729729721,2020-03-12,2020-03-12,2020-03-12,8.0,-5.24,236.69,0.0,162.0,           ,1.0,1.0,57.0
7764,Ruoka_paivittaistavarakauppa,2020-03-12 17:30:48.648648639,2020-03-12,2020-03-12,2020-03-12,8.0,-11.51,225.18,0.0,162.0,           ,1.0,1.0,99.0
7765,Ruoka_paivittaistavarakauppa,2020-03-13 06:55:08.108108098,2020-03-13,2020-03-13,2020-03-13,8.0,-24.49,200.69,0.0,162.0,           ,1.0,1.0,157.0
7766,Ruoka_paivittaistavarakauppa,2020-03-13 09:43:47.027027016,2020-03-13,2020-03-13,2020-03-13,8.0,-9.01,191.68,0.0,162.0,           ,1.0,1.0,124.0
7767,Lemmikit,2020-03-13 20:19:27.567567557,2020-03-13,2020-03-13,2020-03-13,8.0,-33.16,158.52,0.0,106.0,OKOYFIHH   ,0.0,0.0,27.0
7768,Luokittelemattomat,2020-03-13 23:08:06.486486475,2020-03-13,2020-03-13,2020-03-13,8.0,-9.25,149.27,0.0,162.0,           ,1.0,1.0,157.0
7769,Ruoka_paivittaistavarakauppa,2020-03-16 01:56:45.405405393,2020-03-16,2020-03-16,2020-03-16,8.0,-17.69,131.58,0.0,162.0,           ,1.0,1.0,123.0
7770,Hyvinvointijakauneus,2020-03-16 15:21:04.864864852,2020-03-16,2020-03-16,2020-03-16,8.0,-11.44,120.14,0.0,162.0,           ,1.0,1.0,146.0
7771,Ruoka_paivittaistavarakauppa,2020-03-17 04:45:24.324324311,2020-03-17,2020-03-17,2020-03-17,8.0,-1.21,118.93,0.0,162.0,           ,1.0,1.0,112.0
7772,Luokittelemattomat,2020-03-17 12:32:25.945945934,2020-03-17,2020-03-17,2020-03-17,8.0,-19.52,99.41,0.0,162.0,           ,1.0,1.0,168.0
7773,Ruoka_paivittaistavarakauppa,2020-03-18 07:34:03.243243229,2020-03-18,2020-03-18,2020-03-18,8.0,-26.48,72.93,0.0,162.0,           ,1.0,1.0,118.0
7774,Asuminen,2020-03-18 18:09:43.783783770,2020-03-18,2020-03-18,2020-03-18,8.0,-1.66,71.27,0.0,162.0,           ,1.0,1.0,144.0
7775,Ravintolat_kahvilat,2020-03-18 20:58:22.702702688,2020-03-18,2020-03-18,2020-03-18,8.0,-8.63,62.64,0.0,162.0,           ,1.0,1.0,124.0
7776,Liikkuminen,2020-03-19 10:22:42.162162147,2020-03-19,2020-03-19,2020-03-19,8.0,-24.95,37.69,0.0,162.0,           ,1.0,1.0,134.0
7777,Tulot,2020-03-19 23:47:01.621621606,2020-03-19,2020-03-19,2020-03-19,8.0,-10.82,26.87,0.0,162.0,           ,1.0,1.0,112.0
7778,Ruoka_paivittaistavarakauppa,2020-03-20 13:11:21.081081065,2020-03-20,2020-03-20,2020-03-20,8.0,-12.68,14.19,0.0,162.0,           ,1.0,1.0,122.0
7779,Ruoka_paivittaistavarakauppa,2020-03-23 02:35:40.540540524,2020-03-23,2020-03-23,2020-03-23,8.0,-13.21,0.98,0.0,162.0,           ,1.0,1.0,85.0
7780,Luokittelemattomat,2020-03-23 05:24:19.459459442,2020-03-23,2020-03-23,2020-03-23,8.0,-18.38,-17.4,0.0,162.0,           ,1.0,1.0,99.0
7781,Ruoka_paivittaistavarakauppa,2020-03-23 08:12:58.378378360,2020-03-23,2020-03-23,2020-03-23,8.0,-1.73,-19.13,0.0,162.0,           ,1.0,1.0,70.0
7782,Ruoka_paivittaistavarakauppa,2020-03-23 11:01:37.297297278,2020-03-23,2020-03-23,2020-03-23,8.0,-3.56,-22.69,0.0,162.0,           ,1.0,1.0,59.0
7783,Ruoka_paivittaistavarakauppa,2020-03-23 15:59:59.999999983,2020-03-23,2020-03-24,2020-03-23,8.0,-4.37,-27.06,0.0,162.0,           ,1.0,1.0,57.0
7784,Ruoka_paivittaistavarakauppa,2020-03-23 16:38:55.135135114,2020-03-23,2020-03-23,2020-03-23,8.0,-40.39,-67.45,0.0,162.0,           ,1.0,1.0,149.0
7785,Ruoka_paivittaistavarakauppa,2020-03-23 18:48:38.918918901,2020-03-23,2020-03-23,2020-03-23,8.0,-0.89,-68.34,0.0,162.0,           ,1.0,1.0,73.0
7786,Ruoka_paivittaistavarakauppa,2020-03-23 21:37:17.837837819,2020-03-23,2020-03-23,2020-03-23,8.0,-25.86,-94.2,0.0,162.0,           ,1.0,1.0,132.0
7787,Luokittelemattomat,2020-03-26 00:25:56.756756737,2020-03-26,2020-03-26,2020-03-26,8.0,-9.91,-104.11,0.0,162.0,           ,1.0,1.0,43.0
7788,Ruoka_paivittaistavarakauppa,2020-03-26 03:14:35.675675655,2020-03-26,2020-03-26,2020-03-26,8.0,-12.23,-116.34,0.0,162.0,           ,1.0,1.0,124.0
7789,Ruoka_paivittaistavarakauppa,2020-03-26 13:50:16.216216196,2020-03-26,2020-03-26,2020-03-26,8.0,-0.58,-116.92,0.0,162.0,           ,1.0,1.0,113.0
7790,Ruoka_paivittaistavarakauppa,2020-03-27 06:03:14.594594573,2020-03-27,2020-03-27,2020-03-27,8.0,-9.88,-126.8,0.0,162.0,           ,1.0,1.0,40.0
7791,Ruoka_paivittaistavarakauppa,2020-03-27 08:51:53.513513491,2020-03-27,2020-03-27,2020-03-27,8.0,-27.23,-154.03,0.0,162.0,           ,1.0,1.0,168.0
7792,Ravintolat_kahvilat,2020-03-27 19:27:34.054054032,2020-03-27,2020-03-27,2020-03-27,8.0,-1.06,-155.09,0.0,162.0,           ,1.0,1.0,157.0
7793,Ruoka_paivittaistavarakauppa,2020-03-27 22:16:12.972972950,2020-03-27,2020-03-27,2020-03-27,8.0,-3.67,-158.76,0.0,162.0,           ,1.0,1.0,152.0
7794,Ruoka_paivittaistavarakauppa,2020-03-30 01:04:51.891891868,2020-03-30,2020-03-30,2020-03-30,8.0,-4.08,-162.84,0.0,162.0,           ,1.0,1.0,123.0
7795,Ravintolat_kahvilat,2020-03-30 03:53:30.810810786,2020-03-30,2020-03-30,2020-03-30,8.0,-14.59,-177.43,0.0,162.0,           ,1.0,1.0,64.0
7796,Ravintolat_kahvilat,2020-03-30 11:40:32.432432409,2020-03-30,2020-03-30,2020-03-30,8.0,-3.46,-180.89,0.0,162.0,           ,1.0,1.0,159.0
7797,Ruoka_paivittaistavarakauppa,2020-03-30 14:29:11.351351327,2020-03-30,2020-03-30,2020-03-30,8.0,-4.8,-185.69,0.0,162.0,           ,1.0,1.0,110.0
7798,Ruoka_paivittaistavarakauppa,2020-03-31 17:17:50.270270245,2020-03-31,2020-03-31,2020-03-31,8.0,-7.03,-192.72,0.0,162.0,           ,1.0,1.0,52.0
7799,Lapset,2020-04-01 22:40:37.795275590,2020-04-01,2020-04-01,2020-04-01,8.0,-9.06,-201.78,0.0,162.0,           ,1.0,1.0,131.0
7800,Ruoka_paivittaistavarakauppa,2020-04-02 10:00:56.692913385,2020-04-02,2020-04-02,2020-04-02,8.0,-42.07,-243.85,0.0,162.0,           ,1.0,1.0,52.0
7801,Ravintolat_kahvilat,2020-04-02 11:20:18.897637795,2020-04-02,2020-04-02,2020-04-02,8.0,-7.25,-251.1,0.0,162.0,           ,1.0,1.0,128.0
7802,Muut,2020-04-02 21:21:15.590551180,2020-04-02,2020-04-02,2020-04-02,8.0,-54.15,-305.25,0.0,164.0,           ,1.0,1.0,194.0
7803,Ruoka_paivittaistavarakauppa,2020-04-03 07:22:12.283464565,2020-04-03,2020-04-03,2020-04-03,8.0,-2.94,-308.19,0.0,162.0,           ,1.0,1.0,113.0
7804,Lapset,2020-04-03 08:41:34.488188975,2020-04-03,2020-04-03,2020-04-03,8.0,-37.18,-345.37,0.0,162.0,           ,1.0,1.0,124.0
7805,Ruoka_paivittaistavarakauppa,2020-04-03 18:42:31.181102360,2020-04-03,2020-04-03,2020-04-03,8.0,-9.53,-354.9,0.0,162.0,           ,1.0,1.0,68.0
7806,Matkailu,2020-04-03 20:01:53.385826770,2020-04-03,2020-04-03,2020-04-03,8.0,-55.31,-410.21,0.0,162.0,           ,1.0,1.0,124.0
7807,Muut,2020-04-06 04:43:27.874015745,2020-04-06,2020-04-08,2020-04-06,8.0,-8.93,-419.14,0.0,162.0,           ,1.0,1.0,158.0
7808,Ravintolat_kahvilat,2020-04-06 06:02:50.078740155,2020-04-06,2020-04-06,2020-04-06,8.0,-12.6,-431.74,0.0,162.0,           ,1.0,1.0,165.0
7809,Luottojen_maksut,2020-04-06 16:03:46.771653540,2020-04-06,2020-04-06,2020-04-06,8.0,-0.57,-432.31,0.0,162.0,           ,1.0,1.0,120.0
7810,Ruoka_paivittaistavarakauppa,2020-04-06 17:23:08.976377950,2020-04-06,2020-04-06,2020-04-06,8.0,-16.87,-449.18,0.0,162.0,           ,1.0,1.0,172.0
7811,Muut,2020-04-07 00:45:21.259842515,2020-04-07,2020-04-07,2020-04-07,8.0,-1.02,-450.2,0.0,105.0,OKOYFIHH   ,1.0,0.0,8.0
7812,Muut,2020-04-07 03:24:05.669291335,2020-04-07,2020-04-07,2020-04-07,8.0,-4.68,-454.88,0.0,162.0,           ,1.0,1.0,114.0
7813,Ruoka_paivittaistavarakauppa,2020-04-07 14:44:24.566929130,2020-04-07,2020-04-07,2020-04-07,8.0,-3.24,-458.12,0.0,162.0,           ,1.0,1.0,101.0
7814,Tulot,2020-04-08 02:04:43.464566925,2020-04-08,2020-04-08,2020-04-08,8.0,482.43,24.31,0.0,506.0,           ,1.0,1.0,208.0
7815,Muut,2020-04-08 13:25:02.362204720,2020-04-08,2020-04-08,2020-04-08,8.0,-37.93,-13.62,0.0,163.0,           ,1.0,1.0,190.0
7816,Ruoka_paivittaistavarakauppa,2020-04-09 12:05:40.157480310,2020-04-09,2020-04-09,2020-04-09,8.0,-1.46,-15.08,0.0,162.0,           ,1.0,1.0,123.0
7817,Ruoka_paivittaistavarakauppa,2020-04-09 23:25:59.055118105,2020-04-09,2020-04-09,2020-04-09,8.0,-6.55,-21.63,0.0,162.0,           ,1.0,1.0,98.0
7818,Ruoka_paivittaistavarakauppa,2020-04-10 08:07:33.543307080,2020-04-10,2020-04-10,2020-04-10,8.0,-67.87,-89.5,0.0,162.0,           ,1.0,1.0,115.0
7819,Ruoka_paivittaistavarakauppa,2020-04-10 20:47:14.645669285,2020-04-10,2020-04-10,2020-04-10,8.0,-1.13,-90.63,0.0,162.0,           ,1.0,1.0,98.0
7820,Muut,2020-04-10 22:06:36.850393695,2020-04-10,2020-04-10,2020-04-10,8.0,-1.64,-92.27,0.0,162.0,           ,1.0,1.0,108.0
7821,Tulot,2020-04-11 10:46:17.952755900,2020-04-11,2020-04-11,2020-04-11,8.0,89.9,-2.37,0.0,559.0,           ,1.0,1.0,217.0
7822,Tulot,2020-04-12 09:26:55.748031490,2020-04-12,2020-04-12,2020-04-12,8.0,22.81,20.44,0.0,506.0,           ,1.0,1.0,207.0
7823,Tulot,2020-04-13 06:48:11.338582670,2020-04-13,2020-04-13,2020-04-13,8.0,255.43,275.87,0.0,559.0,           ,1.0,1.0,217.0
7824,Luottojen_maksut,2020-04-13 18:08:30.236220465,2020-04-13,2020-04-13,2020-04-13,8.0,-40.02,235.85,0.0,106.0,OKOYFIHH   ,1.0,0.0,12.0
7825,Muut,2020-04-13 19:27:52.440944875,2020-04-13,2020-04-13,2020-04-13,8.0,-4.68,231.17,0.0,162.0,           ,1.0,1.0,40.0
7826,Ravintolat_kahvilat,2020-04-14 04:09:26.929133850,2020-04-14,2020-04-14,2020-04-14,8.0,-4.94,226.23,0.0,162.0,           ,1.0,1.0,97.0
7827,Kulttuuri_viihde,2020-04-14 05:28:49.133858260,2020-04-14,2020-04-14,2020-04-14,8.0,-164.63,61.6,0.0,106.0,OKOYFIHH   ,0.0,0.0,26.0
7828,Ruoka_paivittaistavarakauppa,2020-04-14 16:49:08.031496055,2020-04-14,2020-04-14,2020-04-14,8.0,-0.53,61.07,0.0,162.0,           ,1.0,1.0,99.0
7829,Liikkuminen,2020-04-15 15:29:45.826771645,2020-04-15,2020-04-15,2020-04-15,8.0,-47.24,13.83,0.0,162.0,           ,1.0,1.0,141.0
7830,Ruoka_paivittaistavarakauppa,2020-04-16 02:50:04.724409440,2020-04-16,2020-04-16,2020-04-16,8.0,-5.6,8.23,0.0,162.0,           ,1.0,1.0,115.0
7831,Kulttuuri_viihde,2020-04-16 12:51:01.417322825,2020-04-16,2020-04-16,2020-04-16,8.0,-6.29,1.94,0.0,162.0,           ,1.0,1.0,78.0
7832,Ruoka_paivittaistavarakauppa,2020-04-17 01:30:42.519685030,2020-04-17,2020-04-17,2020-04-17,8.0,-1.04,0.9,0.0,162.0,           ,1.0,1.0,112.0
7833,Ruoka_paivittaistavarakauppa,2020-04-17 11:31:39.212598415,2020-04-17,2020-04-17,2020-04-17,8.0,-0.96,-0.06,0.0,162.0,           ,1.0,1.0,139.0
7834,Ruoka_paivittaistavarakauppa,2020-04-17 14:10:23.622047235,2020-04-17,2020-04-17,2020-04-17,8.0,-1.32,-1.38,0.0,162.0,           ,1.0,1.0,42.0
7835,Ruoka_paivittaistavarakauppa,2020-04-20 00:11:20.314960620,2020-04-20,2020-04-20,2020-04-20,8.0,-8.25,-9.63,0.0,162.0,           ,1.0,1.0,116.0
7836,Shoppailu,2020-04-20 06:14:10.393700775,2020-04-20,2020-04-20,2020-04-20,8.0,-6.1,-15.73,0.0,162.0,           ,1.0,1.0,179.0
7837,Liikkuminen,2020-04-20 07:33:32.598425185,2020-04-20,2020-04-20,2020-04-20,8.0,-4.85,-20.58,0.0,162.0,           ,1.0,1.0,179.0
7838,Vakuutukset,2020-04-20 08:52:54.803149595,2020-04-20,2020-04-21,2020-04-20,8.0,-12.55,-33.13,0.0,106.0,OKOYFIHH   ,0.0,0.0,9.0
7839,Liikkuminen,2020-04-20 10:12:17.007874005,2020-04-20,2020-04-20,2020-04-20,8.0,-4.07,-37.2,0.0,162.0,           ,1.0,1.0,85.0
7840,Ruoka_paivittaistavarakauppa,2020-04-20 18:53:51.496062980,2020-04-20,2020-04-20,2020-04-20,8.0,-4.87,-42.07,0.0,162.0,           ,1.0,1.0,152.0
7841,Ravintolat_kahvilat,2020-04-20 20:13:13.700787390,2020-04-20,2020-04-20,2020-04-20,8.0,-1.79,-43.86,0.0,162.0,           ,1.0,1.0,180.0
7842,Kulttuuri_viihde,2020-04-20 21:32:35.905511800,2020-04-20,2020-04-20,2020-04-20,8.0,-3.06,-46.92,0.0,162.0,           ,1.0,1.0,148.0
7843,Ruoka_paivittaistavarakauppa,2020-04-20 22:51:58.110236210,2020-04-20,2020-04-20,2020-04-20,8.0,-3.64,-50.56,0.0,162.0,           ,1.0,1.0,52.0
7844,Muut,2020-04-23 04:54:48.188976365,2020-04-23,2020-04-23,2020-04-23,8.0,-17.88,-68.44,0.0,163.0,           ,1.0,1.0,190.0
7845,Ruoka_paivittaistavarakauppa,2020-04-23 17:34:29.291338570,2020-04-23,2020-04-23,2020-04-23,8.0,-3.17,-71.61,0.0,162.0,           ,1.0,1.0,140.0
7846,Muut,2020-04-24 02:16:03.779527545,2020-04-24,2020-04-24,2020-04-24,8.0,-13.95,-85.56,0.0,162.0,           ,1.0,1.0,64.0
7847,Ruoka_paivittaistavarakauppa,2020-04-24 03:35:25.984251955,2020-04-24,2020-04-24,2020-04-24,8.0,-7.87,-93.43,0.0,162.0,           ,1.0,1.0,124.0
7848,Tulot,2020-04-24 14:55:44.881889750,2020-04-24,2020-04-24,2020-04-24,8.0,-14.65,-108.08,0.0,162.0,           ,1.0,1.0,135.0
7849,Ruoka_paivittaistavarakauppa,2020-04-24 16:15:07.086614160,2020-04-24,2020-04-24,2020-04-24,8.0,-2.29,-110.37,0.0,162.0,           ,1.0,1.0,103.0
7850,Ravintolat_kahvilat,2020-04-27 00:56:41.574803135,2020-04-27,2020-04-27,2020-04-27,8.0,-3.89,-114.26,0.0,162.0,           ,1.0,1.0,135.0
7851,Muut,2020-04-27 08:18:53.858267700,2020-04-27,2020-04-27,2020-04-27,8.0,-5.2,-119.46,0.0,162.0,           ,1.0,1.0,57.0
7852,Ruoka_paivittaistavarakauppa,2020-04-27 10:57:38.267716520,2020-04-27,2020-04-27,2020-04-27,8.0,-3.89,-123.35,0.0,162.0,           ,1.0,1.0,116.0
7853,Ruoka_paivittaistavarakauppa,2020-04-27 13:36:22.677165340,2020-04-27,2020-04-27,2020-04-27,8.0,-0.69,-124.04,0.0,162.0,           ,1.0,1.0,174.0
7854,Ruoka_paivittaistavarakauppa,2020-04-27 20:58:34.960629905,2020-04-27,2020-04-30,2020-04-27,8.0,-2.2,-126.24,0.0,162.0,           ,1.0,1.0,146.0
7855,Ruoka_paivittaistavarakauppa,2020-04-27 22:17:57.165354315,2020-04-27,2020-04-27,2020-04-27,8.0,-4.06,-130.3,0.0,162.0,           ,1.0,1.0,112.0
7856,Ravintolat_kahvilat,2020-04-27 23:37:19.370078725,2020-04-27,2020-04-28,2020-04-27,8.0,-25.44,-155.74,0.0,162.0,           ,1.0,1.0,184.0
7857,Ruoka_paivittaistavarakauppa,2020-04-28 09:38:16.062992110,2020-04-28,2020-04-28,2020-04-28,8.0,-1.28,-157.02,0.0,162.0,           ,1.0,1.0,169.0
7858,Ruoka_paivittaistavarakauppa,2020-04-29 12:17:00.472440930,2020-04-29,2020-04-29,2020-04-29,8.0,-9.91,-166.93,0.0,162.0,           ,1.0,1.0,78.0
7859,Ravintolat_kahvilat,2020-04-29 18:19:50.551181085,2020-04-29,2020-04-29,2020-04-29,8.0,-2.08,-169.01,0.0,162.0,           ,1.0,1.0,52.0
7860,Ruoka_paivittaistavarakauppa,2020-04-29 19:39:12.755905495,2020-04-29,2020-04-29,2020-04-29,8.0,-17.31,-186.32,0.0,162.0,           ,1.0,1.0,39.0
7861,Ruoka_paivittaistavarakauppa,2020-04-30 06:59:31.653543290,2020-04-30,2020-04-30,2020-04-30,8.0,-0.61,-186.93,0.0,162.0,           ,1.0,1.0,120.0
7862,Ruoka_paivittaistavarakauppa,2020-05-01 06:47:10.344827586,2020-05-01,2020-05-01,2020-05-01,8.0,-10.93,-197.86,0.0,162.0,           ,1.0,1.0,112.0
7863,Hyvinvointi,2020-05-01 10:15:43.448275862,2020-05-01,2020-05-01,2020-05-01,8.0,-1.8,-199.66,0.0,162.0,           ,1.0,1.0,107.0
7864,Hyvinvointijakauneus,2020-05-01 13:34:20.689655172,2020-05-01,2020-05-01,2020-05-01,8.0,-0.98,-200.64,0.0,162.0,           ,1.0,1.0,101.0
7865,Tulot,2020-05-01 20:31:26.896551724,2020-05-01,2020-05-01,2020-05-01,8.0,482.93,282.29,701.0,524.0,           ,1.0,1.0,231.0
7866,Ruoka_paivittaistavarakauppa,2020-05-04 03:18:37.241379310,2020-05-04,2020-05-04,2020-05-04,8.0,-15.32,266.97,0.0,162.0,           ,1.0,1.0,87.0
7867,Ruoka_paivittaistavarakauppa,2020-05-04 10:05:47.586206896,2020-05-04,2020-05-04,2020-05-04,8.0,-4.73,262.24,0.0,162.0,           ,1.0,1.0,87.0
7868,Harrastukset,2020-05-04 13:24:24.827586206,2020-05-04,2020-05-04,2020-05-04,8.0,-2.15,260.09,0.0,162.0,           ,1.0,1.0,106.0
7869,Ruoka_paivittaistavarakauppa,2020-05-04 17:02:53.793103448,2020-05-04,2020-05-04,2020-05-04,8.0,-11.36,248.73,0.0,162.0,           ,1.0,1.0,138.0
7870,Liikkuminen,2020-05-04 20:21:31.034482758,2020-05-04,2020-05-04,2020-05-04,8.0,-16.49,232.24,0.0,162.0,           ,1.0,1.0,122.0
7871,Ravintolat_kahvilat,2020-05-04 23:50:04.137931034,2020-05-04,2020-05-04,2020-05-04,8.0,-16.66,215.58,0.0,162.0,           ,1.0,1.0,127.0
7872,Ruoka_paivittaistavarakauppa,2020-05-05 06:37:14.482758620,2020-05-05,2020-05-05,2020-05-05,8.0,-5.77,209.81,0.0,162.0,           ,1.0,1.0,131.0
7873,Asuminen,2020-05-05 16:52:57.931034482,2020-05-05,2020-05-05,2020-05-05,8.0,-8.96,200.85,0.0,162.0,           ,1.0,1.0,40.0
7874,Muut,2020-05-06 03:08:41.379310344,2020-05-06,2020-05-06,2020-05-06,8.0,-118.13,82.72,0.0,163.0,           ,1.0,1.0,190.0
7875,Shoppailu,2020-05-06 23:40:08.275862068,2020-05-06,2020-05-06,2020-05-06,8.0,-40.37,42.35,0.0,162.0,           ,1.0,1.0,158.0
7876,Muut,2020-05-07 09:55:51.724137930,2020-05-07,2020-05-07,2020-05-07,8.0,-16.37,25.98,0.0,163.0,           ,1.0,1.0,192.0
7877,Ruoka_paivittaistavarakauppa,2020-05-07 16:43:02.068965516,2020-05-07,2020-05-07,2020-05-07,8.0,-3.41,22.57,0.0,162.0,           ,1.0,1.0,60.0
7878,Liikkuminen,2020-05-07 20:11:35.172413792,2020-05-07,2020-05-11,2020-05-07,8.0,-20.42,2.15,0.0,162.0,           ,1.0,1.0,106.0
7879,Ruoka_paivittaistavarakauppa,2020-05-08 06:27:18.620689654,2020-05-08,2020-05-08,2020-05-08,8.0,-1.4,0.75,0.0,162.0,           ,1.0,1.0,52.0
7880,Ruoka_paivittaistavarakauppa,2020-05-08 13:14:28.965517240,2020-05-08,2020-05-08,2020-05-08,8.0,-12.7,-11.95,0.0,162.0,           ,1.0,1.0,181.0
7881,Luottojen_maksut,2020-05-08 23:30:12.413793102,2020-05-08,2020-05-08,2020-05-08,8.0,-1.37,-13.32,0.0,162.0,           ,1.0,1.0,135.0
7882,Ruoka_paivittaistavarakauppa,2020-05-11 02:58:45.517241378,2020-05-11,2020-05-11,2020-05-11,8.0,-12.49,-25.81,0.0,162.0,           ,1.0,1.0,64.0
7883,Lapset,2020-05-11 06:17:22.758620688,2020-05-11,2020-05-11,2020-05-11,8.0,-39.24,-65.05,0.0,162.0,           ,1.0,1.0,117.0
7884,Luottojen_maksut,2020-05-11 09:45:55.862068964,2020-05-11,2020-05-11,2020-05-11,8.0,-0.36,-65.41,0.0,162.0,           ,1.0,1.0,173.0
7885,Ruoka_paivittaistavarakauppa,2020-05-11 16:33:06.206896550,2020-05-11,2020-05-11,2020-05-11,8.0,-3.49,-68.9,0.0,162.0,           ,1.0,1.0,122.0
7886,Ruoka_paivittaistavarakauppa,2020-05-11 20:01:39.310344826,2020-05-11,2020-05-11,2020-05-11,8.0,-1.15,-70.05,0.0,162.0,           ,1.0,1.0,136.0
7887,Tulot,2020-05-12 02:48:49.655172412,2020-05-12,2020-05-12,2020-05-12,8.0,89.79,19.74,0.0,506.0,           ,1.0,1.0,207.0
7888,Ruoka_paivittaistavarakauppa,2020-05-12 13:04:33.103448274,2020-05-12,2020-05-12,2020-05-12,8.0,-11.49,8.25,0.0,162.0,           ,1.0,1.0,85.0
7889,Ruoka_paivittaistavarakauppa,2020-05-12 23:20:16.551724136,2020-05-12,2020-05-12,2020-05-12,8.0,-2.9,5.35,0.0,162.0,           ,1.0,1.0,57.0
7890,Ruoka_paivittaistavarakauppa,2020-05-13 06:07:26.896551722,2020-05-13,2020-05-13,2020-05-13,8.0,-2.96,2.39,0.0,162.0,           ,1.0,1.0,128.0
7891,Ruoka_paivittaistavarakauppa,2020-05-13 19:51:43.448275860,2020-05-13,2020-05-13,2020-05-13,8.0,-11.2,-8.81,0.0,162.0,           ,1.0,1.0,40.0
7892,Luokittelemattomat,2020-05-14 16:23:10.344827584,2020-05-14,2020-05-14,2020-05-14,8.0,-18.84,-27.65,0.0,162.0,           ,1.0,1.0,91.0
7893,Tulot,2020-05-15 02:38:53.793103446,2020-05-15,2020-05-15,2020-05-15,8.0,114.14,86.49,0.0,506.0,           ,1.0,1.0,207.0
7894,Tulot,2020-05-15 09:26:04.137931032,2020-05-15,2020-05-15,2020-05-15,8.0,153.51,240.0,0.0,506.0,           ,1.0,1.0,207.0
7895,Muut,2020-05-15 09:35:59.999999998,2020-05-15,2020-05-15,2020-05-15,8.0,-45.59,194.41,0.0,163.0,           ,1.0,1.0,192.0
7896,Muut,2020-05-15 12:54:37.241379308,2020-05-15,2020-05-15,2020-05-15,8.0,-0.18,194.23,0.0,103.0,           ,0.0,1.0,1.0
7897,Luottojen_maksut,2020-05-15 19:41:47.586206894,2020-05-15,2020-05-15,2020-05-15,8.0,-97.23,97.0,0.0,106.0,NDEAFIHH   ,0.0,0.0,13.0
7898,Luokittelemattomat,2020-05-15 23:10:20.689655170,2020-05-15,2020-05-15,2020-05-15,8.0,-10.91,86.09,0.0,106.0,NDEAFIHH   ,0.0,0.0,27.0
7899,Muut,2020-05-16 16:13:14.482758618,2020-05-16,2020-05-16,2020-05-16,8.0,-42.66,43.43,0.0,163.0,           ,1.0,1.0,191.0
7900,Hyvinvointi,2020-05-17 05:57:31.034482756,2020-05-17,2020-05-17,2020-05-17,8.0,-15.84,27.59,0.0,106.0,OKOYFIHH   ,0.0,0.0,14.0
7901,Muut,2020-05-18 02:28:57.931034480,2020-05-18,2020-05-18,2020-05-18,8.0,-47.92,-20.33,0.0,163.0,           ,1.0,1.0,191.0
7902,Kulttuuri_viihde,2020-05-18 12:44:41.379310342,2020-05-18,2020-05-18,2020-05-18,8.0,-0.46,-20.79,0.0,162.0,           ,1.0,1.0,138.0
7903,Ruoka_paivittaistavarakauppa,2020-05-18 23:00:24.827586204,2020-05-18,2020-05-18,2020-05-18,8.0,-8.22,-29.01,0.0,162.0,           ,1.0,1.0,111.0
7904,Ruoka_paivittaistavarakauppa,2020-05-19 09:16:08.275862066,2020-05-19,2020-05-19,2020-05-19,8.0,-3.28,-32.29,0.0,162.0,           ,1.0,1.0,179.0
7905,Ruoka_paivittaistavarakauppa,2020-05-19 19:31:51.724137928,2020-05-19,2020-05-19,2020-05-19,8.0,-3.74,-36.03,0.0,162.0,           ,1.0,1.0,115.0
7906,Ravintolat_kahvilat,2020-05-20 09:06:12.413793100,2020-05-20,2020-05-20,2020-05-20,8.0,-0.45,-36.48,0.0,162.0,           ,1.0,1.0,146.0
7907,Ruoka_paivittaistavarakauppa,2020-05-20 12:34:45.517241376,2020-05-20,2020-05-20,2020-05-20,8.0,-4.88,-41.36,0.0,162.0,           ,1.0,1.0,113.0
7908,Lemmikit,2020-05-21 05:47:35.172413790,2020-05-21,2020-05-21,2020-05-21,8.0,-4.35,-45.71,0.0,162.0,           ,1.0,1.0,106.0
7909,Ruoka_paivittaistavarakauppa,2020-05-21 22:50:28.965517238,2020-05-21,2020-05-21,2020-05-21,8.0,-24.56,-70.27,0.0,162.0,           ,1.0,1.0,171.0
7910,Ruoka_paivittaistavarakauppa,2020-05-22 05:37:39.310344824,2020-05-22,2020-05-22,2020-05-22,8.0,-5.74,-76.01,0.0,162.0,           ,1.0,1.0,85.0
7911,Liikkuminen,2020-05-22 15:53:22.758620686,2020-05-22,2020-05-22,2020-05-22,8.0,-86.59,-162.6,0.0,129.0,OKOYFIHH   ,0.0,0.0,32.0
7912,Liikkuminen,2020-05-22 16:03:18.620689652,2020-05-22,2020-05-22,2020-05-22,8.0,-19.16,-181.76,0.0,162.0,           ,1.0,1.0,106.0
7913,Ruoka_paivittaistavarakauppa,2020-05-22 19:21:55.862068962,2020-05-22,2020-05-22,2020-05-22,8.0,-7.45,-189.21,0.0,162.0,           ,1.0,1.0,134.0
7914,Muut,2020-05-24 02:19:02.068965514,2020-05-24,2020-05-24,2020-05-24,8.0,-11.02,-200.23,0.0,163.0,           ,1.0,1.0,190.0
7915,Matkailu,2020-05-24 08:56:16.551724134,2020-05-24,2020-05-24,2020-05-24,8.0,-7.7,-207.93,0.0,106.0,NDEAFIHH   ,0.0,0.0,10.0
7916,Asuminen,2020-05-25 02:09:06.206896548,2020-05-25,2020-05-25,2020-05-25,8.0,-15.89,-223.82,0.0,129.0,OKOYFIHH   ,0.0,0.0,31.0
7917,Ravintolat_kahvilat,2020-05-25 12:24:49.655172410,2020-05-25,2020-05-25,2020-05-25,8.0,-1.15,-224.97,0.0,103.0,           ,1.0,1.0,1.0
7918,Ruoka_paivittaistavarakauppa,2020-05-25 19:11:59.999999996,2020-05-25,2020-05-25,2020-05-25,8.0,-0.67,-225.64,0.0,162.0,           ,1.0,1.0,128.0
7919,Asuminen,2020-05-25 22:40:33.103448272,2020-05-25,2020-05-25,2020-05-25,8.0,-33.35,-258.99,0.0,106.0,NDEAFIHH   ,0.0,0.0,26.0
7920,Harrastukset,2020-05-26 05:27:43.448275858,2020-05-26,2020-05-26,2020-05-26,8.0,-10.67,-269.66,0.0,162.0,           ,1.0,1.0,107.0
7921,Ruoka_paivittaistavarakauppa,2020-05-26 15:43:26.896551720,2020-05-26,2020-05-26,2020-05-26,8.0,-0.93,-270.59,0.0,162.0,           ,1.0,1.0,103.0
7922,Ravintolat_kahvilat,2020-05-27 01:59:10.344827582,2020-05-27,2020-05-27,2020-05-27,8.0,-5.65,-276.24,0.0,162.0,           ,1.0,1.0,39.0
7923,Lemmikit,2020-05-27 12:14:53.793103444,2020-05-27,2020-05-27,2020-05-27,8.0,-1.92,-278.16,0.0,162.0,           ,1.0,1.0,160.0
7924,Shoppailu,2020-05-27 19:02:04.137931030,2020-05-27,2020-05-27,2020-05-27,8.0,-15.92,-294.08,0.0,162.0,           ,1.0,1.0,115.0
7925,Saastot_sijoitukset,2020-05-27 22:30:37.241379306,2020-05-27,2020-05-27,2020-05-26,8.0,-11.42,-305.5,0.0,162.0,           ,1.0,1.0,103.0
7926,Matkailu,2020-05-28 15:33:31.034482754,2020-05-28,2020-05-28,2020-05-28,8.0,-8.44,-313.94,0.0,162.0,           ,1.0,1.0,151.0
7927,Saastot_sijoitukset,2020-05-29 01:49:14.482758616,2020-05-29,2020-05-29,2020-05-29,8.0,-4.21,-318.15,0.0,162.0,           ,1.0,1.0,119.0
7928,Ruoka_paivittaistavarakauppa,2020-05-29 05:17:47.586206892,2020-05-29,2020-05-29,2020-05-29,8.0,-2.73,-320.88,0.0,162.0,           ,1.0,1.0,75.0
7929,Ruoka_paivittaistavarakauppa,2020-05-29 08:36:24.827586202,2020-05-29,2020-05-29,2020-05-29,8.0,-29.78,-350.66,0.0,162.0,           ,1.0,1.0,106.0
7930,Ruoka_paivittaistavarakauppa,2020-05-29 08:46:20.689655168,2020-05-29,2020-05-29,2020-05-29,8.0,-1.54,-352.2,0.0,162.0,           ,1.0,1.0,99.0
7931,Ruoka_paivittaistavarakauppa,2020-05-29 12:04:57.931034478,2020-05-29,2020-05-29,2020-05-29,8.0,-70.48,-422.68,0.0,162.0,           ,1.0,1.0,108.0
7932,Luottojen_maksut,2020-05-29 18:52:08.275862064,2020-05-29,2020-05-29,2020-05-28,8.0,-9.75,-432.43,0.0,162.0,           ,1.0,1.0,134.0
7933,Liikkuminen,2020-05-29 22:20:41.379310340,2020-05-29,2020-05-29,2020-05-29,8.0,-1.94,-434.37,0.0,162.0,           ,1.0,1.0,39.0
7934,Hyvinvointijakauneus,2020-06-01 09:47:45.306122448,2020-06-01,2020-06-01,2020-06-01,8.0,-8.44,-442.81,0.0,162.0,           ,1.0,1.0,40.0
7935,Ruoka_paivittaistavarakauppa,2020-06-01 19:35:30.612244896,2020-06-01,2020-06-01,2020-06-01,8.0,-0.37,-443.18,0.0,162.0,           ,1.0,1.0,113.0
7936,Lapset,2020-06-02 05:23:15.918367344,2020-06-02,2020-06-03,2020-06-02,8.0,-3.64,-446.82,0.0,162.0,           ,1.0,1.0,118.0
7937,Muut,2020-06-02 15:11:01.224489792,2020-06-02,2020-06-02,2020-06-02,8.0,-10.94,-457.76,0.0,163.0,           ,1.0,1.0,190.0
7938,Ruoka_paivittaistavarakauppa,2020-06-03 00:58:46.530612240,2020-06-03,2020-06-03,2020-06-03,8.0,-19.86,-477.62,0.0,162.0,           ,1.0,1.0,179.0
7939,Ruoka_paivittaistavarakauppa,2020-06-03 10:46:31.836734688,2020-06-03,2020-06-03,2020-06-03,8.0,-1.14,-478.76,0.0,162.0,           ,1.0,1.0,163.0
7940,Ruoka_paivittaistavarakauppa,2020-06-03 20:34:17.142857136,2020-06-03,2020-06-03,2020-06-03,8.0,-0.92,-479.68,0.0,162.0,           ,1.0,1.0,97.0
7941,Muut,2020-06-04 06:22:02.448979584,2020-06-04,2020-06-04,2020-06-04,8.0,-18.88,-498.56,0.0,162.0,           ,1.0,1.0,103.0
7942,Ruoka_paivittaistavarakauppa,2020-06-04 16:09:47.755102032,2020-06-04,2020-06-04,2020-06-04,8.0,-7.49,-506.05,0.0,162.0,           ,1.0,1.0,135.0
7943,Ruoka_paivittaistavarakauppa,2020-06-05 01:57:33.061224480,2020-06-05,2020-06-05,2020-06-05,8.0,-8.25,-514.3,0.0,162.0,           ,1.0,1.0,57.0
7944,Luokittelemattomat,2020-06-05 07:20:48.979591824,2020-06-05,2020-06-05,2020-06-05,8.0,-17.64,-531.94,0.0,162.0,           ,1.0,1.0,129.0
7945,Muut,2020-06-05 11:45:18.367346928,2020-06-05,2020-06-08,2020-06-05,8.0,-13.69,-545.63,0.0,163.0,           ,1.0,1.0,191.0
7946,Ruoka_paivittaistavarakauppa,2020-06-05 17:08:34.285714272,2020-06-05,2020-06-05,2020-06-05,8.0,-1.21,-546.84,0.0,162.0,           ,1.0,1.0,179.0
7947,Ruoka_paivittaistavarakauppa,2020-06-05 21:33:03.673469376,2020-06-05,2020-06-05,2020-06-05,8.0,-0.89,-547.73,0.0,162.0,           ,1.0,1.0,114.0
7948,Ruoka_paivittaistavarakauppa,2020-06-08 02:56:19.591836720,2020-06-08,2020-06-08,2020-06-08,8.0,-2.07,-549.8,0.0,162.0,           ,1.0,1.0,134.0
7949,Muut,2020-06-08 08:19:35.510204064,2020-06-08,2020-06-08,2020-06-08,8.0,-21.97,-571.77,0.0,163.0,           ,1.0,1.0,193.0
7950,Ruoka_paivittaistavarakauppa,2020-06-08 12:44:04.897959168,2020-06-08,2020-06-08,2020-06-08,8.0,-7.21,-578.98,0.0,162.0,           ,1.0,1.0,119.0
7951,Ruoka_paivittaistavarakauppa,2020-06-08 18:07:20.816326512,2020-06-08,2020-06-08,2020-06-08,8.0,-1.0,-579.98,0.0,162.0,           ,1.0,1.0,75.0
7952,Liikkuminen,2020-06-08 19:06:07.346938752,2020-06-08,2020-06-08,2020-06-08,8.0,-2.05,-582.03,0.0,162.0,           ,1.0,1.0,117.0
7953,Ruoka_paivittaistavarakauppa,2020-06-08 22:31:50.204081616,2020-06-08,2020-06-08,2020-06-08,8.0,-2.66,-584.69,0.0,162.0,           ,1.0,1.0,145.0
7954,Ruoka_paivittaistavarakauppa,2020-06-09 03:55:06.122448960,2020-06-09,2020-06-09,2020-06-09,8.0,-2.09,-586.78,0.0,162.0,           ,1.0,1.0,75.0
7955,Lemmikit,2020-06-09 13:42:51.428571408,2020-06-09,2020-06-09,2020-06-09,8.0,-4.31,-591.09,0.0,162.0,           ,1.0,1.0,39.0
7956,Lapset,2020-06-09 23:30:36.734693856,2020-06-09,2020-06-09,2020-06-09,8.0,-15.15,-606.24,0.0,162.0,           ,1.0,1.0,128.0
7957,Luottojen_maksut,2020-06-10 09:18:22.040816304,2020-06-10,2020-06-10,2020-06-10,8.0,-23.14,-629.38,706.0,129.0,OKOYFIHH   ,0.0,0.0,239.0
7958,Ruoka_paivittaistavarakauppa,2020-06-11 04:53:52.653061200,2020-06-11,2020-06-11,2020-06-11,8.0,-5.49,-634.87,0.0,162.0,           ,1.0,1.0,179.0
7959,Hyvinvointijakauneus,2020-06-11 14:41:37.959183648,2020-06-11,2020-06-11,2020-06-11,8.0,-5.9,-640.77,0.0,162.0,           ,1.0,1.0,157.0
7960,Ravintolat_kahvilat,2020-06-12 00:29:23.265306096,2020-06-12,2020-06-12,2020-06-12,8.0,-3.5,-644.27,0.0,162.0,           ,1.0,1.0,75.0
7961,Liikkuminen,2020-06-12 05:52:39.183673440,2020-06-12,2020-06-12,2020-06-12,8.0,-4.06,-648.33,0.0,162.0,           ,1.0,1.0,106.0
7962,Ruoka_paivittaistavarakauppa,2020-06-12 10:17:08.571428544,2020-06-12,2020-06-12,2020-06-12,8.0,-4.27,-652.6,0.0,162.0,           ,1.0,1.0,180.0
7963,Ravintolat_kahvilat,2020-06-12 15:40:24.489795888,2020-06-12,2020-06-12,2020-06-12,8.0,-7.29,-659.89,0.0,162.0,           ,1.0,1.0,152.0
7964,Muut,2020-06-12 20:04:53.877550992,2020-06-12,2020-06-12,2020-06-12,8.0,-33.63,-693.52,0.0,163.0,           ,1.0,1.0,191.0
7965,Muut,2020-06-15 01:28:09.795918336,2020-06-15,2020-06-15,2020-06-15,8.0,-3.74,-697.26,0.0,162.0,           ,1.0,1.0,157.0
7966,Liikkuminen,2020-06-15 06:51:25.714285680,2020-06-15,2020-06-15,2020-06-15,8.0,-5.21,-702.47,0.0,162.0,           ,1.0,1.0,59.0
7967,Luokittelemattomat,2020-06-15 11:15:55.102040784,2020-06-15,2020-06-15,2020-06-15,8.0,-2.33,-704.8,0.0,162.0,           ,1.0,1.0,168.0
7968,Shoppailu,2020-06-15 16:39:11.020408128,2020-06-15,2020-06-15,2020-06-15,8.0,-4.21,-709.01,0.0,162.0,           ,1.0,1.0,152.0
7969,Liikkuminen,2020-06-15 21:03:40.408163232,2020-06-15,2020-06-17,2020-06-15,8.0,-6.26,-715.27,0.0,162.0,           ,1.0,1.0,123.0
7970,Ruoka_paivittaistavarakauppa,2020-06-16 02:26:56.326530576,2020-06-16,2020-06-16,2020-06-16,8.0,-2.51,-717.78,0.0,162.0,           ,1.0,1.0,179.0
7971,Shoppailu,2020-06-16 12:14:41.632653024,2020-06-16,2020-06-16,2020-06-16,8.0,-18.62,-736.4,0.0,162.0,           ,1.0,1.0,119.0
7972,Ruoka_paivittaistavarakauppa,2020-06-16 22:02:26.938775472,2020-06-16,2020-06-16,2020-06-16,8.0,-9.09,-745.49,0.0,162.0,           ,1.0,1.0,97.0
7973,Kulttuuri_viihde,2020-06-17 17:37:57.551020368,2020-06-17,2020-06-17,2020-06-17,8.0,-8.67,-754.16,0.0,162.0,           ,1.0,1.0,138.0
7974,Kulttuuri_viihde,2020-06-18 03:25:42.857142816,2020-06-18,2020-06-19,2020-06-18,8.0,-5.72,-759.88,0.0,162.0,           ,1.0,1.0,169.0
7975,Ruoka_paivittaistavarakauppa,2020-06-18 07:50:12.244897920,2020-06-18,2020-06-18,2020-06-18,8.0,-5.67,-765.55,0.0,162.0,           ,1.0,1.0,113.0
7976,Ruoka_paivittaistavarakauppa,2020-06-18 13:13:28.163265264,2020-06-18,2020-06-18,2020-06-18,8.0,-1.9,-767.45,0.0,162.0,           ,1.0,1.0,155.0
7977,Ravintolat_kahvilat,2020-06-18 23:01:13.469387712,2020-06-18,2020-06-18,2020-06-18,8.0,-10.35,-777.8,0.0,162.0,           ,1.0,1.0,52.0
7978,Ruoka_paivittaistavarakauppa,2020-06-19 08:48:58.775510160,2020-06-19,2020-06-19,2020-06-19,8.0,-2.72,-780.52,0.0,162.0,           ,1.0,1.0,40.0
7979,Ruoka_paivittaistavarakauppa,2020-06-19 14:12:14.693877504,2020-06-19,2020-06-19,2020-06-19,8.0,-11.96,-792.48,0.0,162.0,           ,1.0,1.0,146.0
7980,Liikkuminen,2020-06-19 18:36:44.081632608,2020-06-19,2020-06-19,2020-06-19,8.0,-0.84,-793.32,0.0,162.0,           ,1.0,1.0,39.0
7981,Ruoka_paivittaistavarakauppa,2020-06-22 04:24:29.387755056,2020-06-22,2020-06-22,2020-06-22,8.0,-2.98,-796.3,0.0,162.0,           ,1.0,1.0,52.0
7982,Lapset,2020-06-22 05:23:15.918367296,2020-06-22,2020-06-22,2020-06-22,8.0,-7.45,-803.75,0.0,162.0,           ,1.0,1.0,97.0
7983,Liikkuminen,2020-06-22 09:47:45.306122400,2020-06-22,2020-06-22,2020-06-22,8.0,-101.7,-905.45,0.0,162.0,           ,1.0,1.0,115.0
7984,Muut,2020-06-22 15:11:01.224489744,2020-06-22,2020-06-22,2020-06-22,8.0,-4.49,-909.94,0.0,162.0,           ,1.0,1.0,114.0
7985,Ruoka_paivittaistavarakauppa,2020-06-22 19:35:30.612244848,2020-06-22,2020-06-22,2020-06-22,8.0,-18.09,-928.03,0.0,162.0,           ,1.0,1.0,150.0
7986,Tulot,2020-06-22 23:59:59.999999952,2020-06-22,2020-06-22,2020-06-22,8.0,-5.38,-933.41,0.0,162.0,           ,1.0,1.0,83.0
7987,Kulttuuri_viihde,2020-06-23 00:58:46.530612192,2020-06-23,2020-06-23,2020-06-23,8.0,-13.23,-946.64,0.0,162.0,           ,1.0,1.0,75.0
7988,Ruoka_paivittaistavarakauppa,2020-06-23 06:22:02.448979536,2020-06-23,2020-06-23,2020-06-23,8.0,-6.54,-953.18,0.0,162.0,           ,1.0,1.0,112.0
7989,Lemmikit,2020-06-23 10:46:31.836734640,2020-06-23,2020-06-23,2020-06-23,8.0,-8.01,-961.19,0.0,162.0,           ,1.0,1.0,146.0
7990,Muut,2020-06-23 20:34:17.142857088,2020-06-23,2020-06-24,2020-06-23,8.0,-84.67,-1045.86,0.0,162.0,           ,1.0,1.0,123.0
7991,Ruoka_paivittaistavarakauppa,2020-06-25 01:57:33.061224432,2020-06-25,2020-06-25,2020-06-25,8.0,-10.22,-1056.08,0.0,162.0,           ,1.0,1.0,178.0
7992,Lemmikit,2020-06-25 07:20:48.979591776,2020-06-25,2020-06-25,2020-06-25,8.0,-3.48,-1059.56,0.0,162.0,           ,1.0,1.0,88.0
7993,Ruoka_paivittaistavarakauppa,2020-06-25 16:09:47.755101984,2020-06-25,2020-06-25,2020-06-23,8.0,-9.57,-1069.13,0.0,162.0,           ,1.0,1.0,129.0
7994,Liikkuminen,2020-06-25 21:33:03.673469328,2020-06-25,2020-06-25,2020-06-25,8.0,-23.81,-1092.94,0.0,162.0,           ,1.0,1.0,135.0
7995,Muut,2020-06-26 02:56:19.591836672,2020-06-26,2020-06-26,2020-06-26,8.0,-0.37,-1093.31,0.0,162.0,           ,1.0,1.0,40.0
7996,Ruoka_paivittaistavarakauppa,2020-06-26 11:45:18.367346880,2020-06-26,2020-06-26,2020-06-26,8.0,-1.02,-1094.33,0.0,162.0,           ,1.0,1.0,116.0
7997,Ruoka_paivittaistavarakauppa,2020-06-26 17:08:34.285714224,2020-06-26,2020-06-26,2020-06-26,8.0,-1.67,-1096.0,0.0,162.0,           ,1.0,1.0,167.0
7998,Ruoka_paivittaistavarakauppa,2020-06-26 22:31:50.204081568,2020-06-26,2020-06-26,2020-06-26,8.0,-8.04,-1104.04,0.0,162.0,           ,1.0,1.0,128.0
7999,Ruoka_paivittaistavarakauppa,2020-06-29 03:55:06.122448912,2020-06-29,2020-07-01,2020-06-29,8.0,-1.87,-1105.91,0.0,162.0,           ,1.0,1.0,68.0
8000,Lapset,2020-06-29 08:19:35.510204016,2020-06-29,2020-06-30,2020-06-29,8.0,-6.18,-1112.09,0.0,162.0,           ,1.0,1.0,182.0
8001,Ravintolat_kahvilat,2020-06-29 09:18:22.040816256,2020-06-29,2020-06-29,2020-06-29,8.0,-6.62,-1118.71,0.0,162.0,           ,1.0,1.0,113.0
8002,Ruoka_paivittaistavarakauppa,2020-06-29 12:44:04.897959120,2020-06-29,2020-06-29,2020-06-29,8.0,-30.55,-1149.26,0.0,162.0,           ,1.0,1.0,140.0
8003,Ravintolat_kahvilat,2020-06-29 13:42:51.428571360,2020-06-29,2020-06-29,2020-06-29,8.0,-3.73,-1152.99,0.0,162.0,           ,1.0,1.0,163.0
8004,Ruoka_paivittaistavarakauppa,2020-06-29 18:07:20.816326464,2020-06-29,2020-06-29,2020-06-29,8.0,-27.07,-1180.06,0.0,162.0,           ,1.0,1.0,109.0
8005,Ruoka_paivittaistavarakauppa,2020-06-29 19:06:07.346938704,2020-06-29,2020-06-29,2020-06-29,8.0,-0.69,-1180.75,0.0,162.0,           ,1.0,1.0,103.0
8006,Ruoka_paivittaistavarakauppa,2020-06-29 23:30:36.734693808,2020-06-29,2020-06-29,2020-06-29,8.0,-3.34,-1184.09,0.0,162.0,           ,1.0,1.0,169.0
8007,Ruoka_paivittaistavarakauppa,2020-07-01 23:48:28.800000000,2020-07-01,2020-07-01,2020-07-01,8.0,-5.12,-1189.21,0.0,162.0,           ,1.0,1.0,107.0
8008,Muut,2020-07-02 11:42:43.200000000,2020-07-02,2020-07-02,2020-07-02,8.0,-0.75,-1189.96,0.0,162.0,           ,1.0,1.0,146.0
8009,Liikkuminen,2020-07-02 23:36:57.600000000,2020-07-02,2020-07-02,2020-07-02,8.0,-8.54,-1198.5,0.0,162.0,           ,1.0,1.0,135.0
8010,Ruoka_paivittaistavarakauppa,2020-07-03 11:31:12.000000000,2020-07-03,2020-07-03,2020-07-03,8.0,-10.83,-1209.33,0.0,162.0,           ,1.0,1.0,68.0
8011,Ruoka_paivittaistavarakauppa,2020-07-03 11:54:14.400000000,2020-07-03,2020-07-03,2020-07-03,8.0,-5.37,-1214.7,0.0,162.0,           ,1.0,1.0,179.0
8012,Lapset,2020-07-03 23:13:55.200000000,2020-07-03,2020-07-03,2020-07-03,8.0,-2.31,-1217.01,0.0,162.0,           ,1.0,1.0,144.0
8013,Kulttuuri_viihde,2020-07-03 23:25:26.400000000,2020-07-03,2020-07-03,2020-07-03,8.0,-5.33,-1222.34,0.0,106.0,OKOYFIHH   ,0.0,0.0,10.0
8014,Kulttuuri_viihde,2020-07-04 11:19:40.800000000,2020-07-04,2020-07-04,2020-07-04,8.0,-13.48,-1235.82,0.0,106.0,OKOYFIHH   ,0.0,0.0,10.0
8015,Luokittelemattomat,2020-07-06 10:33:36.000000000,2020-07-06,2020-07-06,2020-07-06,8.0,-7.22,-1243.04,0.0,162.0,           ,1.0,1.0,127.0
8016,Ruoka_paivittaistavarakauppa,2020-07-06 10:56:38.400000000,2020-07-06,2020-07-06,2020-07-06,8.0,-2.0,-1245.04,0.0,162.0,           ,1.0,1.0,129.0
8017,Ravintolat_kahvilat,2020-07-06 11:08:09.600000000,2020-07-06,2020-07-09,2020-07-06,8.0,-1.6,-1246.64,0.0,162.0,           ,1.0,1.0,174.0
8018,Ruoka_paivittaistavarakauppa,2020-07-06 22:50:52.800000000,2020-07-06,2020-07-06,2020-07-06,8.0,-2.38,-1249.02,0.0,162.0,           ,1.0,1.0,126.0
8019,Shoppailu,2020-07-06 23:02:24.000000000,2020-07-06,2020-07-06,2020-07-06,8.0,-2.96,-1251.98,0.0,162.0,           ,1.0,1.0,108.0
8020,Ruoka_paivittaistavarakauppa,2020-07-07 10:45:07.200000000,2020-07-07,2020-07-07,2020-07-07,8.0,-3.69,-1255.67,0.0,162.0,           ,1.0,1.0,187.0
8021,Muut,2020-07-07 22:39:21.600000000,2020-07-07,2020-07-07,2020-07-07,8.0,-24.32,-1279.99,0.0,163.0,           ,1.0,1.0,190.0
8022,Ruoka_paivittaistavarakauppa,2020-07-08 22:27:50.400000000,2020-07-08,2020-07-08,2020-07-08,8.0,-12.72,-1292.71,0.0,162.0,           ,1.0,1.0,179.0
8023,Ruoka_paivittaistavarakauppa,2020-07-09 10:22:04.800000000,2020-07-09,2020-07-09,2020-07-09,8.0,-5.19,-1297.9,0.0,162.0,           ,1.0,1.0,176.0
8024,Hyvinvointijakauneus,2020-07-09 22:16:19.200000000,2020-07-09,2020-07-09,2020-07-09,8.0,-2.88,-1300.78,0.0,162.0,           ,1.0,1.0,97.0
8025,Ruoka_paivittaistavarakauppa,2020-07-10 10:10:33.600000000,2020-07-10,2020-07-10,2020-07-10,8.0,-4.87,-1305.65,0.0,162.0,           ,1.0,1.0,127.0
8026,Lapset,2020-07-10 21:41:45.600000000,2020-07-10,2020-07-10,2020-07-10,8.0,-2.0,-1307.65,0.0,162.0,           ,1.0,1.0,152.0
8027,Ruoka_paivittaistavarakauppa,2020-07-10 21:53:16.800000000,2020-07-10,2020-07-10,2020-07-10,8.0,-12.17,-1319.82,0.0,162.0,           ,1.0,1.0,162.0
8028,Hyvinvointijakauneus,2020-07-10 22:04:48.000000000,2020-07-10,2020-07-10,2020-07-10,8.0,-4.06,-1323.88,0.0,162.0,           ,1.0,1.0,133.0
8029,Muut,2020-07-11 09:47:31.200000000,2020-07-11,2020-07-11,2020-07-11,8.0,-13.38,-1337.26,0.0,163.0,           ,1.0,1.0,192.0
8030,Ruoka_paivittaistavarakauppa,2020-07-13 09:24:28.800000000,2020-07-13,2020-07-13,2020-07-13,8.0,-1.09,-1338.35,0.0,162.0,           ,1.0,1.0,50.0
8031,Ravintolat_kahvilat,2020-07-13 09:36:00.000000000,2020-07-13,2020-07-13,2020-07-13,8.0,-7.28,-1345.63,0.0,162.0,           ,1.0,1.0,124.0
8032,Ruoka_paivittaistavarakauppa,2020-07-13 09:59:02.400000000,2020-07-13,2020-07-13,2020-07-13,8.0,-12.33,-1357.96,0.0,162.0,           ,1.0,1.0,101.0
8033,Ruoka_paivittaistavarakauppa,2020-07-13 21:30:14.400000000,2020-07-13,2020-07-13,2020-07-13,8.0,-6.14,-1364.1,0.0,162.0,           ,1.0,1.0,133.0
8034,Hyvinvointi,2020-07-15 09:01:26.400000000,2020-07-15,2020-07-15,2020-07-15,8.0,-2.88,-1366.98,0.0,162.0,           ,1.0,1.0,184.0
8035,Ruoka_paivittaistavarakauppa,2020-07-15 21:07:12.000000000,2020-07-15,2020-07-15,2020-07-15,8.0,-5.4,-1372.38,0.0,162.0,           ,1.0,1.0,138.0
8036,Hyvinvointijakauneus,2020-07-16 09:12:57.600000000,2020-07-16,2020-07-16,2020-07-16,8.0,-5.96,-1378.34,0.0,162.0,           ,1.0,1.0,78.0
8037,Ruoka_paivittaistavarakauppa,2020-07-16 20:44:09.600000000,2020-07-16,2020-07-16,2020-07-16,8.0,-2.29,-1380.63,0.0,162.0,           ,1.0,1.0,157.0
8038,Muut,2020-07-16 20:55:40.800000000,2020-07-16,2020-07-16,2020-07-16,8.0,-1.73,-1382.36,0.0,162.0,           ,1.0,1.0,163.0
8039,Ruoka_paivittaistavarakauppa,2020-07-16 21:18:43.200000000,2020-07-16,2020-07-16,2020-07-16,8.0,-5.63,-1387.99,0.0,162.0,           ,1.0,1.0,120.0
8040,Liikkuminen,2020-07-17 08:38:24.000000000,2020-07-17,2020-07-17,2020-07-17,8.0,-11.81,-1399.8,0.0,162.0,           ,1.0,1.0,75.0
8041,Ravintolat_kahvilat,2020-07-17 08:49:55.200000000,2020-07-17,2020-07-17,2020-07-17,8.0,-1.53,-1401.33,0.0,162.0,           ,1.0,1.0,159.0
8042,Hyvinvointijakauneus,2020-07-17 20:32:38.400000000,2020-07-17,2020-07-17,2020-07-17,8.0,-16.68,-1418.01,0.0,162.0,           ,1.0,1.0,131.0
8043,Hyvinvointi,2020-07-20 08:03:50.400000000,2020-07-20,2020-07-20,2020-07-20,8.0,-30.67,-1448.68,0.0,162.0,           ,1.0,1.0,52.0
8044,Ruoka_paivittaistavarakauppa,2020-07-20 08:15:21.600000000,2020-07-20,2020-07-20,2020-07-20,8.0,-10.94,-1459.62,0.0,162.0,           ,1.0,1.0,126.0
8045,Ruoka_paivittaistavarakauppa,2020-07-20 08:26:52.800000000,2020-07-20,2020-07-20,2020-07-20,8.0,-3.5,-1463.12,0.0,162.0,           ,1.0,1.0,46.0
8046,Ruoka_paivittaistavarakauppa,2020-07-20 19:58:04.800000000,2020-07-20,2020-07-20,2020-07-20,8.0,-7.68,-1470.8,0.0,162.0,           ,1.0,1.0,49.0
8047,Ruoka_paivittaistavarakauppa,2020-07-20 20:09:36.000000000,2020-07-20,2020-07-20,2020-07-20,8.0,-33.34,-1504.14,0.0,162.0,           ,1.0,1.0,119.0
8048,Ruoka_paivittaistavarakauppa,2020-07-21 20:21:07.200000000,2020-07-21,2020-07-21,2020-07-21,8.0,-6.19,-1510.33,0.0,162.0,           ,1.0,1.0,108.0
8049,Ravintolat_kahvilat,2020-07-22 07:40:48.000000000,2020-07-22,2020-07-22,2020-07-22,8.0,-0.12,-1510.45,0.0,162.0,           ,1.0,1.0,135.0
8050,Kulttuuri_viihde,2020-07-22 07:52:19.200000000,2020-07-22,2020-07-22,2020-07-22,8.0,-221.15,-1731.6,0.0,106.0,DABAFIHH   ,0.0,0.0,25.0
8051,Luottojen_maksut,2020-07-22 19:46:33.600000000,2020-07-22,2020-07-22,2020-07-22,8.0,-50.97,-1782.57,0.0,106.0,OKOYFIHH   ,0.0,0.0,25.0
8052,Ruoka_paivittaistavarakauppa,2020-07-23 07:29:16.800000000,2020-07-23,2020-07-23,2020-07-23,8.0,-18.14,-1800.71,0.0,162.0,           ,1.0,1.0,163.0
8053,Ruoka_paivittaistavarakauppa,2020-07-23 19:23:31.200000000,2020-07-23,2020-07-23,2020-07-23,8.0,-5.98,-1806.69,0.0,162.0,           ,1.0,1.0,149.0
8054,Ruoka_paivittaistavarakauppa,2020-07-23 19:35:02.400000000,2020-07-23,2020-07-23,2020-07-23,8.0,-1.95,-1808.64,0.0,162.0,           ,1.0,1.0,102.0
8055,Ruoka_paivittaistavarakauppa,2020-07-24 07:17:45.600000000,2020-07-24,2020-07-24,2020-07-24,8.0,-15.69,-1824.33,0.0,162.0,           ,1.0,1.0,105.0
8056,Ruoka_paivittaistavarakauppa,2020-07-27 06:54:43.200000000,2020-07-27,2020-07-27,2020-07-27,8.0,-3.44,-1827.77,0.0,162.0,           ,1.0,1.0,157.0
8057,Ruoka_paivittaistavarakauppa,2020-07-27 07:06:14.400000000,2020-07-27,2020-07-27,2020-07-27,8.0,-13.17,-1840.94,0.0,162.0,           ,1.0,1.0,124.0
8058,Liikkuminen,2020-07-27 18:37:26.400000000,2020-07-27,2020-07-27,2020-07-27,8.0,-19.23,-1860.17,0.0,162.0,           ,1.0,1.0,179.0
8059,Ruoka_paivittaistavarakauppa,2020-07-27 18:48:57.600000000,2020-07-27,2020-07-27,2020-07-27,8.0,-6.33,-1866.5,0.0,162.0,           ,1.0,1.0,183.0
8060,Ruoka_paivittaistavarakauppa,2020-07-27 19:00:28.800000000,2020-07-27,2020-07-27,2020-07-27,8.0,-12.63,-1879.13,0.0,162.0,           ,1.0,1.0,168.0
8061,Ruoka_paivittaistavarakauppa,2020-07-27 19:12:00.000000000,2020-07-27,2020-07-27,2020-07-27,8.0,-0.71,-1879.84,0.0,162.0,           ,1.0,1.0,105.0
8062,Ruoka_paivittaistavarakauppa,2020-07-28 06:43:12.000000000,2020-07-28,2020-07-28,2020-07-28,8.0,-0.19,-1880.03,0.0,162.0,           ,1.0,1.0,146.0
8063,Ruoka_paivittaistavarakauppa,2020-07-29 06:31:40.800000000,2020-07-29,2020-07-29,2020-07-29,8.0,-7.54,-1887.57,0.0,162.0,           ,1.0,1.0,144.0
8064,Lemmikit,2020-07-29 18:25:55.200000000,2020-07-29,2020-07-29,2020-07-29,8.0,-26.38,-1913.95,0.0,162.0,           ,1.0,1.0,137.0
8065,Hyvinvointijakauneus,2020-07-30 06:08:38.400000000,2020-07-30,2020-07-30,2020-07-30,8.0,-7.22,-1921.17,0.0,162.0,           ,1.0,1.0,140.0
8066,Lemmikit,2020-07-30 18:02:52.800000000,2020-07-30,2020-07-30,2020-07-30,8.0,-4.4,-1925.57,0.0,162.0,           ,1.0,1.0,69.0
8067,Ruoka_paivittaistavarakauppa,2020-07-30 18:14:24.000000000,2020-07-30,2020-07-30,2020-07-30,8.0,-4.32,-1929.89,0.0,162.0,           ,1.0,1.0,140.0
8068,Tulot,2020-07-31 06:20:09.600000000,2020-07-31,2020-07-31,2020-07-31,8.0,-4.18,-1934.07,0.0,162.0,           ,1.0,1.0,167.0
8069,Hyvinvointijakauneus,2020-08-03 02:55:55.656108596,2020-08-03,2020-08-03,2020-08-03,8.0,-0.51,-1934.58,0.0,162.0,           ,1.0,1.0,155.0
8070,Lemmikit,2020-08-03 05:51:51.312217192,2020-08-03,2020-08-03,2020-08-03,8.0,-3.15,-1937.73,0.0,162.0,           ,1.0,1.0,126.0
8071,Ruoka_paivittaistavarakauppa,2020-08-03 06:43:58.914027149,2020-08-03,2020-08-03,2020-08-03,8.0,-11.45,-1949.18,0.0,162.0,           ,1.0,1.0,78.0
8072,Luokittelemattomat,2020-08-03 09:39:54.570135745,2020-08-03,2020-08-03,2020-08-03,8.0,-6.06,-1955.24,0.0,162.0,           ,1.0,1.0,137.0
8073,Ruoka_paivittaistavarakauppa,2020-08-03 12:35:50.226244341,2020-08-03,2020-08-03,2020-08-03,8.0,-7.19,-1962.43,0.0,162.0,           ,1.0,1.0,68.0
8074,Ravintolat_kahvilat,2020-08-03 13:27:57.828054298,2020-08-03,2020-08-03,2020-08-03,8.0,-3.78,-1966.21,0.0,162.0,           ,1.0,1.0,97.0
8075,Ruoka_paivittaistavarakauppa,2020-08-03 16:23:53.484162894,2020-08-03,2020-08-03,2020-08-03,8.0,-6.34,-1972.55,0.0,162.0,           ,1.0,1.0,162.0
8076,Ruoka_paivittaistavarakauppa,2020-08-03 19:19:49.140271490,2020-08-03,2020-08-03,2020-08-03,8.0,-1.04,-1973.59,0.0,162.0,           ,1.0,1.0,125.0
8077,Ruoka_paivittaistavarakauppa,2020-08-03 20:11:56.742081447,2020-08-03,2020-08-03,2020-08-03,8.0,-9.62,-1983.21,0.0,162.0,           ,1.0,1.0,126.0
8078,Hyvinvointi,2020-08-03 23:07:52.398190043,2020-08-03,2020-08-03,2020-08-03,8.0,-17.69,-2000.9,0.0,162.0,           ,1.0,1.0,122.0
8079,Kulttuuri_viihde,2020-08-04 02:03:48.054298639,2020-08-04,2020-08-04,2020-08-04,8.0,-6.16,-2007.06,0.0,162.0,           ,1.0,1.0,78.0
8080,Luottojen_maksut,2020-08-04 08:47:46.968325788,2020-08-04,2020-08-04,2020-08-04,8.0,-14.27,-2021.33,0.0,162.0,           ,1.0,1.0,179.0
8081,Ruoka_paivittaistavarakauppa,2020-08-04 15:31:45.882352937,2020-08-04,2020-08-04,2020-08-04,8.0,-3.19,-2024.52,0.0,162.0,           ,1.0,1.0,64.0
8082,Ruoka_paivittaistavarakauppa,2020-08-04 22:15:44.796380086,2020-08-04,2020-08-04,2020-08-04,8.0,-6.29,-2030.81,0.0,162.0,           ,1.0,1.0,135.0
8083,Ruoka_paivittaistavarakauppa,2020-08-05 01:11:40.452488682,2020-08-05,2020-08-05,2020-08-05,8.0,-18.32,-2049.13,0.0,162.0,           ,1.0,1.0,118.0
8084,Ruoka_paivittaistavarakauppa,2020-08-05 04:59:43.710407235,2020-08-05,2020-08-06,2020-08-05,8.0,-3.36,-2052.49,0.0,162.0,           ,1.0,1.0,52.0
8085,Luokittelemattomat,2020-08-06 07:55:39.366515831,2020-08-06,2020-08-06,2020-08-06,8.0,-11.08,-2063.57,0.0,162.0,           ,1.0,1.0,103.0
8086,Asuminen,2020-08-06 18:27:41.538461533,2020-08-06,2020-08-06,2020-08-06,8.0,-99.26,-2162.83,0.0,162.0,           ,1.0,1.0,68.0
8087,Ruoka_paivittaistavarakauppa,2020-08-06 20:31:29.592760172,2020-08-06,2020-08-06,2020-08-06,8.0,-8.06,-2170.89,0.0,162.0,           ,1.0,1.0,171.0
8088,Ruoka_paivittaistavarakauppa,2020-08-06 21:23:37.194570129,2020-08-06,2020-08-06,2020-08-06,8.0,-6.49,-2177.38,0.0,162.0,           ,1.0,1.0,116.0
8089,Matkailu,2020-08-07 00:19:32.850678725,2020-08-07,2020-08-07,2020-08-07,8.0,-18.77,-2196.15,0.0,162.0,           ,1.0,1.0,129.0
8090,Tulot,2020-08-07 03:15:28.506787321,2020-08-07,2020-08-07,2020-08-07,8.0,2816.18,620.03,701.0,510.0,           ,1.0,1.0,221.0
8091,Ruoka_paivittaistavarakauppa,2020-08-07 04:07:36.108597278,2020-08-07,2020-08-07,2020-08-07,8.0,-4.22,615.81,0.0,162.0,           ,1.0,1.0,39.0
8092,Ravintolat_kahvilat,2020-08-07 10:51:35.022624427,2020-08-07,2020-08-07,2020-08-07,8.0,-7.02,608.79,0.0,162.0,           ,1.0,1.0,39.0
8093,Lemmikit,2020-08-07 11:43:42.624434384,2020-08-07,2020-08-07,2020-08-07,8.0,-32.96,575.83,0.0,162.0,           ,1.0,1.0,139.0
8094,Ruoka_paivittaistavarakauppa,2020-08-07 14:39:38.280542980,2020-08-07,2020-08-07,2020-08-07,8.0,-7.15,568.68,0.0,162.0,           ,1.0,1.0,112.0
8095,Lemmikit,2020-08-07 17:35:33.936651576,2020-08-07,2020-08-07,2020-08-06,8.0,-4.51,564.17,0.0,162.0,           ,1.0,1.0,182.0
8096,Asuminen,2020-08-10 05:19:16.561085960,2020-08-10,2020-08-10,2020-08-10,8.0,-29.75,534.42,0.0,162.0,           ,1.0,1.0,90.0
8097,Hyvinvointi,2020-08-10 06:11:24.162895917,2020-08-10,2020-08-10,2020-08-10,8.0,-275.73,258.69,0.0,162.0,           ,1.0,1.0,125.0
8098,Ruoka_paivittaistavarakauppa,2020-08-10 07:03:31.764705874,2020-08-10,2020-08-10,2020-08-10,8.0,-8.52,250.17,0.0,162.0,           ,1.0,1.0,136.0
8099,Ravintolat_kahvilat,2020-08-10 09:59:27.420814470,2020-08-10,2020-08-10,2020-08-10,8.0,-10.81,239.36,0.0,162.0,           ,1.0,1.0,46.0
8100,Tulot,2020-08-10 12:55:23.076923066,2020-08-10,2020-08-10,2020-08-10,8.0,-49.57,189.79,0.0,162.0,           ,1.0,1.0,161.0
8101,Asuminen,2020-08-10 16:43:26.334841619,2020-08-10,2020-08-10,2020-08-10,8.0,-21.22,168.57,0.0,162.0,           ,1.0,1.0,176.0
8102,Ruoka_paivittaistavarakauppa,2020-08-10 18:47:14.389140258,2020-08-10,2020-08-10,2020-08-10,8.0,-6.07,162.5,0.0,162.0,           ,1.0,1.0,146.0
8103,Ruoka_paivittaistavarakauppa,2020-08-10 19:39:21.990950215,2020-08-10,2020-08-10,2020-08-10,8.0,-9.33,153.17,0.0,162.0,           ,1.0,1.0,115.0
8104,Ruoka_paivittaistavarakauppa,2020-08-10 23:27:25.248868768,2020-08-10,2020-08-10,2020-08-10,8.0,-18.88,134.29,0.0,162.0,           ,1.0,1.0,129.0
8105,Ravintolat_kahvilat,2020-08-11 02:23:20.904977364,2020-08-11,2020-08-13,2020-08-11,8.0,-21.93,112.36,0.0,162.0,           ,1.0,1.0,40.0
8106,Ruoka_paivittaistavarakauppa,2020-08-11 09:07:19.819004513,2020-08-11,2020-08-11,2020-08-11,8.0,-7.13,105.23,0.0,162.0,           ,1.0,1.0,108.0
8107,Ravintolat_kahvilat,2020-08-11 13:47:30.678733023,2020-08-11,2020-08-11,2020-08-11,8.0,-6.11,99.12,0.0,162.0,           ,1.0,1.0,87.0
8108,Ravintolat_kahvilat,2020-08-11 15:51:18.733031662,2020-08-11,2020-08-12,2020-08-11,8.0,-72.01,27.11,0.0,162.0,           ,1.0,1.0,57.0
8109,Liikkuminen,2020-08-11 22:35:17.647058811,2020-08-11,2020-08-11,2020-08-11,8.0,-3.27,23.84,0.0,162.0,           ,1.0,1.0,143.0
8110,Ruoka_paivittaistavarakauppa,2020-08-12 01:31:13.303167407,2020-08-12,2020-08-12,2020-08-12,8.0,-2.32,21.52,0.0,162.0,           ,1.0,1.0,179.0
8111,Ruoka_paivittaistavarakauppa,2020-08-12 12:03:15.475113109,2020-08-12,2020-08-12,2020-08-12,8.0,-41.45,-19.93,0.0,162.0,           ,1.0,1.0,179.0
8112,Ruoka_paivittaistavarakauppa,2020-08-13 08:15:12.217194556,2020-08-13,2020-08-13,2020-08-13,8.0,-19.17,-39.1,0.0,162.0,           ,1.0,1.0,116.0
8113,Ruoka_paivittaistavarakauppa,2020-08-13 11:11:07.873303152,2020-08-13,2020-08-13,2020-08-13,8.0,-0.63,-39.73,0.0,162.0,           ,1.0,1.0,57.0
8114,Ruoka_paivittaistavarakauppa,2020-08-13 14:59:11.131221705,2020-08-13,2020-08-13,2020-08-13,8.0,-2.71,-42.44,0.0,162.0,           ,1.0,1.0,97.0
8115,Hyvinvointi,2020-08-14 00:39:05.701357450,2020-08-14,2020-08-14,2020-08-14,8.0,-0.8,-43.24,0.0,162.0,           ,1.0,1.0,68.0
8116,Lemmikit,2020-08-14 04:27:08.959276003,2020-08-14,2020-08-14,2020-08-14,8.0,-12.99,-56.23,0.0,162.0,           ,1.0,1.0,124.0
8117,Lapset,2020-08-14 10:19:00.271493195,2020-08-14,2020-08-14,2020-08-14,8.0,-4.3,-60.53,0.0,162.0,           ,1.0,1.0,117.0
8118,Liikkuminen,2020-08-14 17:55:06.787330301,2020-08-14,2020-08-14,2020-08-14,8.0,-16.09,-76.62,0.0,162.0,           ,1.0,1.0,121.0
8119,Ruoka_paivittaistavarakauppa,2020-08-14 20:51:02.443438897,2020-08-14,2020-08-14,2020-08-14,8.0,-17.01,-93.63,0.0,162.0,           ,1.0,1.0,127.0
8120,Ruoka_paivittaistavarakauppa,2020-08-14 21:43:10.045248854,2020-08-14,2020-08-14,2020-08-14,8.0,-1.44,-95.07,0.0,162.0,           ,1.0,1.0,112.0
8121,Ruoka_paivittaistavarakauppa,2020-08-17 03:35:01.357466046,2020-08-17,2020-08-17,2020-08-17,8.0,-6.42,-101.49,0.0,162.0,           ,1.0,1.0,121.0
8122,Liikkuminen,2020-08-17 06:30:57.013574642,2020-08-17,2020-08-17,2020-08-17,8.0,-1.18,-102.67,0.0,162.0,           ,1.0,1.0,156.0
8123,Ruoka_paivittaistavarakauppa,2020-08-17 07:23:04.615384599,2020-08-17,2020-08-17,2020-08-17,8.0,-21.88,-124.55,0.0,162.0,           ,1.0,1.0,168.0
8124,Liikkuminen,2020-08-17 13:14:55.927601791,2020-08-17,2020-08-17,2020-08-17,8.0,-9.84,-134.39,0.0,162.0,           ,1.0,1.0,145.0
8125,Ruoka_paivittaistavarakauppa,2020-08-17 14:07:03.529411748,2020-08-17,2020-08-17,2020-08-17,8.0,-10.57,-144.96,0.0,162.0,           ,1.0,1.0,109.0
8126,Ruoka_paivittaistavarakauppa,2020-08-17 17:02:59.185520344,2020-08-17,2020-08-17,2020-08-17,8.0,-15.96,-160.92,0.0,162.0,           ,1.0,1.0,90.0
8127,Hyvinvointijakauneus,2020-08-17 19:58:54.841628940,2020-08-17,2020-08-17,2020-08-17,8.0,-3.86,-164.78,0.0,162.0,           ,1.0,1.0,87.0
8128,Hyvinvointijakauneus,2020-08-17 23:46:58.099547493,2020-08-17,2020-08-17,2020-08-17,8.0,-4.77,-169.55,0.0,162.0,           ,1.0,1.0,151.0
8129,Ruoka_paivittaistavarakauppa,2020-08-18 02:42:53.755656089,2020-08-18,2020-08-18,2020-08-18,8.0,-2.26,-171.81,0.0,162.0,           ,1.0,1.0,162.0
8130,Ruoka_paivittaistavarakauppa,2020-08-18 09:26:52.669683238,2020-08-18,2020-08-18,2020-08-18,8.0,-4.87,-176.68,0.0,162.0,           ,1.0,1.0,64.0
8131,Ruoka_paivittaistavarakauppa,2020-08-18 16:10:51.583710387,2020-08-18,2020-08-18,2020-08-18,8.0,-8.06,-184.74,0.0,162.0,           ,1.0,1.0,103.0
8132,Ruoka_paivittaistavarakauppa,2020-08-18 22:54:50.497737536,2020-08-18,2020-08-18,2020-08-18,8.0,-8.72,-193.46,0.0,162.0,           ,1.0,1.0,52.0
8133,Ruoka_paivittaistavarakauppa,2020-08-19 05:38:49.411764685,2020-08-19,2020-08-19,2020-08-18,8.0,-7.28,-200.74,0.0,162.0,           ,1.0,1.0,108.0
8134,Ruoka_paivittaistavarakauppa,2020-08-19 12:22:48.325791834,2020-08-19,2020-08-19,2020-08-19,8.0,-1.48,-202.22,0.0,162.0,           ,1.0,1.0,39.0
8135,Liikkuminen,2020-08-19 19:06:47.239818983,2020-08-19,2020-08-19,2020-08-19,8.0,-5.01,-207.23,0.0,162.0,           ,1.0,1.0,68.0
8136,Ruoka_paivittaistavarakauppa,2020-08-20 01:50:46.153846132,2020-08-20,2020-08-20,2020-08-20,8.0,-11.44,-218.67,0.0,162.0,           ,1.0,1.0,68.0
8137,Saastot_sijoitukset,2020-08-20 08:34:45.067873281,2020-08-20,2020-08-20,2020-08-20,8.0,-5.11,-223.78,0.0,162.0,           ,1.0,1.0,156.0
8138,Ruoka_paivittaistavarakauppa,2020-08-20 11:30:40.723981877,2020-08-20,2020-08-20,2020-08-20,8.0,-10.17,-233.95,0.0,162.0,           ,1.0,1.0,52.0
8139,Ruoka_paivittaistavarakauppa,2020-08-20 15:18:43.981900430,2020-08-20,2020-08-20,2020-08-20,8.0,-8.67,-242.62,0.0,162.0,           ,1.0,1.0,99.0
8140,Tulot,2020-08-20 22:02:42.895927579,2020-08-20,2020-08-20,2020-08-20,8.0,45.26,-197.36,0.0,505.0,           ,1.0,1.0,204.0
8141,Muut,2020-08-21 00:58:38.552036175,2020-08-21,2020-08-21,2020-08-21,8.0,-3.28,-200.64,0.0,162.0,           ,1.0,1.0,152.0
8142,Ruoka_paivittaistavarakauppa,2020-08-21 04:46:41.809954728,2020-08-21,2020-08-21,2020-08-21,8.0,-25.46,-226.1,0.0,162.0,           ,1.0,1.0,127.0
8143,Ravintolat_kahvilat,2020-08-21 07:42:37.466063324,2020-08-21,2020-08-21,2020-08-21,8.0,-14.47,-240.57,0.0,162.0,           ,1.0,1.0,107.0
8144,Tulot,2020-08-21 18:14:39.638009026,2020-08-21,2020-08-21,2020-08-21,8.0,267.68,27.11,701.0,522.0,           ,1.0,1.0,230.0
8145,Ruoka_paivittaistavarakauppa,2020-08-21 21:10:35.294117622,2020-08-21,2020-08-21,2020-08-21,8.0,-8.63,18.48,0.0,162.0,           ,1.0,1.0,159.0
8146,Ruoka_paivittaistavarakauppa,2020-08-24 00:06:30.950226218,2020-08-24,2020-08-24,2020-08-24,8.0,-2.63,15.85,0.0,162.0,           ,1.0,1.0,140.0
8147,Ruoka_paivittaistavarakauppa,2020-08-24 03:02:26.606334814,2020-08-24,2020-08-24,2020-08-24,8.0,-3.64,12.21,0.0,162.0,           ,1.0,1.0,112.0
8148,Ravintolat_kahvilat,2020-08-24 03:54:34.208144771,2020-08-24,2020-08-24,2020-08-24,8.0,-2.78,9.43,0.0,162.0,           ,1.0,1.0,72.0
8149,Ravintolat_kahvilat,2020-08-24 06:50:29.864253367,2020-08-24,2020-08-24,2020-08-24,8.0,-0.17,9.26,0.0,162.0,           ,1.0,1.0,85.0
8150,Lapset,2020-08-24 10:38:33.122171920,2020-08-24,2020-08-24,2020-08-24,8.0,-18.69,-9.43,0.0,162.0,           ,1.0,1.0,105.0
8151,Tulot,2020-08-24 13:34:28.778280516,2020-08-24,2020-08-24,2020-08-24,8.0,-0.87,-10.3,0.0,162.0,           ,1.0,1.0,95.0
8152,Luokittelemattomat,2020-08-24 14:26:36.380090473,2020-08-24,2020-08-25,2020-08-24,8.0,-6.43,-16.73,0.0,162.0,           ,1.0,1.0,78.0
8153,Saastot_sijoitukset,2020-08-24 16:30:24.434389112,2020-08-24,2020-08-24,2020-08-24,8.0,-3.7,-20.43,0.0,162.0,           ,1.0,1.0,128.0
8154,Ruoka_paivittaistavarakauppa,2020-08-24 17:22:32.036199069,2020-08-24,2020-08-24,2020-08-24,8.0,-5.09,-25.52,0.0,162.0,           ,1.0,1.0,105.0
8155,Matkailu,2020-08-24 20:18:27.692307665,2020-08-24,2020-08-24,2020-08-24,8.0,-4.88,-30.4,0.0,162.0,           ,1.0,1.0,153.0
8156,Ruoka_paivittaistavarakauppa,2020-08-24 23:14:23.348416261,2020-08-24,2020-08-24,2020-08-24,8.0,-0.35,-30.75,0.0,162.0,           ,1.0,1.0,121.0
8157,Ruoka_paivittaistavarakauppa,2020-08-26 05:58:22.262443410,2020-08-26,2020-08-26,2020-08-26,8.0,-5.32,-36.07,0.0,162.0,           ,1.0,1.0,167.0
8158,Ruoka_paivittaistavarakauppa,2020-08-26 09:46:25.520361963,2020-08-26,2020-08-26,2020-08-26,8.0,-2.09,-38.16,0.0,162.0,           ,1.0,1.0,146.0
8159,Tulot,2020-08-26 12:42:21.176470559,2020-08-26,2020-08-26,2020-08-26,8.0,68.0,29.84,0.0,505.0,           ,1.0,1.0,203.0
8160,Ravintolat_kahvilat,2020-08-27 02:10:19.004524857,2020-08-27,2020-08-27,2020-08-27,8.0,-10.47,19.37,0.0,162.0,           ,1.0,1.0,128.0
8161,Muut,2020-08-27 08:54:17.918552006,2020-08-27,2020-08-27,2020-08-27,8.0,-0.57,18.8,0.0,162.0,           ,1.0,1.0,168.0
8162,Ruoka_paivittaistavarakauppa,2020-08-27 19:26:20.090497708,2020-08-27,2020-08-27,2020-08-27,8.0,-5.05,13.75,0.0,162.0,           ,1.0,1.0,45.0
8163,Lemmikit,2020-08-28 01:18:11.402714900,2020-08-28,2020-08-28,2020-08-27,8.0,-6.0,7.75,0.0,162.0,           ,1.0,1.0,105.0
8164,Muut,2020-08-28 05:06:14.660633453,2020-08-28,2020-08-28,2020-08-28,8.0,-8.54,-0.79,0.0,163.0,           ,1.0,1.0,190.0
8165,Liikkuminen,2020-08-28 08:02:10.316742049,2020-08-28,2020-08-28,2020-08-28,8.0,-5.74,-6.53,0.0,162.0,           ,1.0,1.0,126.0
8166,Liikkuminen,2020-08-28 11:50:13.574660602,2020-08-28,2020-08-28,2020-08-28,8.0,-2.71,-9.24,0.0,162.0,           ,1.0,1.0,64.0
8167,Ravintolat_kahvilat,2020-08-28 18:34:12.488687751,2020-08-28,2020-08-28,2020-08-28,8.0,-3.05,-12.29,0.0,162.0,           ,1.0,1.0,140.0
8168,Tulot,2020-08-28 22:22:15.746606304,2020-08-28,2020-08-28,2020-08-28,8.0,33.49,21.2,0.0,505.0,           ,1.0,1.0,203.0
8169,Tulot,2020-08-29 15:38:16.832579155,2020-08-29,2020-08-29,2020-08-29,8.0,17.83,39.03,0.0,505.0,           ,1.0,1.0,204.0
8170,Liikkuminen,2020-08-31 00:26:03.800904943,2020-08-31,2020-08-31,2020-08-31,8.0,-13.85,25.18,0.0,162.0,           ,1.0,1.0,40.0
8171,Lemmikit,2020-08-31 04:14:07.058823496,2020-08-31,2020-08-31,2020-08-31,8.0,-7.71,17.47,0.0,162.0,           ,1.0,1.0,57.0
8172,Muut,2020-08-31 07:10:02.714932092,2020-08-31,2020-08-31,2020-08-31,8.0,-4.92,12.55,0.0,162.0,           ,1.0,1.0,125.0
8173,Kulttuuri_viihde,2020-08-31 10:58:05.972850645,2020-08-31,2020-09-02,2020-08-31,8.0,-14.65,-2.1,0.0,162.0,           ,1.0,1.0,85.0
8174,Luokittelemattomat,2020-08-31 13:54:01.628959241,2020-08-31,2020-08-31,2020-08-31,8.0,-1.86,-3.96,0.0,162.0,           ,1.0,1.0,131.0
8175,Ruoka_paivittaistavarakauppa,2020-08-31 14:46:09.230769198,2020-08-31,2020-09-01,2020-08-31,8.0,-6.14,-10.1,0.0,162.0,           ,1.0,1.0,78.0
8176,Ravintolat_kahvilat,2020-08-31 17:42:04.886877794,2020-08-31,2020-08-31,2020-08-31,8.0,-16.48,-26.58,0.0,162.0,           ,1.0,1.0,157.0
8177,Lapset,2020-08-31 20:38:00.542986390,2020-08-31,2020-08-31,2020-08-31,8.0,-15.13,-41.71,0.0,162.0,           ,1.0,1.0,115.0
8178,Ruoka_paivittaistavarakauppa,2020-08-31 21:30:08.144796347,2020-08-31,2020-08-31,2020-08-31,8.0,-20.19,-61.9,0.0,162.0,           ,1.0,1.0,169.0
8179,Luokittelemattomat,2020-10-01 13:24:19.459459459,2020-10-01,2020-10-01,2020-10-01,8.0,-2.31,-64.21,0.0,162.0,           ,1.0,1.0,121.0
8180,Liikkuminen,2020-10-02 02:48:38.918918918,2020-10-02,2020-10-02,2020-10-02,8.0,-4.1,-68.31,0.0,162.0,           ,1.0,1.0,78.0
8181,Ruoka_paivittaistavarakauppa,2020-10-02 16:12:58.378378377,2020-10-02,2020-10-02,2020-10-02,8.0,-11.75,-80.06,0.0,162.0,           ,1.0,1.0,113.0
8182,Ruoka_paivittaistavarakauppa,2020-10-02 19:01:37.297297295,2020-10-02,2020-10-02,2020-10-02,8.0,-3.75,-83.81,0.0,162.0,           ,1.0,1.0,124.0
8183,Tulot,2020-10-04 21:50:16.216216213,2020-10-04,2020-10-04,2020-10-04,8.0,70.55,-13.26,0.0,506.0,           ,1.0,1.0,210.0
8184,Ruoka_paivittaistavarakauppa,2020-10-05 00:38:55.135135131,2020-10-05,2020-10-05,2020-10-05,8.0,-37.16,-50.42,0.0,162.0,           ,1.0,1.0,93.0
8185,Ruoka_paivittaistavarakauppa,2020-10-05 05:37:17.837837836,2020-10-05,2020-10-05,2020-10-05,8.0,-3.57,-53.99,0.0,162.0,           ,1.0,1.0,90.0
8186,Ruoka_paivittaistavarakauppa,2020-10-05 08:25:56.756756754,2020-10-05,2020-10-05,2020-10-05,8.0,-2.65,-56.64,0.0,162.0,           ,1.0,1.0,107.0
8187,Luokittelemattomat,2020-10-05 11:14:35.675675672,2020-10-05,2020-10-05,2020-10-05,8.0,-3.53,-60.17,0.0,162.0,           ,1.0,1.0,119.0
8188,Ruoka_paivittaistavarakauppa,2020-10-06 14:03:14.594594590,2020-10-06,2020-10-06,2020-10-05,8.0,-1.8,-61.97,0.0,162.0,           ,1.0,1.0,135.0
8189,Lemmikit,2020-10-07 03:27:34.054054049,2020-10-07,2020-10-07,2020-10-07,8.0,-8.02,-69.99,0.0,162.0,           ,1.0,1.0,113.0
8190,Ravintolat_kahvilat,2020-10-07 16:51:53.513513508,2020-10-07,2020-10-07,2020-10-07,8.0,-0.27,-70.26,0.0,162.0,           ,1.0,1.0,152.0
8191,Ruoka_paivittaistavarakauppa,2020-10-08 06:16:12.972972967,2020-10-08,2020-10-08,2020-10-08,8.0,-1.12,-71.38,0.0,162.0,           ,1.0,1.0,146.0
8192,Ravintolat_kahvilat,2020-10-08 19:40:32.432432426,2020-10-08,2020-10-08,2020-10-08,8.0,-1.84,-73.22,0.0,162.0,           ,1.0,1.0,142.0
8193,Ruoka_paivittaistavarakauppa,2020-10-09 09:04:51.891891885,2020-10-09,2020-10-09,2020-10-09,8.0,-5.35,-78.57,0.0,162.0,           ,1.0,1.0,162.0
8194,Tulot,2020-10-09 22:29:11.351351344,2020-10-09,2020-10-09,2020-10-09,8.0,101.52,22.95,0.0,505.0,           ,1.0,1.0,205.0
8195,Muut,2020-10-10 11:53:30.810810803,2020-10-10,2020-10-10,2020-10-10,8.0,-20.29,2.66,0.0,163.0,           ,1.0,1.0,191.0
8196,Muut,2020-10-12 14:42:09.729729721,2020-10-12,2020-10-12,2020-10-12,8.0,-0.14,2.52,0.0,162.0,           ,1.0,1.0,113.0
8197,Ruoka_paivittaistavarakauppa,2020-10-12 17:30:48.648648639,2020-10-12,2020-10-14,2020-10-12,8.0,-0.41,2.11,0.0,162.0,           ,1.0,1.0,124.0
8198,Asuminen,2020-10-12 23:08:06.486486475,2020-10-12,2020-10-12,2020-10-12,8.0,-16.45,-14.34,0.0,106.0,OKOYFIHH   ,0.0,0.0,9.0
8199,Ravintolat_kahvilat,2020-10-13 01:17:50.270270262,2020-10-13,2020-10-13,2020-10-13,8.0,-7.26,-21.6,0.0,162.0,           ,1.0,1.0,137.0
8200,Muut,2020-10-13 04:06:29.189189180,2020-10-13,2020-10-13,2020-10-13,8.0,-27.2,-48.8,0.0,163.0,           ,1.0,1.0,192.0
8201,Ruoka_paivittaistavarakauppa,2020-10-13 06:55:08.108108098,2020-10-13,2020-10-13,2020-10-13,8.0,-6.18,-54.98,0.0,162.0,           ,1.0,1.0,188.0
8202,Ruoka_paivittaistavarakauppa,2020-10-14 09:43:47.027027016,2020-10-14,2020-10-14,2020-10-14,8.0,-3.55,-58.53,0.0,162.0,           ,1.0,1.0,107.0
8203,Luokittelemattomat,2020-10-14 20:19:27.567567557,2020-10-14,2020-10-14,2020-10-14,8.0,-5.32,-63.85,0.0,162.0,           ,1.0,1.0,120.0
8204,Ruoka_paivittaistavarakauppa,2020-10-15 12:32:25.945945934,2020-10-15,2020-10-15,2020-10-15,8.0,-0.33,-64.18,0.0,162.0,           ,1.0,1.0,129.0
8205,Liikkuminen,2020-10-15 15:21:04.864864852,2020-10-15,2020-10-15,2020-10-15,8.0,-13.59,-77.77,0.0,162.0,           ,1.0,1.0,39.0
8206,Ruoka_paivittaistavarakauppa,2020-10-15 18:09:43.783783770,2020-10-15,2020-10-15,2020-10-15,8.0,-7.08,-84.85,0.0,162.0,           ,1.0,1.0,57.0
8207,Liikkuminen,2020-10-16 01:56:45.405405393,2020-10-16,2020-10-16,2020-10-16,8.0,-2.07,-86.92,0.0,162.0,           ,1.0,1.0,132.0
8208,Ruoka_paivittaistavarakauppa,2020-10-16 07:34:03.243243229,2020-10-16,2020-10-16,2020-10-16,8.0,-2.22,-89.14,0.0,162.0,           ,1.0,1.0,45.0
8209,Ruoka_paivittaistavarakauppa,2020-10-19 04:45:24.324324311,2020-10-19,2020-10-19,2020-10-19,8.0,-34.5,-123.64,0.0,162.0,           ,1.0,1.0,139.0
8210,Terveys,2020-10-19 10:22:42.162162147,2020-10-19,2020-10-19,2020-10-19,8.0,-0.41,-124.05,0.0,162.0,           ,1.0,1.0,186.0
8211,Ravintolat_kahvilat,2020-10-19 23:47:01.621621606,2020-10-19,2020-10-19,2020-10-19,8.0,-3.41,-127.46,0.0,162.0,           ,1.0,1.0,108.0
8212,Ruoka_paivittaistavarakauppa,2020-10-20 13:11:21.081081065,2020-10-20,2020-10-20,2020-10-20,8.0,-1.16,-128.62,0.0,162.0,           ,1.0,1.0,79.0
8213,Ruoka_paivittaistavarakauppa,2020-10-20 20:58:22.702702688,2020-10-20,2020-10-21,2020-10-20,8.0,-2.29,-130.91,0.0,162.0,           ,1.0,1.0,162.0
8214,Tulot,2020-10-21 02:35:40.540540524,2020-10-21,2020-10-21,2020-10-21,8.0,179.41,48.5,0.0,505.0,           ,1.0,1.0,203.0
8215,Ruoka_paivittaistavarakauppa,2020-10-21 15:59:59.999999983,2020-10-21,2020-10-21,2020-10-21,8.0,-10.39,38.11,0.0,162.0,           ,1.0,1.0,92.0
8216,Ruoka_paivittaistavarakauppa,2020-10-21 18:48:38.918918901,2020-10-21,2020-10-21,2020-10-21,8.0,-0.73,37.38,0.0,162.0,           ,1.0,1.0,157.0
8217,Ruoka_paivittaistavarakauppa,2020-10-22 05:24:19.459459442,2020-10-22,2020-10-22,2020-10-22,8.0,-15.41,21.97,0.0,162.0,           ,1.0,1.0,156.0
8218,Liikkuminen,2020-10-22 11:01:37.297297278,2020-10-22,2020-10-22,2020-10-22,8.0,-16.48,5.49,0.0,162.0,           ,1.0,1.0,57.0
8219,Ruoka_paivittaistavarakauppa,2020-10-23 08:12:58.378378360,2020-10-23,2020-10-23,2020-10-23,8.0,-4.82,0.67,0.0,162.0,           ,1.0,1.0,136.0
8220,Ruoka_paivittaistavarakauppa,2020-10-23 21:37:17.837837819,2020-10-23,2020-10-23,2020-10-23,8.0,-9.48,-8.81,0.0,162.0,           ,1.0,1.0,148.0
8221,Ruoka_paivittaistavarakauppa,2020-10-26 00:25:56.756756737,2020-10-26,2020-10-26,2020-10-26,8.0,-3.01,-11.82,0.0,162.0,           ,1.0,1.0,147.0
8222,Lapset,2020-10-26 03:14:35.675675655,2020-10-26,2020-10-26,2020-10-26,8.0,-22.66,-34.48,0.0,162.0,           ,1.0,1.0,142.0
8223,Ruoka_paivittaistavarakauppa,2020-10-26 13:50:16.216216196,2020-10-26,2020-10-26,2020-10-26,8.0,-31.64,-66.12,0.0,162.0,           ,1.0,1.0,75.0
8224,Lemmikit,2020-10-26 16:38:55.135135114,2020-10-26,2020-10-26,2020-10-26,8.0,-62.18,-128.3,0.0,162.0,           ,1.0,1.0,181.0
8225,Ruoka_paivittaistavarakauppa,2020-10-27 06:03:14.594594573,2020-10-27,2020-10-27,2020-10-27,8.0,-1.96,-130.26,0.0,162.0,           ,1.0,1.0,133.0
8226,Muut,2020-10-27 19:27:34.054054032,2020-10-27,2020-10-27,2020-10-27,8.0,-10.18,-140.44,0.0,162.0,           ,1.0,1.0,123.0
8227,Lemmikit,2020-10-28 08:51:53.513513491,2020-10-28,2020-10-28,2020-10-28,8.0,-1.05,-141.49,0.0,162.0,           ,1.0,1.0,140.0
8228,Tulot,2020-10-29 22:16:12.972972950,2020-10-29,2020-10-29,2020-10-29,8.0,287.98,146.49,0.0,506.0,           ,1.0,1.0,209.0
8229,Asuminen,2020-10-30 01:04:51.891891868,2020-10-30,2020-10-30,2020-10-30,8.0,-3.21,143.28,0.0,162.0,           ,1.0,1.0,155.0
8230,Ruoka_paivittaistavarakauppa,2020-10-30 03:53:30.810810786,2020-10-30,2020-10-30,2020-10-30,8.0,-8.5,134.78,0.0,162.0,           ,1.0,1.0,41.0
8231,Ruoka_paivittaistavarakauppa,2020-10-30 11:40:32.432432409,2020-10-30,2020-10-30,2020-10-30,8.0,-19.37,115.41,0.0,162.0,           ,1.0,1.0,154.0
8232,Ruoka_paivittaistavarakauppa,2020-10-30 14:29:11.351351327,2020-10-30,2020-10-30,2020-10-30,8.0,-2.2,113.21,0.0,162.0,           ,1.0,1.0,98.0
8233,Lapset,2020-10-30 17:17:50.270270245,2020-10-30,2020-10-30,2020-10-29,8.0,-25.78,87.43,0.0,162.0,           ,1.0,1.0,40.0
8234,Saastot_sijoitukset,2020-11-02 04:22:27.783251228,2020-11-02,2020-11-02,2020-11-02,8.0,-2.5,84.93,0.0,162.0,           ,1.0,1.0,119.0
8235,Matkailu,2020-11-02 07:05:36.945812807,2020-11-02,2020-11-02,2020-11-02,8.0,-6.62,78.31,0.0,164.0,           ,1.0,1.0,195.0
8236,Ruoka_paivittaistavarakauppa,2020-11-02 11:28:04.729064035,2020-11-02,2020-11-02,2020-11-02,8.0,-7.56,70.75,0.0,162.0,           ,1.0,1.0,40.0
8237,Ruoka_paivittaistavarakauppa,2020-11-02 14:11:13.891625614,2020-11-02,2020-11-02,2020-11-02,8.0,-0.95,69.8,0.0,162.0,           ,1.0,1.0,129.0
8238,Ravintolat_kahvilat,2020-11-02 18:33:41.674876842,2020-11-02,2020-11-02,2020-11-02,8.0,-23.78,46.02,0.0,162.0,           ,1.0,1.0,107.0
8239,Ruoka_paivittaistavarakauppa,2020-11-02 21:16:50.837438421,2020-11-02,2020-11-02,2020-11-02,8.0,-5.67,40.35,0.0,162.0,           ,1.0,1.0,168.0
8240,Ravintolat_kahvilat,2020-11-03 01:39:18.620689649,2020-11-03,2020-11-03,2020-11-03,8.0,-13.8,26.55,0.0,162.0,           ,1.0,1.0,135.0
8241,Tulot,2020-11-03 06:01:46.403940877,2020-11-03,2020-11-03,2020-11-03,8.0,17.21,43.76,0.0,551.0,           ,1.0,1.0,212.0
8242,Luokittelemattomat,2020-11-03 08:44:55.566502456,2020-11-03,2020-11-03,2020-11-03,8.0,-4.1,39.66,0.0,162.0,           ,1.0,1.0,141.0
8243,Ruoka_paivittaistavarakauppa,2020-11-03 15:50:32.512315263,2020-11-03,2020-11-04,2020-11-03,8.0,-6.58,33.08,0.0,162.0,           ,1.0,1.0,56.0
8244,Ruoka_paivittaistavarakauppa,2020-11-03 22:56:09.458128070,2020-11-03,2020-11-03,2020-11-02,8.0,-14.24,18.84,0.0,162.0,           ,1.0,1.0,173.0
8245,Luokittelemattomat,2020-11-04 13:07:23.349753684,2020-11-04,2020-11-04,2020-11-04,8.0,-1.87,16.97,0.0,106.0,OKOYFIHH   ,0.0,0.0,13.0
8246,Tulot,2020-11-04 20:13:00.295566491,2020-11-04,2020-11-04,2020-11-04,8.0,28.96,45.93,0.0,505.0,           ,1.0,1.0,206.0
8247,Lapset,2020-11-05 10:24:14.187192105,2020-11-05,2020-11-05,2020-11-05,8.0,-5.89,40.04,0.0,162.0,           ,1.0,1.0,41.0
8248,Liikkuminen,2020-11-05 12:03:32.807881754,2020-11-05,2020-11-05,2020-11-05,8.0,-15.63,24.41,0.0,162.0,           ,1.0,1.0,148.0
8249,Lapset,2020-11-06 00:35:28.078817719,2020-11-06,2020-11-06,2020-11-06,8.0,-2.56,21.85,0.0,162.0,           ,1.0,1.0,156.0
8250,Lapset,2020-11-06 03:18:37.241379298,2020-11-06,2020-11-06,2020-11-06,8.0,-18.63,3.22,0.0,162.0,           ,1.0,1.0,185.0
8251,Tulot,2020-11-06 07:41:05.024630526,2020-11-06,2020-11-06,2020-11-06,8.0,0.37,3.59,0.0,551.0,           ,1.0,1.0,211.0
8252,Tulot,2020-11-06 14:46:41.970443333,2020-11-06,2020-11-06,2020-11-06,8.0,27.81,31.4,0.0,551.0,           ,1.0,1.0,212.0
8253,Lapset,2020-11-06 17:29:51.133004912,2020-11-06,2020-11-06,2020-11-06,8.0,-1.12,30.28,0.0,162.0,           ,1.0,1.0,78.0
8254,Luokittelemattomat,2020-11-06 21:52:18.916256140,2020-11-06,2020-11-06,2020-11-06,8.0,-13.7,16.58,0.0,106.0,OKOYFIHH   ,1.0,0.0,17.0
8255,Liikkuminen,2020-11-07 20:48:28.374384210,2020-11-07,2020-11-07,2020-11-07,8.0,-2.0,14.58,0.0,151.0,           ,1.0,1.0,33.0
8256,Ravintolat_kahvilat,2020-11-09 02:14:46.699507368,2020-11-09,2020-11-09,2020-11-09,8.0,-2.4,12.18,0.0,162.0,           ,1.0,1.0,122.0
8257,Liikkuminen,2020-11-09 04:57:55.862068947,2020-11-09,2020-11-11,2020-11-09,8.0,-4.38,7.8,0.0,162.0,           ,1.0,1.0,133.0
8258,Luokittelemattomat,2020-11-09 06:37:14.482758596,2020-11-09,2020-11-09,2020-11-09,8.0,-4.62,3.18,0.0,106.0,SBANFIHH   ,1.0,0.0,29.0
8259,Ruoka_paivittaistavarakauppa,2020-11-09 09:20:23.645320175,2020-11-09,2020-11-09,2020-11-09,8.0,-2.08,1.1,0.0,162.0,           ,1.0,1.0,42.0
8260,Tulot,2020-11-09 13:42:51.428571403,2020-11-09,2020-11-09,2020-11-09,8.0,14.99,16.09,0.0,551.0,           ,1.0,1.0,212.0
8261,Ravintolat_kahvilat,2020-11-09 15:22:10.049261052,2020-11-09,2020-11-09,2020-11-09,8.0,-8.33,7.76,0.0,162.0,           ,1.0,1.0,117.0
8262,Liikkuminen,2020-11-09 16:26:00.591132982,2020-11-09,2020-11-09,2020-11-09,8.0,-3.03,4.73,0.0,162.0,           ,1.0,1.0,186.0
8263,Ravintolat_kahvilat,2020-11-09 19:09:09.753694561,2020-11-09,2020-11-09,2020-11-09,8.0,-13.35,-8.62,0.0,162.0,           ,1.0,1.0,87.0
8264,Ravintolat_kahvilat,2020-11-10 10:59:42.266009824,2020-11-10,2020-11-10,2020-11-10,8.0,-10.85,-19.47,0.0,162.0,           ,1.0,1.0,154.0
8265,Ruoka_paivittaistavarakauppa,2020-11-10 18:05:19.211822631,2020-11-10,2020-11-10,2020-11-10,8.0,-2.64,-22.11,0.0,162.0,           ,1.0,1.0,86.0
8266,Tulot,2020-11-10 23:31:37.536945789,2020-11-10,2020-11-10,2020-11-10,8.0,1.64,-20.47,710.0,588.0,           ,0.0,1.0,260.0
8267,Liikkuminen,2020-11-11 01:10:56.157635438,2020-11-11,2020-11-11,2020-11-11,8.0,-6.99,-27.46,0.0,162.0,           ,1.0,1.0,117.0
8268,Luokittelemattomat,2020-11-11 03:54:05.320197017,2020-11-11,2020-11-11,2020-11-11,8.0,-57.15,-84.61,0.0,151.0,           ,1.0,1.0,38.0
8269,Ruoka_paivittaistavarakauppa,2020-11-12 08:16:33.103448245,2020-11-12,2020-11-12,2020-11-12,8.0,-2.28,-86.89,0.0,162.0,           ,1.0,1.0,179.0
8270,Ruoka_paivittaistavarakauppa,2020-11-12 12:39:00.886699473,2020-11-12,2020-11-12,2020-11-12,8.0,-0.97,-87.86,0.0,162.0,           ,1.0,1.0,103.0
8271,Lemmikit,2020-11-12 19:44:37.832512280,2020-11-12,2020-11-12,2020-11-12,8.0,-6.19,-94.05,0.0,151.0,           ,1.0,1.0,35.0
8272,Liikkuminen,2020-11-12 22:27:46.995073859,2020-11-12,2020-11-12,2020-11-12,8.0,-1.95,-96.0,0.0,162.0,           ,1.0,1.0,78.0
8273,Asuminen,2020-11-13 02:50:14.778325087,2020-11-13,2020-11-13,2020-11-13,8.0,-8.42,-104.42,0.0,106.0,OKOYFIHH   ,0.0,0.0,27.0
8274,Liikkuminen,2020-11-13 09:55:51.724137894,2020-11-13,2020-11-13,2020-11-13,8.0,-1.69,-106.11,0.0,151.0,           ,1.0,1.0,33.0
8275,Tulot,2020-11-13 17:01:28.669950701,2020-11-13,2020-11-13,2020-11-13,8.0,404.17,298.06,0.0,551.0,           ,1.0,1.0,212.0
8276,Luokittelemattomat,2020-11-14 00:07:05.615763508,2020-11-14,2020-11-14,2020-11-14,8.0,-191.04,107.02,0.0,151.0,           ,1.0,1.0,34.0
8277,Luottojen_maksut,2020-11-14 05:33:23.940886666,2020-11-14,2020-11-14,2020-11-14,8.0,-4.86,102.16,0.0,151.0,           ,1.0,1.0,34.0
8278,Luottojen_maksut,2020-11-14 14:18:19.507389122,2020-11-14,2020-11-14,2020-11-14,8.0,-77.61,24.55,0.0,151.0,           ,1.0,1.0,34.0
8279,Liikkuminen,2020-11-15 04:29:33.399014736,2020-11-15,2020-11-15,2020-11-15,8.0,-18.5,6.05,0.0,151.0,           ,1.0,1.0,33.0
8280,Tulot,2020-11-15 11:35:10.344827543,2020-11-15,2020-11-15,2020-11-15,8.0,0.93,6.98,0.0,551.0,           ,1.0,1.0,212.0
8281,Tulot,2020-11-15 21:23:56.453201929,2020-11-15,2020-11-15,2020-11-15,8.0,5.52,12.5,0.0,551.0,           ,1.0,1.0,213.0
8282,Ruoka_paivittaistavarakauppa,2020-11-16 01:46:24.236453157,2020-11-16,2020-11-16,2020-11-16,8.0,-14.17,-1.67,0.0,162.0,           ,1.0,1.0,106.0
8283,Tulot,2020-11-16 06:08:52.019704385,2020-11-16,2020-11-16,2020-11-16,8.0,0.87,-0.8,0.0,551.0,           ,1.0,1.0,212.0
8284,Luokittelemattomat,2020-11-16 07:12:42.561576315,2020-11-16,2020-11-16,2020-11-16,8.0,-4.7,-5.5,0.0,162.0,           ,1.0,1.0,113.0
8285,Luottojen_maksut,2020-11-16 07:48:10.640394034,2020-11-16,2020-11-16,2020-11-16,8.0,-0.64,-6.14,0.0,151.0,           ,1.0,1.0,37.0
8286,Matkailu,2020-11-16 08:52:01.182265964,2020-11-16,2020-11-16,2020-11-16,8.0,-10.55,-16.69,0.0,162.0,           ,1.0,1.0,75.0
8287,Ruoka_paivittaistavarakauppa,2020-11-16 15:57:38.128078771,2020-11-16,2020-11-16,2020-11-16,8.0,-8.23,-24.92,0.0,162.0,           ,1.0,1.0,148.0
8288,Ruoka_paivittaistavarakauppa,2020-11-16 18:40:47.290640350,2020-11-16,2020-11-18,2020-11-16,8.0,-7.1,-32.02,0.0,162.0,           ,1.0,1.0,168.0
8289,Tulot,2020-11-16 20:20:05.911329999,2020-11-16,2020-11-16,2020-11-16,8.0,98.0,65.98,701.0,506.0,           ,1.0,1.0,220.0
8290,Ruoka_paivittaistavarakauppa,2020-11-16 23:03:15.073891578,2020-11-16,2020-11-16,2020-11-16,8.0,-4.08,61.9,0.0,162.0,           ,1.0,1.0,76.0
8291,Muut,2020-11-18 00:42:33.694581227,2020-11-18,2020-11-18,2020-11-18,8.0,-17.83,44.07,0.0,106.0,OKOYFIHH   ,0.0,0.0,23.0
8292,Matkailu,2020-11-18 10:31:19.802955613,2020-11-18,2020-11-18,2020-11-18,8.0,-1.4,42.67,0.0,151.0,           ,1.0,1.0,33.0
8293,Luokittelemattomat,2020-11-18 13:14:28.965517192,2020-11-18,2020-11-18,2020-11-18,8.0,-10.84,31.83,0.0,151.0,           ,1.0,1.0,33.0
8294,Tulot,2020-11-19 03:25:42.857142806,2020-11-19,2020-11-19,2020-11-19,8.0,9.33,41.16,0.0,551.0,           ,1.0,1.0,211.0
8295,Ruoka_paivittaistavarakauppa,2020-11-19 14:53:47.586206841,2020-11-19,2020-11-19,2020-11-19,8.0,-5.3,35.86,0.0,162.0,           ,1.0,1.0,153.0
8296,Luokittelemattomat,2020-11-19 17:36:56.748768420,2020-11-19,2020-11-19,2020-11-19,8.0,-4.35,31.51,0.0,151.0,           ,1.0,1.0,33.0
8297,Matkailu,2020-11-20 05:05:01.477832455,2020-11-20,2020-11-20,2020-11-20,8.0,-5.55,25.96,0.0,151.0,           ,1.0,1.0,36.0
8298,Tulot,2020-11-20 12:10:38.423645262,2020-11-20,2020-11-20,2020-11-20,8.0,9.6,35.56,0.0,551.0,           ,1.0,1.0,211.0
8299,Tulot,2020-11-20 19:16:15.369458069,2020-11-20,2020-11-20,2020-11-20,8.0,6.62,42.18,0.0,551.0,           ,1.0,1.0,216.0
8300,Luokittelemattomat,2020-11-20 21:59:24.532019648,2020-11-20,2020-11-20,2020-11-20,8.0,-3.19,38.99,0.0,151.0,           ,1.0,1.0,34.0
8301,Matkailu,2020-11-21 02:21:52.315270876,2020-11-21,2020-11-21,2020-11-21,8.0,-1.44,37.55,0.0,151.0,           ,1.0,1.0,35.0
8302,Luokittelemattomat,2020-11-21 09:27:29.261083683,2020-11-21,2020-11-21,2020-11-21,8.0,-25.35,12.2,0.0,151.0,           ,1.0,1.0,33.0
8303,Matkailu,2020-11-21 16:33:06.206896490,2020-11-21,2020-11-21,2020-11-21,8.0,-3.33,8.87,0.0,151.0,           ,1.0,1.0,33.0
8304,Tulot,2020-11-22 04:01:10.935960525,2020-11-22,2020-11-22,2020-11-22,8.0,2.65,11.52,0.0,551.0,           ,1.0,1.0,212.0
8305,Liikkuminen,2020-11-22 22:34:52.610837367,2020-11-22,2020-11-22,2020-11-22,8.0,-10.9,0.62,0.0,151.0,           ,1.0,1.0,36.0
8306,Tulot,2020-11-22 23:38:43.152709297,2020-11-22,2020-11-22,2020-11-22,8.0,37.74,38.36,0.0,551.0,           ,1.0,1.0,212.0
8307,Ruoka_paivittaistavarakauppa,2020-11-23 06:44:20.098522104,2020-11-23,2020-11-23,2020-11-23,8.0,-9.57,28.79,0.0,162.0,           ,1.0,1.0,108.0
8308,Luottojen_maksut,2020-11-23 08:23:38.719211753,2020-11-23,2020-11-23,2020-11-23,8.0,-0.85,27.94,0.0,151.0,           ,1.0,1.0,34.0
8309,Luokittelemattomat,2020-11-23 18:12:24.827586139,2020-11-23,2020-11-23,2020-11-23,8.0,-38.75,-10.81,0.0,106.0,OKOYFIHH   ,1.0,0.0,11.0
8310,Ravintolat_kahvilat,2020-11-23 20:55:33.990147718,2020-11-23,2020-11-23,2020-11-23,8.0,-17.09,-27.9,0.0,162.0,           ,1.0,1.0,97.0
8311,Tulot,2020-11-24 05:40:29.556650174,2020-11-24,2020-11-24,2020-11-24,8.0,107.16,79.26,0.0,505.0,           ,1.0,1.0,205.0
8312,Lemmikit,2020-11-24 11:06:47.881773332,2020-11-24,2020-11-24,2020-11-24,8.0,-15.1,64.16,0.0,106.0,OKOYFIHH   ,0.0,0.0,28.0
8313,Ruoka_paivittaistavarakauppa,2020-11-24 13:49:57.044334911,2020-11-24,2020-11-24,2020-11-24,8.0,-10.39,53.77,0.0,162.0,           ,1.0,1.0,101.0
8314,Tulot,2020-11-24 15:29:15.665024560,2020-11-24,2020-11-24,2020-11-24,8.0,13.56,67.33,0.0,551.0,           ,1.0,1.0,211.0
8315,Luokittelemattomat,2020-11-25 01:18:01.773398946,2020-11-25,2020-11-25,2020-11-25,8.0,-107.61,-40.28,0.0,106.0,OKOYFIHH   ,1.0,0.0,23.0
8316,Muut,2020-11-25 02:57:20.394088595,2020-11-25,2020-11-25,2020-11-25,8.0,-1.3,-41.58,0.0,162.0,           ,1.0,1.0,78.0
8317,Liikkuminen,2020-11-26 12:46:06.502462981,2020-11-26,2020-11-26,2020-11-26,8.0,-1.74,-43.32,0.0,151.0,           ,1.0,1.0,33.0
8318,Luokittelemattomat,2020-11-27 00:14:11.231527016,2020-11-27,2020-11-27,2020-11-27,8.0,-5.59,-48.91,0.0,151.0,           ,1.0,1.0,34.0
8319,Ruoka_paivittaistavarakauppa,2020-11-27 07:19:48.177339823,2020-11-27,2020-11-27,2020-11-27,8.0,-5.38,-54.29,0.0,162.0,           ,1.0,1.0,54.0
8320,Liikkuminen,2020-11-27 10:02:57.339901402,2020-11-27,2020-11-27,2020-11-27,8.0,-4.39,-58.68,0.0,162.0,           ,1.0,1.0,147.0
8321,Tulot,2020-11-27 14:25:25.123152630,2020-11-27,2020-11-27,2020-11-27,8.0,172.86,114.18,0.0,551.0,           ,1.0,1.0,212.0
8322,Liikkuminen,2020-11-27 17:08:34.285714209,2020-11-27,2020-11-27,2020-11-27,8.0,-4.73,109.45,0.0,162.0,           ,1.0,1.0,47.0
8323,Luokittelemattomat,2020-11-27 18:47:52.906403858,2020-11-27,2020-11-27,2020-11-27,8.0,-44.51,64.94,0.0,151.0,           ,1.0,1.0,37.0
8324,Saastot_sijoitukset,2020-11-27 19:51:43.448275788,2020-11-27,2020-11-27,2020-11-27,8.0,89.31,154.25,0.0,551.0,           ,1.0,1.0,213.0
8325,Luottojen_maksut,2020-11-27 21:31:02.068965437,2020-11-27,2020-11-27,2020-11-27,8.0,-139.35,14.9,0.0,151.0,           ,1.0,1.0,34.0
8326,Luokittelemattomat,2020-11-28 04:36:39.014778244,2020-11-28,2020-11-30,2020-11-28,8.0,-12.58,2.32,0.0,151.0,           ,1.0,1.0,34.0
8327,Tulot,2020-11-29 08:59:06.798029472,2020-11-29,2020-11-29,2020-11-29,8.0,47.25,49.57,0.0,505.0,           ,1.0,1.0,205.0
8328,Liikkuminen,2020-11-29 13:21:34.581280700,2020-11-29,2020-11-29,2020-11-29,8.0,-35.03,14.54,0.0,151.0,           ,1.0,1.0,34.0
8329,Tulot,2020-11-29 23:10:20.689655086,2020-11-29,2020-12-01,2020-11-29,8.0,10.22,24.76,0.0,551.0,           ,1.0,1.0,211.0
8330,Ruoka_paivittaistavarakauppa,2020-11-30 01:53:29.852216665,2020-11-30,2020-11-30,2020-11-30,8.0,-1.08,23.68,0.0,162.0,           ,1.0,1.0,168.0
8331,Saastot_sijoitukset,2020-11-30 06:15:57.635467893,2020-11-30,2020-12-02,2020-11-30,8.0,23.7,47.38,0.0,551.0,           ,1.0,1.0,213.0
8332,Luokittelemattomat,2020-11-30 11:42:15.960591051,2020-11-30,2020-11-30,2020-11-30,8.0,-18.07,29.31,0.0,151.0,           ,1.0,1.0,34.0
8333,Ruoka_paivittaistavarakauppa,2020-11-30 16:04:43.743842279,2020-11-30,2020-11-30,2020-11-30,8.0,-1.83,27.48,0.0,162.0,           ,1.0,1.0,85.0
8334,Hyvinvointijakauneus,2020-11-30 20:27:11.527093507,2020-11-30,2020-12-02,2020-11-30,8.0,-10.22,17.26,0.0,162.0,           ,1.0,1.0,167.0
8335,Ruoka_paivittaistavarakauppa,2020-12-01 10:33:11.489361702,2020-12-01,2020-12-01,2020-12-01,8.0,-7.22,10.04,0.0,162.0,           ,1.0,1.0,99.0
8336,Tulot,2020-12-01 21:06:22.978723404,2020-12-01,2020-12-01,2020-12-01,8.0,0.67,10.71,0.0,551.0,           ,1.0,1.0,215.0
8337,Luokittelemattomat,2020-12-02 07:39:34.468085106,2020-12-02,2020-12-02,2020-12-02,8.0,-1.53,9.18,0.0,151.0,           ,1.0,1.0,34.0
8338,Liikkuminen,2020-12-02 18:12:45.957446808,2020-12-02,2020-12-02,2020-12-02,8.0,-2.58,6.6,0.0,151.0,           ,1.0,1.0,34.0
8339,Tulot,2020-12-03 04:45:57.446808510,2020-12-03,2020-12-03,2020-12-03,8.0,33.79,40.39,0.0,505.0,           ,1.0,1.0,203.0
8340,Vakuutukset,2020-12-03 15:19:08.936170212,2020-12-03,2020-12-03,2020-12-03,8.0,-11.95,28.44,0.0,106.0,SBANFIHH   ,0.0,0.0,17.0
8341,Luottojen_maksut,2020-12-04 01:52:20.425531914,2020-12-04,2020-12-04,2020-12-04,8.0,-4.72,23.72,0.0,151.0,           ,1.0,1.0,36.0
8342,Ruoka_paivittaistavarakauppa,2020-12-04 12:25:31.914893616,2020-12-04,2020-12-04,2020-12-04,8.0,-0.76,22.96,0.0,162.0,           ,1.0,1.0,117.0
8343,Kulttuuri_viihde,2020-12-04 22:58:43.404255318,2020-12-04,2020-12-04,2020-12-04,8.0,-7.28,15.68,0.0,162.0,           ,1.0,1.0,116.0
8344,Tulot,2020-12-05 09:31:54.893617020,2020-12-05,2020-12-05,2020-12-05,8.0,2.2,17.88,0.0,551.0,           ,1.0,1.0,211.0
8345,Muut,2020-12-05 20:05:06.382978722,2020-12-05,2020-12-05,2020-12-05,8.0,-14.44,3.44,0.0,105.0,OKOYFIHH   ,1.0,0.0,6.0
8346,Tulot,2020-12-06 11:24:15.319148934,2020-12-06,2020-12-06,2020-12-06,8.0,15.76,19.2,0.0,505.0,           ,1.0,1.0,203.0
8347,Ravintolat_kahvilat,2020-12-07 00:51:03.829787232,2020-12-07,2020-12-07,2020-12-07,8.0,-12.19,7.01,0.0,163.0,           ,1.0,1.0,190.0
8348,Tulot,2020-12-07 03:44:40.851063828,2020-12-07,2020-12-07,2020-12-07,8.0,138.03,145.04,0.0,551.0,           ,1.0,1.0,213.0
8349,Tulot,2020-12-07 06:38:17.872340424,2020-12-07,2020-12-07,2020-12-07,8.0,907.48,1052.52,710.0,506.0,           ,1.0,1.0,257.0
8350,Luottojen_maksut,2020-12-07 14:17:52.340425530,2020-12-07,2020-12-07,2020-12-07,8.0,-63.18,989.34,0.0,106.0,NDEAFIHH   ,0.0,0.0,17.0
8351,Shoppailu,2020-12-07 17:11:29.361702126,2020-12-07,2020-12-07,2020-12-07,8.0,-8.58,980.76,0.0,162.0,           ,1.0,1.0,179.0
8352,Ravintolat_kahvilat,2020-12-08 08:30:38.297872338,2020-12-08,2020-12-08,2020-12-08,8.0,-14.52,966.24,0.0,106.0,OKOYFIHH   ,0.0,0.0,14.0
8353,Hyvinvointi,2020-12-08 19:03:49.787234040,2020-12-08,2020-12-08,2020-12-08,8.0,-73.35,892.89,0.0,106.0,NDEAFIHH   ,0.0,0.0,30.0
8354,Matkailu,2020-12-08 21:57:26.808510636,2020-12-08,2020-12-08,2020-12-08,8.0,-6.57,886.32,0.0,151.0,           ,1.0,1.0,33.0
8355,Asuminen,2020-12-10 05:37:01.276595742,2020-12-10,2020-12-10,2020-12-10,8.0,-70.1,816.22,0.0,106.0,OKOYFIHH   ,0.0,0.0,11.0
8356,Tulot,2020-12-10 16:10:12.765957444,2020-12-10,2020-12-10,2020-12-10,8.0,114.28,930.5,0.0,505.0,           ,1.0,1.0,204.0
8357,Ravintolat_kahvilat,2020-12-10 20:56:10.212765954,2020-12-10,2020-12-10,2020-12-10,8.0,-1.69,928.81,0.0,162.0,           ,1.0,1.0,57.0
8358,Lapset,2020-12-11 02:43:24.255319146,2020-12-11,2020-12-11,2020-12-11,8.0,-149.65,779.16,0.0,106.0,NDEAFIHH   ,0.0,0.0,30.0
8359,Matkailu,2020-12-11 13:16:35.744680848,2020-12-11,2020-12-11,2020-12-10,8.0,-198.8,580.36,0.0,151.0,           ,1.0,1.0,36.0
8360,Tulot,2020-12-11 23:49:47.234042550,2020-12-11,2020-12-11,2020-12-11,8.0,44.43,624.79,0.0,551.0,           ,1.0,1.0,214.0
8361,Matkailu,2020-12-12 10:22:58.723404252,2020-12-12,2020-12-12,2020-12-12,8.0,-3.09,621.7,0.0,151.0,           ,1.0,1.0,33.0
8362,Luokittelemattomat,2020-12-12 12:15:19.148936166,2020-12-12,2020-12-12,2020-12-12,8.0,-335.65,286.05,0.0,151.0,           ,1.0,1.0,33.0
8363,Tulot,2020-12-14 04:35:44.680851060,2020-12-14,2020-12-14,2020-12-14,8.0,149.7,435.75,701.0,524.0,           ,1.0,1.0,231.0
8364,Asuminen,2020-12-14 15:08:56.170212762,2020-12-14,2020-12-14,2020-12-14,8.0,-120.47,315.28,0.0,106.0,OKOYFIHH   ,0.0,0.0,10.0
8365,Kulttuuri_viihde,2020-12-14 18:02:33.191489358,2020-12-14,2020-12-14,2020-12-14,8.0,-4.3,310.98,0.0,106.0,OKOYFIHH   ,0.0,0.0,20.0
8366,Tulot,2020-12-15 01:42:07.659574464,2020-12-15,2020-12-15,2020-12-15,8.0,159.59,470.57,0.0,505.0,           ,1.0,1.0,203.0
8367,Lapset,2020-12-15 22:48:30.638297868,2020-12-15,2020-12-15,2020-12-15,8.0,-8.5,462.07,0.0,106.0,OKOYFIHH   ,0.0,0.0,28.0
8368,Tulot,2020-12-16 07:29:21.702127656,2020-12-16,2020-12-16,2020-12-16,8.0,7.84,469.91,0.0,551.0,           ,1.0,1.0,211.0
8369,Luottojen_maksut,2020-12-16 09:21:42.127659570,2020-12-16,2020-12-17,2020-12-16,8.0,-114.79,355.12,0.0,106.0,OKOYFIHH   ,0.0,0.0,20.0
8370,Tulot,2020-12-16 19:54:53.617021272,2020-12-16,2020-12-16,2020-12-16,8.0,143.61,498.73,0.0,505.0,           ,1.0,1.0,204.0
8371,Tulot,2020-12-18 03:34:28.085106378,2020-12-18,2020-12-18,2020-12-18,8.0,27.84,526.57,0.0,551.0,           ,1.0,1.0,212.0
8372,Luokittelemattomat,2020-12-18 06:28:05.106382974,2020-12-18,2020-12-18,2020-12-18,8.0,-578.14,-51.57,0.0,151.0,           ,1.0,1.0,33.0
8373,Luokittelemattomat,2020-12-18 14:07:39.574468080,2020-12-18,2020-12-18,2020-12-18,8.0,-2.6,-54.17,0.0,151.0,           ,1.0,1.0,33.0
8374,Liikkuminen,2020-12-18 17:01:16.595744676,2020-12-18,2020-12-18,2020-12-18,8.0,-4.65,-58.82,0.0,151.0,           ,1.0,1.0,34.0
8375,Luokittelemattomat,2020-12-18 21:47:14.042553186,2020-12-18,2020-12-18,2020-12-18,8.0,-51.24,-110.06,0.0,106.0,OKOYFIHH   ,0.0,0.0,10.0
8376,Muut,2020-12-19 00:40:51.063829782,2020-12-19,2020-12-19,2020-12-19,8.0,-5.86,-115.92,0.0,105.0,OKOYFIHH   ,1.0,0.0,5.0
8377,Luottojen_maksut,2020-12-20 11:14:02.553191484,2020-12-20,2020-12-20,2020-12-20,8.0,-0.15,-116.07,0.0,151.0,           ,1.0,1.0,33.0
8378,Muut,2020-12-21 05:26:48.510638292,2020-12-21,2020-12-21,2020-12-21,8.0,-1.01,-117.08,0.0,162.0,           ,1.0,1.0,129.0
8379,Ruoka_paivittaistavarakauppa,2020-12-21 08:20:25.531914888,2020-12-21,2020-12-21,2020-12-21,8.0,-2.45,-119.53,0.0,162.0,           ,1.0,1.0,135.0
8380,Muut,2020-12-21 13:06:22.978723398,2020-12-21,2020-12-21,2020-12-21,8.0,-5.42,-124.95,0.0,106.0,OKOYFIHH   ,0.0,0.0,27.0
8381,Liikkuminen,2020-12-21 15:59:59.999999994,2020-12-21,2020-12-21,2020-12-21,8.0,-2.43,-127.38,0.0,162.0,           ,1.0,1.0,113.0
8382,Liikkuminen,2020-12-21 18:53:37.021276590,2020-12-21,2020-12-21,2020-12-21,8.0,-2.49,-129.87,0.0,162.0,           ,1.0,1.0,124.0
8383,Ruoka_paivittaistavarakauppa,2020-12-21 23:39:34.468085100,2020-12-21,2020-12-21,2020-12-21,8.0,-0.93,-130.8,0.0,162.0,           ,1.0,1.0,62.0
8384,Matkailu,2020-12-22 17:52:20.425531908,2020-12-22,2020-12-22,2020-12-22,8.0,-22.41,-153.21,0.0,162.0,           ,1.0,1.0,129.0
8385,Tulot,2020-12-23 02:33:11.489361696,2020-12-23,2020-12-23,2020-12-23,8.0,171.5,18.29,0.0,505.0,           ,1.0,1.0,204.0
8386,Ruoka_paivittaistavarakauppa,2020-12-23 10:12:45.957446802,2020-12-23,2020-12-23,2020-12-23,8.0,-4.98,13.31,0.0,162.0,           ,1.0,1.0,128.0
8387,Luottojen_maksut,2020-12-24 07:19:08.936170206,2020-12-24,2020-12-24,2020-12-24,8.0,-3.03,10.28,0.0,162.0,           ,1.0,1.0,180.0
8388,Kulttuuri_viihde,2020-12-24 20:45:57.446808504,2020-12-24,2020-12-24,2020-12-24,8.0,-5.7,4.58,0.0,162.0,           ,1.0,1.0,126.0
8389,Luokittelemattomat,2020-12-25 01:31:54.893617014,2020-12-25,2020-12-25,2020-12-25,8.0,-64.73,-60.15,0.0,106.0,SBANFIHH   ,1.0,0.0,25.0
8390,Tulot,2020-12-25 04:25:31.914893610,2020-12-25,2020-12-25,2020-12-25,8.0,8.44,-51.71,710.0,506.0,           ,1.0,1.0,255.0
8391,Hyvinvointijakauneus,2020-12-25 09:11:29.361702120,2020-12-25,2020-12-25,2020-12-25,8.0,-15.94,-67.65,0.0,106.0,OKOYFIHH   ,0.0,0.0,21.0
8392,Muut,2020-12-25 14:58:43.404255312,2020-12-25,2020-12-25,2020-12-25,8.0,-3.96,-71.61,0.0,105.0,OKOYFIHH   ,1.0,0.0,4.0
8393,Luokittelemattomat,2020-12-26 12:05:06.382978716,2020-12-26,2020-12-26,2020-12-26,8.0,-44.38,-115.99,0.0,106.0,NDEAFIHH   ,0.0,0.0,15.0
8394,Luottojen_maksut,2020-12-26 19:44:40.851063822,2020-12-26,2020-12-26,2020-12-26,8.0,-4.46,-120.45,0.0,106.0,OKOYFIHH   ,1.0,0.0,13.0
8395,Hyvinvointi,2020-12-26 22:38:17.872340418,2020-12-26,2020-12-26,2020-12-29,8.0,-21.1,-141.55,0.0,106.0,OKOYFIHH   ,0.0,0.0,28.0
8396,Luokittelemattomat,2020-12-28 03:24:15.319148928,2020-12-28,2020-12-28,2020-12-28,8.0,-10.56,-152.11,0.0,162.0,           ,1.0,1.0,103.0
8397,Tulot,2020-12-28 06:17:52.340425524,2020-12-28,2020-12-28,2020-12-28,8.0,454.51,302.4,0.0,505.0,           ,1.0,1.0,204.0
8398,Muut,2020-12-28 11:03:49.787234034,2020-12-28,2020-12-28,2020-12-28,8.0,-195.78,106.62,0.0,105.0,OKOYFIHH   ,1.0,0.0,5.0
8399,Liikkuminen,2020-12-28 16:51:03.829787226,2020-12-28,2020-12-28,2020-12-28,8.0,-22.27,84.35,0.0,162.0,           ,1.0,1.0,124.0
8400,Lapset,2020-12-29 21:37:01.276595736,2020-12-29,2020-12-29,2020-12-29,8.0,-13.43,70.92,0.0,106.0,OKOYFIHH   ,0.0,0.0,9.0
8401,Lemmikit,2020-12-31 00:30:38.297872332,2020-12-31,2020-12-31,2020-12-31,8.0,-30.73,40.19,0.0,106.0,OKOYFIHH   ,0.0,0.0,9.0
8402,Muut,2020-12-31 08:10:12.765957438,2020-12-31,2020-12-31,2020-12-31,8.0,-7.8,32.39,0.0,105.0,OKOYFIHH   ,1.0,0.0,7.0
8403,Asuminen,2020-12-31 13:57:26.808510630,2020-12-31,2020-12-31,2020-12-31,8.0,-105.31,-72.92,0.0,129.0,NDEAFIHH   ,0.0,0.0,31.0
8404,Muut,2020-12-31 18:43:24.255319140,2020-12-31,2021-01-01,2020-12-31,8.0,-27.57,-100.49,0.0,105.0,OKOYFIHH   ,1.0,0.0,5.0
8405,Liikkuminen,2019-01-01 00:00:00.000000000,2019-01-01,2019-01-01,2019-01-01,9.0,-6.53,161.04,0.0,162.0,           ,1.0,1.0,187.0
8406,Lemmikit,2019-01-02 21:05:27.272727272,2019-01-02,2019-01-02,2019-01-02,9.0,-17.34,143.7,0.0,162.0,           ,1.0,1.0,115.0
8407,Asuminen,2019-01-04 18:10:54.545454544,2019-01-04,2019-01-04,2019-01-04,9.0,-18.92,124.78,0.0,162.0,           ,1.0,1.0,113.0
8408,Tulot,2019-01-07 15:16:21.818181816,2019-01-07,2019-01-07,2019-01-07,9.0,23.49,148.27,710.0,588.0,           ,0.0,1.0,263.0
8409,Ruoka_paivittaistavarakauppa,2019-01-08 12:21:49.090909088,2019-01-08,2019-01-08,2019-01-08,9.0,-15.9,132.37,0.0,162.0,           ,1.0,1.0,142.0
8410,Terveys,2019-01-09 09:27:16.363636360,2019-01-09,2019-01-09,2019-01-09,9.0,-17.02,115.35,0.0,162.0,           ,1.0,1.0,154.0
8411,Ruoka_paivittaistavarakauppa,2019-01-11 06:32:43.636363632,2019-01-11,2019-01-11,2019-01-11,9.0,-4.52,110.83,0.0,162.0,           ,1.0,1.0,142.0
8412,Ruoka_paivittaistavarakauppa,2019-01-14 03:38:10.909090904,2019-01-14,2019-01-14,2019-01-14,9.0,-13.45,97.38,0.0,162.0,           ,1.0,1.0,149.0
8413,Ravintolat_kahvilat,2019-01-16 00:43:38.181818176,2019-01-16,2019-01-18,2019-01-16,9.0,-3.51,93.87,0.0,162.0,           ,1.0,1.0,146.0
8414,Ravintolat_kahvilat,2019-01-17 21:49:05.454545448,2019-01-17,2019-01-17,2019-01-17,9.0,-5.29,88.58,0.0,162.0,           ,1.0,1.0,140.0
8415,Ruoka_paivittaistavarakauppa,2019-01-21 15:59:59.999999992,2019-01-21,2019-01-21,2019-01-21,9.0,-5.48,83.1,0.0,162.0,           ,1.0,1.0,128.0
8416,Muut,2019-01-22 18:54:32.727272720,2019-01-22,2019-01-22,2019-01-22,9.0,-30.1,53.0,0.0,163.0,           ,1.0,1.0,204.0
8417,Muut,2019-01-23 13:05:27.272727264,2019-01-23,2019-01-23,2019-01-23,9.0,-13.81,39.19,0.0,163.0,           ,1.0,1.0,204.0
8418,Muut,2019-01-25 10:10:54.545454536,2019-01-25,2019-01-25,2019-01-25,9.0,-18.95,20.24,0.0,163.0,           ,1.0,1.0,204.0
8419,Tulot,2019-01-28 04:21:49.090909080,2019-01-28,2019-01-28,2019-01-28,9.0,49.21,69.45,0.0,505.0,           ,1.0,1.0,217.0
8420,Tulot,2019-01-28 07:16:21.818181808,2019-01-28,2019-01-28,2019-01-28,9.0,120.53,189.98,710.0,588.0,           ,0.0,1.0,262.0
8421,Ravintolat_kahvilat,2019-01-31 01:27:16.363636352,2019-01-31,2019-01-31,2019-01-31,9.0,-22.54,167.44,0.0,162.0,           ,1.0,1.0,95.0
8422,Ravintolat_kahvilat,2019-02-01 13:51:32.957746478,2019-02-01,2019-02-01,2019-02-01,9.0,-3.88,163.56,0.0,162.0,           ,1.0,1.0,157.0
8423,Luokittelemattomat,2019-02-01 18:55:46.478873239,2019-02-01,2019-02-01,2019-02-01,9.0,-13.98,149.58,0.0,162.0,           ,1.0,1.0,153.0
8424,Ravintolat_kahvilat,2019-02-04 03:43:05.915492956,2019-02-04,2019-02-04,2019-02-04,9.0,-11.54,138.04,0.0,162.0,           ,1.0,1.0,86.0
8425,Lapset,2019-02-04 08:47:19.436619717,2019-02-04,2019-02-04,2019-02-04,9.0,-3.25,134.79,0.0,162.0,           ,1.0,1.0,140.0
8426,Muut,2019-02-04 17:34:38.873239434,2019-02-04,2019-02-05,2019-02-04,9.0,-66.42,68.37,0.0,163.0,           ,1.0,1.0,205.0
8427,Tulot,2019-02-04 22:38:52.394366195,2019-02-04,2019-02-04,2019-02-04,9.0,173.47,241.84,710.0,588.0,           ,0.0,1.0,262.0
8428,Muut,2019-02-07 07:26:11.830985912,2019-02-07,2019-02-07,2019-02-07,9.0,-3.16,238.68,0.0,162.0,           ,1.0,1.0,112.0
8429,Ruoka_paivittaistavarakauppa,2019-02-07 12:30:25.352112673,2019-02-07,2019-02-07,2019-02-07,9.0,-9.05,229.63,0.0,162.0,           ,1.0,1.0,77.0
8430,Ruoka_paivittaistavarakauppa,2019-02-08 02:21:58.309859151,2019-02-08,2019-02-08,2019-02-08,9.0,-4.42,225.21,0.0,162.0,           ,1.0,1.0,100.0
8431,Ravintolat_kahvilat,2019-02-08 21:17:44.788732390,2019-02-08,2019-02-08,2019-02-08,9.0,-3.37,221.84,0.0,162.0,           ,1.0,1.0,168.0
8432,Ruoka_paivittaistavarakauppa,2019-02-11 11:09:17.746478868,2019-02-11,2019-02-11,2019-02-11,9.0,-17.84,204.0,0.0,162.0,           ,1.0,1.0,131.0
8433,Ruoka_paivittaistavarakauppa,2019-02-11 16:13:31.267605629,2019-02-11,2019-02-11,2019-02-11,9.0,-9.08,194.92,0.0,162.0,           ,1.0,1.0,112.0
8434,Saastot_sijoitukset,2019-02-12 06:05:04.225352107,2019-02-12,2019-02-12,2019-02-12,9.0,5.43,200.35,0.0,506.0,           ,1.0,1.0,219.0
8435,Muut,2019-02-12 14:52:23.661971824,2019-02-12,2019-02-12,2019-02-12,9.0,-21.62,178.73,0.0,106.0,OKOYFIHH   ,0.0,0.0,30.0
8436,Vakuutukset,2019-02-12 19:56:37.183098585,2019-02-12,2019-02-12,2019-02-12,9.0,-73.27,105.46,0.0,106.0,SBANFIHH   ,0.0,0.0,28.0
8437,Lapset,2019-02-12 23:39:43.098591541,2019-02-07,2019-02-12,2019-02-12,9.0,-76.06,29.4,0.0,162.0,           ,1.0,1.0,196.0
8438,Liikkuminen,2019-02-13 01:00:50.704225346,2019-02-13,2019-02-13,2019-02-13,9.0,-7.67,21.73,0.0,106.0,OKOYFIHH   ,1.0,0.0,17.0
8439,Asuminen,2019-02-15 04:43:56.619718302,2019-02-15,2019-02-15,2019-02-15,9.0,-7.64,14.09,0.0,162.0,           ,1.0,1.0,112.0
8440,Kulttuuri_viihde,2019-02-15 09:48:10.140845063,2019-02-15,2019-02-15,2019-02-15,9.0,-15.0,-0.91,0.0,106.0,OKOYFIHH   ,0.0,0.0,28.0
8441,Asuminen,2019-02-15 18:35:29.577464780,2019-02-15,2019-02-15,2019-02-15,9.0,-1.29,-2.2,0.0,162.0,           ,1.0,1.0,125.0
8442,Matkailu,2019-02-18 08:27:02.535211258,2019-02-18,2019-02-18,2019-02-18,9.0,-28.88,-31.08,0.0,163.0,           ,1.0,1.0,204.0
8443,Ruoka_paivittaistavarakauppa,2019-02-18 13:31:16.056338019,2019-02-18,2019-02-18,2019-02-18,9.0,-7.92,-39.0,0.0,162.0,           ,1.0,1.0,163.0
8444,Tulot,2019-02-19 03:22:49.014084497,2019-02-19,2019-02-19,2019-02-19,9.0,91.28,52.28,0.0,506.0,           ,1.0,1.0,219.0
8445,Muut,2019-02-19 17:14:21.971830975,2019-02-19,2019-02-19,2019-02-19,9.0,-38.9,13.38,0.0,163.0,           ,1.0,1.0,205.0
8446,Muut,2019-02-19 22:18:35.492957736,2019-02-19,2019-02-19,2019-02-19,9.0,-9.0,4.38,0.0,163.0,           ,1.0,1.0,205.0
8447,Ruoka_paivittaistavarakauppa,2019-02-22 02:01:41.408450692,2019-02-22,2019-02-22,2019-02-21,9.0,-10.06,-5.68,0.0,162.0,           ,1.0,1.0,60.0
8448,Ruoka_paivittaistavarakauppa,2019-02-22 07:05:54.929577453,2019-02-22,2019-02-22,2019-02-22,9.0,-3.68,-9.36,0.0,162.0,           ,1.0,1.0,184.0
8449,Lemmikit,2019-02-22 12:10:08.450704214,2019-02-22,2019-02-22,2019-02-22,9.0,-8.02,-17.38,0.0,162.0,           ,1.0,1.0,142.0
8450,Tulot,2019-02-25 15:53:14.366197170,2019-02-25,2019-02-25,2019-02-25,9.0,22.64,5.26,0.0,506.0,           ,1.0,1.0,219.0
8451,Tulot,2019-02-25 20:57:27.887323931,2019-02-25,2019-02-25,2019-02-25,9.0,0.55,5.81,710.0,588.0,           ,0.0,1.0,261.0
8452,Matkailu,2019-02-26 05:44:47.323943648,2019-02-26,2019-02-26,2019-02-26,9.0,-12.21,-6.4,0.0,164.0,           ,1.0,1.0,208.0
8453,Ruoka_paivittaistavarakauppa,2019-02-27 00:40:33.802816887,2019-02-27,2019-02-27,2019-02-27,9.0,-3.25,-9.65,0.0,162.0,           ,1.0,1.0,164.0
8454,Muut,2019-02-27 10:49:00.845070409,2019-02-27,2019-02-27,2019-02-27,9.0,-4.56,-14.21,0.0,163.0,           ,1.0,1.0,204.0
8455,Kulttuuri_viihde,2019-02-27 19:36:20.281690126,2019-02-27,2019-02-27,2019-02-27,9.0,-4.8,-19.01,0.0,162.0,           ,1.0,1.0,173.0
8456,Muut,2019-02-28 14:32:06.760563365,2019-02-28,2019-02-28,2019-02-28,9.0,-71.1,-90.11,0.0,163.0,           ,1.0,1.0,204.0
8457,Tulot,2019-03-01 19:19:28.831168831,2019-03-01,2019-03-01,2019-03-01,9.0,295.88,205.77,701.0,520.0,           ,1.0,1.0,232.0
8458,Muut,2019-03-02 14:38:57.662337662,2019-03-02,2019-03-02,2019-03-02,9.0,-22.73,183.04,0.0,163.0,           ,1.0,1.0,204.0
8459,Luokittelemattomat,2019-03-04 05:17:55.324675324,2019-03-04,2019-03-04,2019-03-04,9.0,-138.99,44.05,0.0,106.0,OKOYFIHH   ,1.0,0.0,25.0
8460,Asuminen,2019-03-04 09:58:26.493506493,2019-03-04,2019-03-04,2019-03-04,9.0,-29.4,14.65,706.0,129.0,DABAFIHH   ,0.0,0.0,242.0
8461,Ruoka_paivittaistavarakauppa,2019-03-05 00:37:24.155844155,2019-03-05,2019-03-05,2019-03-05,9.0,-9.65,5.0,0.0,162.0,           ,1.0,1.0,171.0
8462,Liikkuminen,2019-03-05 15:16:21.818181817,2019-03-05,2019-03-05,2019-03-05,9.0,-4.55,0.45,0.0,162.0,           ,1.0,1.0,151.0
8463,Ruoka_paivittaistavarakauppa,2019-03-05 19:56:52.987012986,2019-03-05,2019-03-05,2019-03-05,9.0,-3.15,-2.7,0.0,162.0,           ,1.0,1.0,120.0
8464,Liikkuminen,2019-03-07 10:35:50.649350648,2019-03-07,2019-03-07,2019-03-07,9.0,-22.44,-25.14,0.0,162.0,           ,1.0,1.0,140.0
8465,Ruoka_paivittaistavarakauppa,2019-03-08 01:14:48.311688310,2019-03-08,2019-03-08,2019-03-08,9.0,-13.74,-38.88,0.0,162.0,           ,1.0,1.0,160.0
8466,Ruoka_paivittaistavarakauppa,2019-03-08 05:55:19.480519479,2019-03-08,2019-03-08,2019-03-08,9.0,-4.77,-43.65,0.0,162.0,           ,1.0,1.0,58.0
8467,Muut,2019-03-09 15:53:45.974025972,2019-03-09,2019-03-09,2019-03-09,9.0,-19.18,-62.83,0.0,163.0,           ,1.0,1.0,204.0
8468,Ravintolat_kahvilat,2019-03-11 11:13:14.805194803,2019-03-11,2019-03-11,2019-03-08,9.0,-1.28,-64.11,0.0,162.0,           ,1.0,1.0,151.0
8469,Ruoka_paivittaistavarakauppa,2019-03-11 20:34:17.142857141,2019-03-11,2019-03-11,2019-03-11,9.0,-2.65,-66.76,0.0,162.0,           ,1.0,1.0,69.0
8470,Ruoka_paivittaistavarakauppa,2019-03-12 01:52:12.467532465,2019-03-12,2019-03-12,2019-03-12,9.0,-2.86,-69.62,0.0,162.0,           ,1.0,1.0,125.0
8471,Ruoka_paivittaistavarakauppa,2019-03-12 06:32:43.636363634,2019-03-12,2019-03-12,2019-03-12,9.0,-2.42,-72.04,0.0,162.0,           ,1.0,1.0,142.0
8472,Tulot,2019-03-13 21:11:41.298701296,2019-03-13,2019-03-13,2019-03-13,9.0,152.15,80.11,0.0,574.0,           ,1.0,1.0,225.0
8473,Liikkuminen,2019-03-14 16:31:10.129870127,2019-03-14,2019-03-14,2019-03-14,9.0,-33.94,46.17,0.0,162.0,           ,1.0,1.0,118.0
8474,Saastot_sijoitukset,2019-03-15 11:50:38.961038958,2019-03-15,2019-03-15,2019-03-15,9.0,-9.03,37.14,0.0,162.0,           ,1.0,1.0,105.0
8475,Muut,2019-03-18 02:29:36.623376620,2019-03-18,2019-03-19,2019-03-18,9.0,-44.25,-7.11,0.0,162.0,           ,1.0,1.0,174.0
8476,Lemmikit,2019-03-18 07:10:07.792207789,2019-03-18,2019-03-18,2019-03-18,9.0,-2.37,-9.48,0.0,162.0,           ,1.0,1.0,167.0
8477,Muut,2019-03-18 17:08:34.285714282,2019-03-18,2019-03-18,2019-03-18,9.0,-30.49,-39.97,0.0,163.0,           ,1.0,1.0,204.0
8478,Muut,2019-03-18 21:49:05.454545451,2019-03-18,2019-03-18,2019-03-18,9.0,-2.37,-42.34,0.0,162.0,           ,1.0,1.0,195.0
8479,Muut,2019-03-19 07:47:31.948051944,2019-03-19,2019-03-19,2019-03-18,9.0,-1.42,-43.76,0.0,103.0,           ,0.0,1.0,2.0
8480,Muut,2019-03-19 12:28:03.116883113,2019-03-19,2019-03-19,2019-03-19,9.0,-28.79,-72.55,0.0,163.0,           ,1.0,1.0,204.0
8481,Liikkuminen,2019-03-20 17:45:58.441558437,2019-03-20,2019-03-20,2019-03-20,9.0,-18.96,-91.51,0.0,162.0,           ,1.0,1.0,112.0
8482,Ruoka_paivittaistavarakauppa,2019-03-20 22:26:29.610389606,2019-03-20,2019-03-20,2019-03-20,9.0,-1.5,-93.01,0.0,162.0,           ,1.0,1.0,162.0
8483,Ruoka_paivittaistavarakauppa,2019-03-22 03:07:00.779220775,2019-03-22,2019-03-22,2019-03-22,9.0,-0.93,-93.94,0.0,162.0,           ,1.0,1.0,115.0
8484,Liikkuminen,2019-03-22 13:05:27.272727268,2019-03-22,2019-03-22,2019-03-22,9.0,-99.73,-193.67,0.0,162.0,           ,1.0,1.0,145.0
8485,Tulot,2019-03-25 03:44:24.935064930,2019-03-25,2019-03-26,2019-03-25,9.0,-3.06,-196.73,706.0,147.0,OKOYFIHH   ,0.0,0.0,253.0
8486,Ruoka_paivittaistavarakauppa,2019-03-25 23:03:53.766233761,2019-03-25,2019-03-25,2019-03-25,9.0,-2.12,-198.85,0.0,162.0,           ,1.0,1.0,153.0
8487,Ruoka_paivittaistavarakauppa,2019-03-26 08:24:56.103896099,2019-03-26,2019-03-26,2019-03-26,9.0,-0.84,-199.69,0.0,162.0,           ,1.0,1.0,69.0
8488,Luokittelemattomat,2019-03-26 18:23:22.597402592,2019-03-26,2019-03-26,2019-03-26,9.0,-0.9,-200.59,0.0,162.0,           ,1.0,1.0,120.0
8489,Ruoka_paivittaistavarakauppa,2019-03-27 13:42:51.428571423,2019-03-27,2019-03-28,2019-03-27,9.0,-2.78,-203.37,0.0,162.0,           ,1.0,1.0,93.0
8490,Ruoka_paivittaistavarakauppa,2019-03-28 04:21:49.090909085,2019-03-28,2019-03-28,2019-03-28,9.0,-21.61,-224.98,0.0,162.0,           ,1.0,1.0,57.0
8491,Ruoka_paivittaistavarakauppa,2019-03-28 19:00:46.753246747,2019-03-28,2019-03-28,2019-03-28,9.0,-4.84,-229.82,0.0,162.0,           ,1.0,1.0,111.0
8492,Liikkuminen,2019-03-28 23:41:17.922077916,2019-03-28,2019-03-28,2019-03-28,9.0,-11.75,-241.57,0.0,162.0,           ,1.0,1.0,67.0
8493,Lemmikit,2019-03-29 09:02:20.259740254,2019-03-29,2019-03-29,2019-03-28,9.0,-12.38,-253.95,0.0,162.0,           ,1.0,1.0,173.0
8494,Asuminen,2019-03-29 14:20:15.584415578,2019-03-29,2019-03-29,2019-03-29,9.0,-60.73,-314.68,706.0,147.0,NDEAFIHH   ,0.0,0.0,250.0
8495,Tulot,2019-04-01 18:13:40.253164556,2019-04-01,2019-04-01,2019-04-01,9.0,241.2,-73.48,701.0,520.0,           ,1.0,1.0,231.0
8496,Ruoka_paivittaistavarakauppa,2019-04-02 12:27:20.506329112,2019-04-02,2019-04-02,2019-04-02,9.0,-1.64,-75.12,0.0,162.0,           ,1.0,1.0,59.0
8497,Ruoka_paivittaistavarakauppa,2019-04-03 06:41:00.759493668,2019-04-03,2019-04-03,2019-04-03,9.0,-14.38,-89.5,0.0,162.0,           ,1.0,1.0,162.0
8498,Ruoka_paivittaistavarakauppa,2019-04-04 00:54:41.012658224,2019-04-04,2019-04-04,2019-04-04,9.0,-4.24,-93.74,0.0,162.0,           ,1.0,1.0,109.0
8499,Ruoka_paivittaistavarakauppa,2019-04-04 19:08:21.265822780,2019-04-04,2019-04-04,2019-04-04,9.0,-6.33,-100.07,0.0,162.0,           ,1.0,1.0,116.0
8500,Ruoka_paivittaistavarakauppa,2019-04-05 13:22:01.518987336,2019-04-05,2019-04-05,2019-04-05,9.0,-25.53,-125.6,0.0,162.0,           ,1.0,1.0,147.0
8501,Liikkuminen,2019-04-08 01:49:22.025316448,2019-04-08,2019-04-08,2019-04-08,9.0,-4.39,-129.99,0.0,162.0,           ,1.0,1.0,158.0
8502,Ruoka_paivittaistavarakauppa,2019-04-08 07:35:41.772151892,2019-04-08,2019-04-09,2019-04-08,9.0,-0.65,-130.64,0.0,162.0,           ,1.0,1.0,198.0
8503,Ruoka_paivittaistavarakauppa,2019-04-08 14:16:42.531645560,2019-04-08,2019-04-08,2019-04-08,9.0,-5.22,-135.86,0.0,162.0,           ,1.0,1.0,168.0
8504,Kulttuuri_viihde,2019-04-08 20:03:02.278481004,2019-04-08,2019-04-08,2019-04-08,9.0,-2.61,-138.47,0.0,162.0,           ,1.0,1.0,157.0
8505,Ruoka_paivittaistavarakauppa,2019-04-09 08:30:22.784810116,2019-04-09,2019-04-09,2019-04-09,9.0,-13.19,-151.66,0.0,162.0,           ,1.0,1.0,85.0
8506,Ruoka_paivittaistavarakauppa,2019-04-10 02:44:03.037974672,2019-04-10,2019-04-10,2019-04-10,9.0,-6.74,-158.4,0.0,162.0,           ,1.0,1.0,112.0
8507,Lapset,2019-04-11 20:57:43.291139228,2019-04-11,2019-04-11,2019-04-10,9.0,-4.98,-163.38,0.0,106.0,OKOYFIHH   ,1.0,0.0,40.0
8508,Ruoka_paivittaistavarakauppa,2019-04-11 21:52:24.303797452,2019-04-11,2019-04-11,2019-04-11,9.0,-4.98,-168.36,0.0,162.0,           ,1.0,1.0,69.0
8509,Kulttuuri_viihde,2019-04-12 03:38:44.050632896,2019-04-12,2019-04-12,2019-04-12,9.0,-1.15,-169.51,0.0,162.0,           ,1.0,1.0,133.0
8510,Lemmikit,2019-04-12 09:25:03.797468340,2019-04-12,2019-04-12,2019-04-12,9.0,-1.94,-171.45,0.0,162.0,           ,1.0,1.0,69.0
8511,Luokittelemattomat,2019-04-12 15:11:23.544303784,2019-04-12,2019-04-12,2019-04-12,9.0,-22.27,-193.72,0.0,106.0,OKOYFIHH   ,1.0,0.0,20.0
8512,Lapset,2019-04-15 10:19:44.810126564,2019-04-15,2019-04-15,2019-04-15,9.0,-14.37,-208.09,0.0,162.0,           ,1.0,1.0,202.0
8513,Ruoka_paivittaistavarakauppa,2019-04-15 16:06:04.556962008,2019-04-15,2019-04-15,2019-04-15,9.0,-1.22,-209.31,0.0,162.0,           ,1.0,1.0,57.0
8514,Luokittelemattomat,2019-04-15 17:00:45.569620232,2019-04-15,2019-04-15,2019-04-15,9.0,-275.6,-484.91,706.0,147.0,NDEAFIHH   ,0.0,0.0,251.0
8515,Ruoka_paivittaistavarakauppa,2019-04-16 04:33:25.063291120,2019-04-16,2019-04-16,2019-04-16,9.0,-8.95,-493.86,0.0,162.0,           ,1.0,1.0,145.0
8516,Ruoka_paivittaistavarakauppa,2019-04-16 22:47:05.316455676,2019-04-16,2019-04-16,2019-04-16,9.0,-1.52,-495.38,0.0,162.0,           ,1.0,1.0,158.0
8517,Luottojen_maksut,2019-04-17 11:14:25.822784788,2019-04-17,2019-04-17,2019-04-17,9.0,-8.26,-503.64,706.0,147.0,OKOYFIHH   ,0.0,0.0,252.0
8518,Muut,2019-04-18 23:41:46.329113900,2019-04-18,2019-04-18,2019-04-17,9.0,-1.29,-504.93,0.0,103.0,           ,0.0,1.0,2.0
8519,Asuminen,2019-04-19 05:28:06.075949344,2019-04-19,2019-04-19,2019-04-19,9.0,-99.26,-604.19,0.0,162.0,           ,1.0,1.0,58.0
8520,Liikkuminen,2019-04-22 06:22:47.088607568,2019-04-22,2019-04-22,2019-04-22,9.0,-24.29,-628.48,0.0,162.0,           ,1.0,1.0,106.0
8521,Muut,2019-04-22 17:55:26.582278456,2019-04-22,2019-04-22,2019-04-22,9.0,-12.05,-640.53,0.0,163.0,           ,1.0,1.0,204.0
8522,Ruoka_paivittaistavarakauppa,2019-04-23 00:36:27.341772124,2019-04-23,2019-04-23,2019-04-23,9.0,-2.21,-642.74,0.0,162.0,           ,1.0,1.0,76.0
8523,Ruoka_paivittaistavarakauppa,2019-04-23 12:09:06.835443012,2019-04-23,2019-04-23,2019-04-23,9.0,-4.62,-647.36,0.0,162.0,           ,1.0,1.0,117.0
8524,Luokittelemattomat,2019-04-23 18:50:07.594936680,2019-04-23,2019-04-23,2019-04-23,9.0,-15.63,-662.99,0.0,162.0,           ,1.0,1.0,156.0
8525,Shoppailu,2019-04-24 01:31:08.354430348,2019-04-24,2019-04-24,2019-04-24,9.0,-3.44,-666.43,0.0,162.0,           ,1.0,1.0,183.0
8526,Ruoka_paivittaistavarakauppa,2019-04-24 13:03:47.848101236,2019-04-24,2019-04-24,2019-04-24,9.0,-6.74,-673.17,0.0,162.0,           ,1.0,1.0,162.0
8527,Liikkuminen,2019-04-25 07:17:28.101265792,2019-04-25,2019-04-25,2019-04-25,9.0,-13.81,-686.98,0.0,162.0,           ,1.0,1.0,121.0
8528,Luokittelemattomat,2019-04-25 13:58:28.860759460,2019-04-25,2019-04-25,2019-04-25,9.0,-18.2,-705.18,0.0,162.0,           ,1.0,1.0,111.0
8529,Terveys,2019-04-25 19:44:48.607594904,2019-04-25,2019-04-25,2019-04-25,9.0,-2.88,-708.06,0.0,162.0,           ,1.0,1.0,184.0
8530,Ravintolat_kahvilat,2019-04-29 02:25:49.367088572,2019-04-29,2019-04-29,2019-04-29,9.0,-1.63,-709.69,0.0,162.0,           ,1.0,1.0,111.0
8531,Ravintolat_kahvilat,2019-04-29 08:12:09.113924016,2019-04-29,2019-04-29,2019-04-29,9.0,-0.38,-710.07,0.0,162.0,           ,1.0,1.0,148.0
8532,Luokittelemattomat,2019-04-29 14:53:09.873417684,2019-04-29,2019-04-29,2019-04-29,9.0,-1.49,-711.56,0.0,162.0,           ,1.0,1.0,118.0
8533,Ravintolat_kahvilat,2019-04-29 20:39:29.620253128,2019-04-29,2019-04-29,2019-04-29,9.0,-10.92,-722.48,0.0,162.0,           ,1.0,1.0,59.0
8534,Tulot,2019-05-01 08:42:06.315789473,2019-05-01,2019-05-03,2019-05-01,9.0,885.72,163.24,701.0,520.0,           ,1.0,1.0,231.0
8535,Ruoka_paivittaistavarakauppa,2019-05-01 17:24:12.631578946,2019-05-01,2019-05-01,2019-05-01,9.0,-42.62,120.62,0.0,162.0,           ,1.0,1.0,184.0
8536,Ruoka_paivittaistavarakauppa,2019-05-02 02:06:18.947368419,2019-05-02,2019-05-02,2019-05-02,9.0,-4.67,115.95,0.0,162.0,           ,1.0,1.0,100.0
8537,Liikkuminen,2019-05-02 10:48:25.263157892,2019-05-02,2019-05-02,2019-05-02,9.0,-2.8,113.15,0.0,162.0,           ,1.0,1.0,121.0
8538,Ravintolat_kahvilat,2019-05-02 15:01:03.157894730,2019-05-02,2019-05-02,2019-05-02,9.0,-8.17,104.98,0.0,162.0,           ,1.0,1.0,172.0
8539,Ruoka_paivittaistavarakauppa,2019-05-02 19:30:31.578947365,2019-05-02,2019-05-02,2019-05-02,9.0,-17.08,87.9,0.0,162.0,           ,1.0,1.0,90.0
8540,Ruoka_paivittaistavarakauppa,2019-05-03 04:12:37.894736838,2019-05-03,2019-05-03,2019-05-03,9.0,-6.09,81.81,0.0,162.0,           ,1.0,1.0,135.0
8541,Ruoka_paivittaistavarakauppa,2019-05-03 06:18:56.842105257,2019-05-03,2019-05-03,2019-05-03,9.0,-8.38,73.43,0.0,162.0,           ,1.0,1.0,181.0
8542,Asuminen,2019-05-03 12:54:44.210526311,2019-05-03,2019-05-03,2019-05-03,9.0,-15.35,58.08,0.0,106.0,OKOYFIHH   ,0.0,0.0,13.0
8543,Ruoka_paivittaistavarakauppa,2019-05-03 21:36:50.526315784,2019-05-03,2019-05-03,2019-05-03,9.0,-5.36,52.72,0.0,162.0,           ,1.0,1.0,158.0
8544,Ruoka_paivittaistavarakauppa,2019-05-06 01:49:28.421052622,2019-05-06,2019-05-06,2019-05-06,9.0,-6.81,45.91,0.0,162.0,           ,1.0,1.0,133.0
8545,Ruoka_paivittaistavarakauppa,2019-05-06 08:25:15.789473676,2019-05-06,2019-05-06,2019-05-06,9.0,-5.43,40.48,0.0,162.0,           ,1.0,1.0,111.0
8546,Ravintolat_kahvilat,2019-05-06 10:31:34.736842095,2019-05-06,2019-05-06,2019-05-06,9.0,-4.55,35.93,0.0,162.0,           ,1.0,1.0,166.0
8547,Hyvinvointi,2019-05-06 17:07:22.105263149,2019-05-06,2019-05-06,2019-05-06,9.0,-0.86,35.07,0.0,162.0,           ,1.0,1.0,113.0
8548,Muut,2019-05-06 19:13:41.052631568,2019-05-06,2019-05-06,2019-05-06,9.0,-11.16,23.91,0.0,162.0,           ,1.0,1.0,135.0
8549,Ravintolat_kahvilat,2019-05-06 23:43:09.473684203,2019-05-06,2019-05-06,2019-05-06,9.0,-8.38,15.53,0.0,162.0,           ,1.0,1.0,196.0
8550,Ruoka_paivittaistavarakauppa,2019-05-07 03:55:47.368421041,2019-05-07,2019-05-07,2019-05-07,9.0,-13.85,1.68,0.0,162.0,           ,1.0,1.0,129.0
8551,Ruoka_paivittaistavarakauppa,2019-05-07 06:02:06.315789460,2019-05-07,2019-05-07,2019-05-07,9.0,-19.53,-17.85,0.0,162.0,           ,1.0,1.0,154.0
8552,Ravintolat_kahvilat,2019-05-07 12:37:53.684210514,2019-05-07,2019-05-07,2019-05-07,9.0,-2.48,-20.33,0.0,162.0,           ,1.0,1.0,151.0
8553,Ruoka_paivittaistavarakauppa,2019-05-07 21:19:59.999999987,2019-05-07,2019-05-07,2019-05-07,9.0,-12.22,-32.55,0.0,162.0,           ,1.0,1.0,139.0
8554,Ravintolat_kahvilat,2019-05-08 14:44:12.631578933,2019-05-08,2019-05-08,2019-05-08,9.0,-6.97,-39.52,0.0,162.0,           ,1.0,1.0,111.0
8555,Ruoka_paivittaistavarakauppa,2019-05-09 08:08:25.263157879,2019-05-09,2019-05-09,2019-05-09,9.0,-14.92,-54.44,0.0,162.0,           ,1.0,1.0,112.0
8556,Luottojen_maksut,2019-05-09 16:50:31.578947352,2019-05-09,2019-05-10,2019-05-09,9.0,-3.88,-58.32,0.0,162.0,           ,1.0,1.0,104.0
8557,Ruoka_paivittaistavarakauppa,2019-05-10 01:32:37.894736825,2019-05-10,2019-05-10,2019-05-09,9.0,-4.05,-62.37,0.0,162.0,           ,1.0,1.0,112.0
8558,Ruoka_paivittaistavarakauppa,2019-05-10 03:38:56.842105244,2019-05-10,2019-05-10,2019-05-10,9.0,-8.78,-71.15,0.0,162.0,           ,1.0,1.0,140.0
8559,Lemmikit,2019-05-10 10:14:44.210526298,2019-05-10,2019-05-10,2019-05-10,9.0,-26.11,-97.26,0.0,162.0,           ,1.0,1.0,140.0
8560,Ruoka_paivittaistavarakauppa,2019-05-10 12:21:03.157894717,2019-05-10,2019-05-10,2019-05-10,9.0,-2.73,-99.99,0.0,162.0,           ,1.0,1.0,135.0
8561,Ruoka_paivittaistavarakauppa,2019-05-10 14:27:22.105263136,2019-05-10,2019-05-10,2019-05-10,9.0,-2.26,-102.25,0.0,162.0,           ,1.0,1.0,151.0
8562,Ruoka_paivittaistavarakauppa,2019-05-10 18:56:50.526315771,2019-05-10,2019-05-10,2019-05-10,9.0,-6.0,-108.25,0.0,162.0,           ,1.0,1.0,148.0
8563,Ruoka_paivittaistavarakauppa,2019-05-10 23:26:18.947368406,2019-05-10,2019-05-10,2019-05-10,9.0,-65.37,-173.62,0.0,162.0,           ,1.0,1.0,58.0
8564,Lemmikit,2019-05-13 05:45:15.789473663,2019-05-13,2019-05-13,2019-05-13,9.0,-23.07,-196.69,0.0,162.0,           ,1.0,1.0,118.0
8565,Ruoka_paivittaistavarakauppa,2019-05-13 07:51:34.736842082,2019-05-09,2019-05-13,2019-05-13,9.0,-0.42,-197.11,0.0,162.0,           ,1.0,1.0,167.0
8566,Ruoka_paivittaistavarakauppa,2019-05-13 09:57:53.684210501,2019-05-13,2019-05-13,2019-05-13,9.0,-1.55,-198.66,0.0,162.0,           ,1.0,1.0,105.0
8567,Liikkuminen,2019-05-13 16:33:41.052631555,2019-05-13,2019-05-13,2019-05-13,9.0,-36.73,-235.39,0.0,162.0,           ,1.0,1.0,171.0
8568,Ruoka_paivittaistavarakauppa,2019-05-13 21:03:09.473684190,2019-05-13,2019-05-13,2019-05-13,9.0,-11.57,-246.96,0.0,162.0,           ,1.0,1.0,62.0
8569,Ruoka_paivittaistavarakauppa,2019-05-13 23:09:28.421052609,2019-05-13,2019-05-13,2019-05-13,9.0,-7.07,-254.03,0.0,162.0,           ,1.0,1.0,149.0
8570,Lemmikit,2019-05-14 01:15:47.368421028,2019-05-14,2019-05-14,2019-05-14,9.0,-2.15,-256.18,0.0,162.0,           ,1.0,1.0,90.0
8571,Ravintolat_kahvilat,2019-05-14 14:10:31.578947339,2019-05-14,2019-05-14,2019-05-14,9.0,-7.04,-263.22,0.0,162.0,           ,1.0,1.0,112.0
8572,Ruoka_paivittaistavarakauppa,2019-05-14 18:39:59.999999974,2019-05-14,2019-05-14,2019-05-14,9.0,-6.26,-269.48,0.0,162.0,           ,1.0,1.0,181.0
8573,Ruoka_paivittaistavarakauppa,2019-05-15 03:22:06.315789447,2019-05-15,2019-05-15,2019-05-15,9.0,-1.03,-270.51,0.0,162.0,           ,1.0,1.0,173.0
8574,Lapset,2019-05-15 12:04:12.631578920,2019-05-15,2019-05-15,2019-05-15,9.0,-3.26,-273.77,0.0,162.0,           ,1.0,1.0,139.0
8575,Liikkuminen,2019-05-17 05:28:25.263157866,2019-05-17,2019-05-17,2019-05-17,9.0,-3.93,-277.7,0.0,162.0,           ,1.0,1.0,188.0
8576,Liikkuminen,2019-05-17 07:34:44.210526285,2019-05-17,2019-05-17,2019-05-17,9.0,-4.38,-282.08,0.0,162.0,           ,1.0,1.0,147.0
8577,Ruoka_paivittaistavarakauppa,2019-05-17 09:41:03.157894704,2019-05-17,2019-05-17,2019-05-17,9.0,-1.94,-284.02,0.0,162.0,           ,1.0,1.0,77.0
8578,Ruoka_paivittaistavarakauppa,2019-05-17 16:16:50.526315758,2019-05-17,2019-05-17,2019-05-17,9.0,-21.01,-305.03,0.0,162.0,           ,1.0,1.0,146.0
8579,Ruoka_paivittaistavarakauppa,2019-05-17 18:23:09.473684177,2019-05-17,2019-05-17,2019-05-17,9.0,-1.65,-306.68,0.0,162.0,           ,1.0,1.0,127.0
8580,Ravintolat_kahvilat,2019-05-17 20:46:18.947368393,2019-05-17,2019-05-17,2019-05-17,9.0,-4.4,-311.08,0.0,162.0,           ,1.0,1.0,184.0
8581,Asuminen,2019-05-17 22:52:37.894736812,2019-05-17,2019-05-17,2019-05-17,9.0,-0.99,-312.07,0.0,162.0,           ,1.0,1.0,120.0
8582,Ruoka_paivittaistavarakauppa,2019-05-20 00:42:06.315789434,2019-05-20,2019-05-20,2019-05-20,9.0,-32.75,-344.82,0.0,162.0,           ,1.0,1.0,95.0
8583,Matkailu,2019-05-20 00:58:56.842105231,2019-05-20,2019-05-20,2019-05-20,9.0,-6.51,-351.33,0.0,162.0,           ,1.0,1.0,95.0
8584,Ravintolat_kahvilat,2019-05-20 03:05:15.789473650,2019-05-20,2019-05-20,2019-05-20,9.0,-1.96,-353.29,0.0,162.0,           ,1.0,1.0,138.0
8585,Matkailu,2019-05-20 05:11:34.736842069,2019-05-20,2019-05-20,2019-05-20,9.0,-2.95,-356.24,0.0,162.0,           ,1.0,1.0,184.0
8586,Tulot,2019-05-20 11:47:22.105263123,2019-05-20,2019-05-20,2019-05-20,9.0,466.97,110.73,710.0,588.0,           ,0.0,1.0,263.0
8587,Lapset,2019-05-20 13:53:41.052631542,2019-05-20,2019-05-20,2019-05-20,9.0,-19.84,90.89,0.0,106.0,OKOYFIHH   ,0.0,0.0,30.0
8588,Ruoka_paivittaistavarakauppa,2019-05-20 20:29:28.421052596,2019-05-20,2019-05-22,2019-05-20,9.0,-7.27,83.62,0.0,162.0,           ,1.0,1.0,118.0
8589,Asuminen,2019-05-20 22:35:47.368421015,2019-05-20,2019-05-20,2019-05-20,9.0,-18.08,65.54,0.0,162.0,           ,1.0,1.0,129.0
8590,Ravintolat_kahvilat,2019-05-21 07:17:53.684210488,2019-05-21,2019-05-21,2019-05-21,9.0,-2.81,62.73,0.0,162.0,           ,1.0,1.0,162.0
8591,Luokittelemattomat,2019-05-21 09:24:12.631578907,2019-05-21,2019-05-21,2019-05-21,9.0,-45.11,17.62,0.0,162.0,           ,1.0,1.0,137.0
8592,Liikkuminen,2019-05-21 15:59:59.999999961,2019-05-21,2019-05-23,2019-05-21,9.0,-7.27,10.35,0.0,162.0,           ,1.0,1.0,156.0
8593,Ruoka_paivittaistavarakauppa,2019-05-22 02:48:25.263157853,2019-05-22,2019-05-22,2019-05-22,9.0,-14.01,-3.66,0.0,162.0,           ,1.0,1.0,117.0
8594,Liikkuminen,2019-05-23 04:54:44.210526272,2019-05-23,2019-05-23,2019-05-23,9.0,-5.78,-9.44,0.0,162.0,           ,1.0,1.0,69.0
8595,Ruoka_paivittaistavarakauppa,2019-05-23 13:36:50.526315745,2019-05-23,2019-05-23,2019-05-23,9.0,-3.49,-12.93,0.0,162.0,           ,1.0,1.0,163.0
8596,Liikkuminen,2019-05-23 18:06:18.947368380,2019-05-23,2019-05-23,2019-05-23,9.0,-10.44,-23.37,0.0,162.0,           ,1.0,1.0,117.0
8597,Matkailu,2019-05-24 07:01:03.157894691,2019-05-24,2019-05-24,2019-05-24,9.0,-4.38,-27.75,0.0,162.0,           ,1.0,1.0,184.0
8598,Muut,2019-05-24 11:30:31.578947326,2019-05-24,2019-05-24,2019-05-24,9.0,-7.65,-35.4,0.0,162.0,           ,1.0,1.0,137.0
8599,Lapset,2019-05-24 15:43:09.473684164,2019-05-24,2019-05-28,2019-05-24,9.0,-4.06,-39.46,0.0,162.0,           ,1.0,1.0,121.0
8600,Ravintolat_kahvilat,2019-05-24 20:12:37.894736799,2019-05-24,2019-05-24,2019-05-24,9.0,-13.59,-53.05,0.0,162.0,           ,1.0,1.0,105.0
8601,Muut,2019-05-24 22:18:56.842105218,2019-05-24,2019-05-24,2019-05-24,9.0,-29.41,-82.46,0.0,163.0,           ,1.0,1.0,204.0
8602,Liikkuminen,2019-05-27 00:25:15.789473637,2019-05-27,2019-05-27,2019-05-27,9.0,-1.33,-83.79,0.0,162.0,           ,1.0,1.0,105.0
8603,Ruoka_paivittaistavarakauppa,2019-05-27 02:31:34.736842056,2019-05-27,2019-05-27,2019-05-27,9.0,-23.26,-107.05,0.0,162.0,           ,1.0,1.0,113.0
8604,Ruoka_paivittaistavarakauppa,2019-05-27 15:26:18.947368367,2019-05-27,2019-05-27,2019-05-27,9.0,-2.1,-109.15,0.0,162.0,           ,1.0,1.0,91.0
8605,Lemmikit,2019-05-27 19:55:47.368421002,2019-05-27,2019-05-27,2019-05-27,9.0,-4.69,-113.84,0.0,162.0,           ,1.0,1.0,89.0
8606,Ruoka_paivittaistavarakauppa,2019-05-27 22:02:06.315789421,2019-05-27,2019-05-27,2019-05-27,9.0,-82.23,-196.07,0.0,162.0,           ,1.0,1.0,70.0
8607,Ruoka_paivittaistavarakauppa,2019-05-28 04:37:53.684210475,2019-05-28,2019-05-28,2019-05-28,9.0,-10.57,-206.64,0.0,162.0,           ,1.0,1.0,172.0
8608,Ruoka_paivittaistavarakauppa,2019-05-28 06:44:12.631578894,2019-05-28,2019-05-28,2019-05-28,9.0,-1.18,-207.82,0.0,162.0,           ,1.0,1.0,112.0
8609,Ravintolat_kahvilat,2019-05-28 09:07:22.105263110,2019-05-28,2019-05-28,2019-05-28,9.0,-3.29,-211.11,0.0,162.0,           ,1.0,1.0,145.0
8610,Tulot,2019-05-28 11:13:41.052631529,2019-05-28,2019-05-28,2019-05-28,9.0,122.06,-89.05,701.0,506.0,           ,1.0,1.0,229.0
8611,Saastot_sijoitukset,2019-05-28 13:19:59.999999948,2019-05-28,2019-05-28,2019-05-28,9.0,-4.62,-93.67,0.0,162.0,           ,1.0,1.0,128.0
8612,Ruoka_paivittaistavarakauppa,2019-05-28 17:49:28.421052583,2019-05-28,2019-05-28,2019-05-28,9.0,-2.4,-96.07,0.0,162.0,           ,1.0,1.0,149.0
8613,Ruoka_paivittaistavarakauppa,2019-05-29 00:08:25.263157840,2019-05-29,2019-05-29,2019-05-29,9.0,-0.8,-96.87,0.0,162.0,           ,1.0,1.0,58.0
8614,Ruoka_paivittaistavarakauppa,2019-05-30 08:50:31.578947313,2019-05-30,2019-05-30,2019-05-30,9.0,-4.3,-101.17,0.0,162.0,           ,1.0,1.0,127.0
8615,Kulttuuri_viihde,2019-05-30 17:32:37.894736786,2019-05-30,2019-05-30,2019-05-30,9.0,-8.73,-109.9,0.0,162.0,           ,1.0,1.0,118.0
8616,Vakuutukset,2019-05-30 19:38:56.842105205,2019-05-30,2019-05-30,2019-05-30,9.0,-17.26,-127.16,0.0,106.0,OKOYFIHH   ,0.0,0.0,35.0
8617,Tulot,2019-05-31 02:14:44.210526259,2019-05-31,2019-05-31,2019-05-31,9.0,90.53,-36.63,701.0,506.0,           ,1.0,1.0,227.0
8618,Ruoka_paivittaistavarakauppa,2019-05-31 10:56:50.526315732,2019-05-31,2019-05-31,2019-05-31,9.0,-6.42,-43.05,0.0,162.0,           ,1.0,1.0,100.0
8619,Luokittelemattomat,2019-06-02 14:39:27.785234896,2019-06-02,2019-06-02,2019-06-02,9.0,-37.91,-80.96,0.0,106.0,OKOYFIHH   ,0.0,0.0,13.0
8620,Luokittelemattomat,2019-06-03 00:19:19.731543620,2019-06-03,2019-06-03,2019-06-03,9.0,-14.79,-95.75,0.0,106.0,NDEAFIHH   ,1.0,0.0,17.0
8621,Ruoka_paivittaistavarakauppa,2019-06-03 04:59:35.838926172,2019-06-03,2019-06-03,2019-06-03,9.0,-0.4,-96.15,0.0,162.0,           ,1.0,1.0,139.0
8622,Ravintolat_kahvilat,2019-06-03 09:39:51.946308724,2019-06-03,2019-06-03,2019-06-03,9.0,-5.79,-101.94,0.0,162.0,           ,1.0,1.0,140.0
8623,Lemmikit,2019-06-03 09:59:11.677852344,2019-06-03,2019-06-03,2019-06-03,9.0,-7.12,-109.06,0.0,106.0,OKOYFIHH   ,1.0,0.0,44.0
8624,Ruoka_paivittaistavarakauppa,2019-06-03 19:19:43.892617448,2019-06-03,2019-06-03,2019-06-03,9.0,-3.23,-112.29,0.0,162.0,           ,1.0,1.0,128.0
8625,Asuminen,2019-06-03 19:39:03.624161068,2019-06-03,2019-06-03,2019-06-03,9.0,-34.28,-146.57,0.0,106.0,OKOYFIHH   ,0.0,0.0,20.0
8626,Hyvinvointijakauneus,2019-06-04 05:18:55.570469792,2019-06-04,2019-06-04,2019-06-04,9.0,-32.68,-179.25,0.0,106.0,OKOYFIHH   ,0.0,0.0,41.0
8627,Hyvinvointijakauneus,2019-06-04 05:38:15.302013412,2019-06-04,2019-06-04,2019-06-04,9.0,-3.74,-182.99,0.0,162.0,           ,1.0,1.0,137.0
8628,Lapset,2019-06-04 14:58:47.516778516,2019-06-04,2019-06-04,2019-06-04,9.0,-25.34,-208.33,0.0,106.0,OKOYFIHH   ,0.0,0.0,46.0
8629,Ruoka_paivittaistavarakauppa,2019-06-04 19:58:23.355704688,2019-06-04,2019-06-04,2019-06-04,9.0,-2.95,-211.28,0.0,162.0,           ,1.0,1.0,164.0
8630,Ruoka_paivittaistavarakauppa,2019-06-05 00:38:39.463087240,2019-06-05,2019-06-05,2019-06-05,9.0,-10.56,-221.84,0.0,162.0,           ,1.0,1.0,117.0
8631,Saastot_sijoitukset,2019-06-05 10:18:31.409395964,2019-06-05,2019-06-05,2019-06-05,9.0,-2.67,-224.51,0.0,162.0,           ,1.0,1.0,151.0
8632,Tulot,2019-06-05 15:18:07.248322136,2019-06-05,2019-06-05,2019-06-05,9.0,687.27,462.76,701.0,506.0,           ,1.0,1.0,227.0
8633,Saastot_sijoitukset,2019-06-06 15:37:26.979865756,2019-06-06,2019-06-06,2019-06-06,9.0,-12.55,450.21,0.0,162.0,           ,1.0,1.0,176.0
8634,Luokittelemattomat,2019-06-07 00:57:59.194630860,2019-06-07,2019-06-07,2019-06-07,9.0,-38.39,411.82,0.0,106.0,OKOYFIHH   ,1.0,0.0,43.0
8635,Ruoka_paivittaistavarakauppa,2019-06-07 05:57:35.033557032,2019-06-07,2019-06-07,2019-06-07,9.0,-51.16,360.66,0.0,162.0,           ,1.0,1.0,91.0
8636,Ruoka_paivittaistavarakauppa,2019-06-07 10:37:51.140939584,2019-06-07,2019-06-07,2019-06-07,9.0,-26.49,334.17,0.0,162.0,           ,1.0,1.0,143.0
8637,Ravintolat_kahvilat,2019-06-07 20:17:43.087248308,2019-06-07,2019-06-07,2019-06-07,9.0,-4.5,329.67,0.0,162.0,           ,1.0,1.0,131.0
8638,Muut,2019-06-08 01:17:18.926174480,2019-06-08,2019-06-08,2019-06-08,9.0,-73.07,256.6,0.0,163.0,           ,1.0,1.0,204.0
8639,Ruoka_paivittaistavarakauppa,2019-06-10 06:16:54.765100652,2019-06-10,2019-06-10,2019-06-10,9.0,-11.29,245.31,0.0,162.0,           ,1.0,1.0,111.0
8640,Liikkuminen,2019-06-10 10:57:10.872483204,2019-06-10,2019-06-10,2019-06-10,9.0,-53.28,192.03,0.0,162.0,           ,1.0,1.0,82.0
8641,Ruoka_paivittaistavarakauppa,2019-06-10 11:35:50.335570444,2019-06-10,2019-06-10,2019-06-10,9.0,-9.92,182.11,0.0,162.0,           ,1.0,1.0,138.0
8642,Ruoka_paivittaistavarakauppa,2019-06-10 15:56:46.711409376,2019-06-10,2019-06-10,2019-06-10,9.0,-16.15,165.96,0.0,162.0,           ,1.0,1.0,143.0
8643,Lapset,2019-06-10 20:37:02.818791928,2019-06-10,2019-06-10,2019-06-10,9.0,-9.23,156.73,0.0,162.0,           ,1.0,1.0,125.0
8644,Ruoka_paivittaistavarakauppa,2019-06-11 01:36:38.657718100,2019-06-11,2019-06-11,2019-06-11,9.0,-1.88,154.85,0.0,162.0,           ,1.0,1.0,59.0
8645,Liikkuminen,2019-06-11 11:16:30.604026824,2019-06-11,2019-06-11,2019-06-11,9.0,-60.74,94.11,0.0,106.0,NDEAFIHH   ,1.0,0.0,32.0
8646,Liikkuminen,2019-06-11 20:56:22.550335548,2019-06-11,2019-06-11,2019-06-11,9.0,-29.4,64.71,0.0,162.0,           ,1.0,1.0,147.0
8647,Muut,2019-06-12 06:36:14.496644272,2019-06-12,2019-06-14,2019-06-12,9.0,-40.24,24.47,0.0,163.0,           ,1.0,1.0,205.0
8648,Ruoka_paivittaistavarakauppa,2019-06-12 16:16:06.442952996,2019-06-12,2019-06-12,2019-06-12,9.0,-24.91,-0.44,0.0,162.0,           ,1.0,1.0,201.0
8649,Tulot,2019-06-13 01:55:58.389261720,2019-06-13,2019-06-13,2019-06-13,9.0,53.25,52.81,710.0,506.0,           ,1.0,1.0,255.0
8650,Ruoka_paivittaistavarakauppa,2019-06-14 06:55:34.228187892,2019-06-14,2019-06-14,2019-06-14,9.0,-11.88,40.93,0.0,162.0,           ,1.0,1.0,125.0
8651,Ravintolat_kahvilat,2019-06-14 11:55:10.067114064,2019-06-14,2019-06-14,2019-06-14,9.0,-22.69,18.24,0.0,162.0,           ,1.0,1.0,58.0
8652,Liikkuminen,2019-06-14 16:35:26.174496616,2019-06-14,2019-06-14,2019-06-14,9.0,-15.24,3.0,0.0,106.0,OKOYFIHH   ,1.0,0.0,42.0
8653,Ruoka_paivittaistavarakauppa,2019-06-14 21:15:42.281879168,2019-06-14,2019-06-14,2019-06-14,9.0,-4.02,-1.02,0.0,162.0,           ,1.0,1.0,134.0
8654,Ravintolat_kahvilat,2019-06-14 21:35:02.013422788,2019-06-14,2019-06-14,2019-06-14,9.0,-8.24,-9.26,0.0,162.0,           ,1.0,1.0,162.0
8655,Muut,2019-06-15 02:15:18.120805340,2019-06-15,2019-06-15,2019-06-15,9.0,-49.81,-59.07,0.0,163.0,           ,1.0,1.0,206.0
8656,Liikkuminen,2019-06-17 02:34:37.852348960,2019-06-17,2019-06-17,2019-06-17,9.0,-5.0,-64.07,0.0,162.0,           ,1.0,1.0,142.0
8657,Luottojen_maksut,2019-06-17 02:53:57.583892580,2019-06-17,2019-06-17,2019-06-17,9.0,-58.53,-122.6,0.0,172.0,           ,1.0,1.0,210.0
8658,Lemmikit,2019-06-17 07:14:53.959731512,2019-06-17,2019-06-17,2019-06-17,9.0,-4.99,-127.59,0.0,162.0,           ,1.0,1.0,163.0
8659,Luokittelemattomat,2019-06-17 12:14:29.798657684,2019-06-17,2019-06-20,2019-06-17,9.0,-5.29,-132.88,0.0,162.0,           ,1.0,1.0,112.0
8660,Terveys,2019-06-17 12:33:49.530201304,2019-06-17,2019-06-17,2019-06-17,9.0,-66.08,-198.96,706.0,129.0,DABAFIHH   ,0.0,0.0,242.0
8661,Ruoka_paivittaistavarakauppa,2019-06-17 16:54:45.906040236,2019-06-17,2019-06-17,2019-06-17,9.0,-6.03,-204.99,0.0,162.0,           ,1.0,1.0,107.0
8662,Lapset,2019-06-17 21:54:21.744966408,2019-06-17,2019-06-17,2019-06-17,9.0,-3.04,-208.03,0.0,162.0,           ,1.0,1.0,120.0
8663,Ruoka_paivittaistavarakauppa,2019-06-18 07:34:13.691275132,2019-06-18,2019-06-18,2019-06-18,9.0,-4.53,-212.56,0.0,162.0,           ,1.0,1.0,149.0
8664,Muut,2019-06-18 17:14:05.637583856,2019-06-18,2019-06-18,2019-06-18,9.0,-1.77,-214.33,0.0,192.0,           ,0.0,1.0,211.0
8665,Tulot,2019-06-18 22:13:41.476510028,2019-06-18,2019-06-18,2019-06-18,9.0,76.6,-137.73,701.0,506.0,           ,1.0,1.0,228.0
8666,Hyvinvointijakauneus,2019-06-19 03:13:17.315436200,2019-06-19,2019-06-19,2019-06-19,9.0,-16.01,-153.74,706.0,129.0,OKOYFIHH   ,0.0,0.0,243.0
8667,Ruoka_paivittaistavarakauppa,2019-06-20 07:53:33.422818752,2019-06-20,2019-06-20,2019-06-20,9.0,-4.82,-158.56,0.0,162.0,           ,1.0,1.0,125.0
8668,Ruoka_paivittaistavarakauppa,2019-06-20 08:12:53.154362372,2019-06-20,2019-06-20,2019-06-20,9.0,-5.73,-164.29,0.0,162.0,           ,1.0,1.0,143.0
8669,Luokittelemattomat,2019-06-20 12:53:09.261744924,2019-06-20,2019-06-20,2019-06-20,9.0,-4.18,-168.47,0.0,162.0,           ,1.0,1.0,59.0
8670,Matkailu,2019-06-20 17:33:25.369127476,2019-06-20,2019-06-20,2019-06-20,9.0,-6.3,-174.77,0.0,162.0,           ,1.0,1.0,169.0
8671,Hyvinvointijakauneus,2019-06-20 22:33:01.208053648,2019-06-20,2019-06-20,2019-06-20,9.0,-2.28,-177.05,0.0,162.0,           ,1.0,1.0,113.0
8672,Ruoka_paivittaistavarakauppa,2019-06-24 03:32:37.046979820,2019-06-24,2019-06-24,2019-06-24,9.0,-4.4,-181.45,0.0,162.0,           ,1.0,1.0,165.0
8673,Ruoka_paivittaistavarakauppa,2019-06-24 03:51:56.778523440,2019-06-24,2019-06-24,2019-06-24,9.0,-2.42,-183.87,0.0,162.0,           ,1.0,1.0,196.0
8674,Ruoka_paivittaistavarakauppa,2019-06-24 08:32:12.885905992,2019-06-24,2019-06-24,2019-06-24,9.0,-5.42,-189.29,0.0,162.0,           ,1.0,1.0,57.0
8675,Ruoka_paivittaistavarakauppa,2019-06-24 08:51:32.617449612,2019-06-24,2019-06-24,2019-06-24,9.0,-7.8,-197.09,0.0,162.0,           ,1.0,1.0,143.0
8676,Ruoka_paivittaistavarakauppa,2019-06-24 13:12:28.993288544,2019-06-24,2019-06-24,2019-06-24,9.0,-1.75,-198.84,0.0,162.0,           ,1.0,1.0,61.0
8677,Shoppailu,2019-06-24 13:31:48.724832164,2019-06-24,2019-06-24,2019-06-24,9.0,-9.09,-207.93,0.0,162.0,           ,1.0,1.0,118.0
8678,Ruoka_paivittaistavarakauppa,2019-06-24 17:52:45.100671096,2019-06-24,2019-06-24,2019-06-24,9.0,-0.79,-208.72,0.0,162.0,           ,1.0,1.0,105.0
8679,Luokittelemattomat,2019-06-24 18:12:04.832214716,2019-06-24,2019-06-24,2019-06-24,9.0,-8.6,-217.32,0.0,162.0,           ,1.0,1.0,199.0
8680,Liikkuminen,2019-06-24 22:52:20.939597268,2019-06-24,2019-06-24,2019-06-24,9.0,-6.45,-223.77,0.0,162.0,           ,1.0,1.0,95.0
8681,Hyvinvointi,2019-06-24 23:11:40.671140888,2019-06-24,2019-06-24,2019-06-24,9.0,-14.68,-238.45,0.0,162.0,           ,1.0,1.0,69.0
8682,Ruoka_paivittaistavarakauppa,2019-06-26 18:31:24.563758336,2019-06-26,2019-06-26,2019-06-26,9.0,-5.62,-244.07,0.0,162.0,           ,1.0,1.0,69.0
8683,Ruoka_paivittaistavarakauppa,2019-06-27 04:11:16.510067060,2019-06-27,2019-06-27,2019-06-27,9.0,-11.25,-255.32,0.0,162.0,           ,1.0,1.0,59.0
8684,Tulot,2019-06-27 13:51:08.456375784,2019-06-27,2019-06-27,2019-06-27,9.0,435.68,180.36,710.0,506.0,           ,1.0,1.0,258.0
8685,Ruoka_paivittaistavarakauppa,2019-06-27 23:31:00.402684508,2019-06-27,2019-06-27,2019-06-27,9.0,-8.9,171.46,0.0,162.0,           ,1.0,1.0,152.0
8686,Muut,2019-06-28 04:30:36.241610680,2019-06-28,2019-06-28,2019-06-28,9.0,-74.96,96.5,0.0,163.0,           ,1.0,1.0,204.0
8687,Ravintolat_kahvilat,2019-06-28 09:10:52.348993232,2019-06-28,2019-06-28,2019-06-28,9.0,-2.9,93.6,0.0,162.0,           ,1.0,1.0,153.0
8688,Luokittelemattomat,2019-06-28 09:30:12.080536852,2019-06-28,2019-06-28,2019-06-28,9.0,-15.33,78.27,0.0,162.0,           ,1.0,1.0,59.0
8689,Saastot_sijoitukset,2019-06-28 14:10:28.187919404,2019-06-28,2019-06-28,2019-06-28,9.0,-14.09,64.18,0.0,162.0,           ,1.0,1.0,111.0
8690,Ruoka_paivittaistavarakauppa,2019-06-28 18:50:44.295301956,2019-06-28,2019-06-28,2019-06-28,9.0,-23.83,40.35,0.0,162.0,           ,1.0,1.0,63.0
8691,Ruoka_paivittaistavarakauppa,2019-06-28 19:10:04.026845576,2019-06-28,2019-06-28,2019-06-28,9.0,-29.2,11.15,0.0,162.0,           ,1.0,1.0,120.0
8692,Saastot_sijoitukset,2019-06-28 23:50:20.134228128,2019-06-28,2019-06-28,2019-06-28,9.0,-31.96,-20.81,0.0,162.0,           ,1.0,1.0,142.0
8693,Hyvinvointijakauneus,2019-07-01 13:10:05.309734513,2019-07-01,2019-07-01,2019-07-01,9.0,-4.76,-25.57,0.0,162.0,           ,1.0,1.0,60.0
8694,Muut,2019-07-02 02:20:10.619469026,2019-07-02,2019-07-02,2019-07-02,9.0,-1.95,-27.52,0.0,162.0,           ,1.0,1.0,105.0
8695,Ruoka_paivittaistavarakauppa,2019-07-02 15:30:15.929203539,2019-07-02,2019-07-02,2019-07-02,9.0,-1.91,-29.43,0.0,162.0,           ,1.0,1.0,131.0
8696,Muut,2019-07-03 04:40:21.238938052,2019-07-03,2019-07-03,2019-07-03,9.0,-36.7,-66.13,0.0,163.0,           ,1.0,1.0,204.0
8697,Muut,2019-07-03 17:50:26.548672565,2019-07-03,2019-07-03,2019-07-05,9.0,-11.22,-77.35,0.0,163.0,           ,1.0,1.0,204.0
8698,Ruoka_paivittaistavarakauppa,2019-07-04 07:00:31.858407078,2019-07-04,2019-07-04,2019-07-04,9.0,-1.18,-78.53,0.0,162.0,           ,1.0,1.0,119.0
8699,Ruoka_paivittaistavarakauppa,2019-07-04 20:10:37.168141591,2019-07-04,2019-07-04,2019-07-04,9.0,-1.21,-79.74,0.0,162.0,           ,1.0,1.0,132.0
8700,Ruoka_paivittaistavarakauppa,2019-07-05 09:20:42.477876104,2019-07-05,2019-07-05,2019-07-05,9.0,-1.44,-81.18,0.0,162.0,           ,1.0,1.0,162.0
8701,Ravintolat_kahvilat,2019-07-05 22:30:47.787610617,2019-07-05,2019-07-05,2019-07-05,9.0,-2.15,-83.33,0.0,162.0,           ,1.0,1.0,117.0
8702,Saastot_sijoitukset,2019-07-08 00:50:58.407079643,2019-07-08,2019-07-08,2019-07-08,9.0,-6.51,-89.84,0.0,162.0,           ,1.0,1.0,116.0
8703,Ruoka_paivittaistavarakauppa,2019-07-08 03:11:09.026548669,2019-07-08,2019-07-08,2019-07-08,9.0,-7.01,-96.85,0.0,162.0,           ,1.0,1.0,155.0
8704,Ruoka_paivittaistavarakauppa,2019-07-08 11:40:53.097345130,2019-07-08,2019-07-08,2019-07-08,9.0,-1.39,-98.24,0.0,162.0,           ,1.0,1.0,189.0
8705,Ruoka_paivittaistavarakauppa,2019-07-08 14:01:03.716814156,2019-07-08,2019-07-08,2019-07-08,9.0,-4.17,-102.41,0.0,162.0,           ,1.0,1.0,194.0
8706,Ruoka_paivittaistavarakauppa,2019-07-08 16:21:14.336283182,2019-07-08,2019-07-08,2019-07-08,9.0,-6.69,-109.1,0.0,162.0,           ,1.0,1.0,184.0
8707,Matkailu,2019-07-09 05:31:19.646017695,2019-07-09,2019-07-09,2019-07-09,9.0,-21.66,-130.76,0.0,162.0,           ,1.0,1.0,77.0
8708,Ruoka_paivittaistavarakauppa,2019-07-09 07:51:30.265486721,2019-07-09,2019-07-09,2019-07-09,9.0,-2.37,-133.13,0.0,162.0,           ,1.0,1.0,114.0
8709,Muut,2019-07-09 18:41:24.955752208,2019-07-09,2019-07-09,2019-07-09,9.0,-4.49,-137.62,0.0,162.0,           ,1.0,1.0,112.0
8710,Ravintolat_kahvilat,2019-07-11 10:11:40.884955747,2019-07-11,2019-07-11,2019-07-11,9.0,-23.04,-160.66,0.0,162.0,           ,1.0,1.0,167.0
8711,Ruoka_paivittaistavarakauppa,2019-07-11 23:21:46.194690260,2019-07-11,2019-07-11,2019-07-11,9.0,-8.56,-169.22,0.0,162.0,           ,1.0,1.0,200.0
8712,Matkailu,2019-07-12 01:41:56.814159286,2019-07-12,2019-07-12,2019-07-12,9.0,-20.62,-189.84,0.0,162.0,           ,1.0,1.0,94.0
8713,Muut,2019-07-12 12:31:51.504424773,2019-07-12,2019-07-12,2019-07-12,9.0,-34.01,-223.85,0.0,163.0,           ,1.0,1.0,207.0
8714,Ruoka_paivittaistavarakauppa,2019-07-12 21:01:35.575221234,2019-07-12,2019-07-12,2019-07-12,9.0,-6.29,-230.14,0.0,162.0,           ,1.0,1.0,95.0
8715,Ruoka_paivittaistavarakauppa,2019-07-15 04:02:07.433628312,2019-07-15,2019-07-15,2019-07-15,9.0,-4.42,-234.56,0.0,162.0,           ,1.0,1.0,128.0
8716,Ruoka_paivittaistavarakauppa,2019-07-15 06:22:18.053097338,2019-07-15,2019-07-15,2019-07-12,9.0,-3.33,-237.89,0.0,162.0,           ,1.0,1.0,150.0
8717,Ruoka_paivittaistavarakauppa,2019-07-15 14:52:02.123893799,2019-07-15,2019-07-16,2019-07-15,9.0,-3.11,-241.0,0.0,162.0,           ,1.0,1.0,182.0
8718,Kulttuuri_viihde,2019-07-15 17:12:12.743362825,2019-07-15,2019-07-15,2019-07-15,9.0,-4.88,-245.88,0.0,162.0,           ,1.0,1.0,164.0
8719,Muut,2019-07-15 19:32:23.362831851,2019-07-15,2019-07-15,2019-07-15,9.0,-0.2,-246.08,0.0,162.0,           ,1.0,1.0,134.0
8720,Muut,2019-07-16 08:42:28.672566364,2019-07-16,2019-07-16,2019-07-16,9.0,-14.84,-260.92,0.0,163.0,           ,1.0,1.0,204.0
8721,Ruoka_paivittaistavarakauppa,2019-07-16 21:52:33.982300877,2019-07-16,2019-07-16,2019-07-16,9.0,-6.56,-267.48,0.0,162.0,           ,1.0,1.0,152.0
8722,Luokittelemattomat,2019-07-18 00:12:44.601769903,2019-07-18,2019-07-18,2019-07-18,9.0,-3.23,-270.71,0.0,162.0,           ,1.0,1.0,133.0
8723,Luottojen_maksut,2019-07-18 11:02:39.292035390,2019-07-18,2019-07-18,2019-07-18,9.0,-1.54,-272.25,0.0,162.0,           ,1.0,1.0,95.0
8724,Ruoka_paivittaistavarakauppa,2019-07-18 13:22:49.911504416,2019-07-18,2019-07-18,2019-07-18,9.0,-8.6,-280.85,0.0,162.0,           ,1.0,1.0,145.0
8725,Lapset,2019-07-18 18:03:11.150442468,2019-07-18,2019-07-18,2019-07-18,9.0,-5.3,-286.15,0.0,162.0,           ,1.0,1.0,59.0
8726,Ravintolat_kahvilat,2019-07-19 02:32:55.221238929,2019-07-19,2019-07-19,2019-07-19,9.0,-1.88,-288.03,0.0,162.0,           ,1.0,1.0,133.0
8727,Kulttuuri_viihde,2019-07-19 15:43:00.530973442,2019-07-19,2019-07-19,2019-07-19,9.0,-10.0,-298.03,0.0,162.0,           ,1.0,1.0,196.0
8728,Muut,2019-07-19 20:23:21.769911494,2019-07-19,2019-07-19,2019-07-19,9.0,-5.25,-303.28,0.0,163.0,           ,1.0,1.0,205.0
8729,Ruoka_paivittaistavarakauppa,2019-07-22 04:53:05.840707955,2019-07-22,2019-07-22,2019-07-22,9.0,-1.28,-304.56,0.0,162.0,           ,1.0,1.0,158.0
8730,Tulot,2019-07-22 07:13:16.460176981,2019-07-18,2019-07-22,2019-07-22,9.0,-3.04,-307.6,0.0,162.0,           ,1.0,1.0,139.0
8731,Terveys,2019-07-22 09:33:27.079646007,2019-07-22,2019-07-22,2019-07-22,9.0,-25.87,-333.47,0.0,162.0,           ,1.0,1.0,162.0
8732,Ravintolat_kahvilat,2019-07-22 22:43:32.389380520,2019-07-22,2019-07-23,2019-07-22,9.0,-8.72,-342.19,0.0,162.0,           ,1.0,1.0,182.0
8733,Ruoka_paivittaistavarakauppa,2019-07-23 01:03:43.008849546,2019-07-23,2019-07-23,2019-07-23,9.0,-4.07,-346.26,0.0,162.0,           ,1.0,1.0,140.0
8734,Ruoka_paivittaistavarakauppa,2019-07-23 11:53:37.699115033,2019-07-23,2019-07-23,2019-07-23,9.0,-19.92,-366.18,0.0,162.0,           ,1.0,1.0,188.0
8735,Luokittelemattomat,2019-07-23 14:13:48.318584059,2019-07-23,2019-07-23,2019-07-23,9.0,-1.59,-367.77,0.0,162.0,           ,1.0,1.0,100.0
8736,Ruoka_paivittaistavarakauppa,2019-07-25 16:33:58.938053085,2019-07-25,2019-07-25,2019-07-25,9.0,-2.19,-369.96,0.0,162.0,           ,1.0,1.0,71.0
8737,Luokittelemattomat,2019-07-26 03:23:53.628318572,2019-07-26,2019-07-26,2019-07-26,9.0,-3.5,-373.46,0.0,162.0,           ,1.0,1.0,132.0
8738,Tulot,2019-07-26 05:44:04.247787598,2019-07-26,2019-07-26,2019-07-26,9.0,407.89,34.43,0.0,506.0,           ,1.0,1.0,219.0
8739,Ravintolat_kahvilat,2019-07-26 18:54:09.557522111,2019-07-26,2019-07-26,2019-07-26,9.0,-7.61,26.82,0.0,162.0,           ,1.0,1.0,195.0
8740,Tulot,2019-07-26 21:14:20.176991137,2019-07-26,2019-07-26,2019-07-26,9.0,-0.65,26.17,0.0,162.0,           ,1.0,1.0,141.0
8741,Ruoka_paivittaistavarakauppa,2019-07-29 01:54:41.415929189,2019-07-29,2019-07-30,2019-07-29,9.0,-2.32,23.85,0.0,162.0,           ,1.0,1.0,117.0
8742,Luokittelemattomat,2019-07-29 08:04:14.867256624,2019-07-29,2019-07-30,2019-07-29,9.0,-5.46,18.39,0.0,162.0,           ,1.0,1.0,149.0
8743,Ruoka_paivittaistavarakauppa,2019-07-29 10:24:25.486725650,2019-07-29,2019-07-29,2019-07-29,9.0,-4.87,13.52,0.0,162.0,           ,1.0,1.0,128.0
8744,Ruoka_paivittaistavarakauppa,2019-07-29 12:44:36.106194676,2019-07-29,2019-07-29,2019-07-29,9.0,-14.9,-1.38,0.0,162.0,           ,1.0,1.0,127.0
8745,Ruoka_paivittaistavarakauppa,2019-07-29 23:34:30.796460163,2019-07-29,2019-07-30,2019-07-29,9.0,-3.24,-4.62,0.0,162.0,           ,1.0,1.0,134.0
8746,Ruoka_paivittaistavarakauppa,2019-07-30 04:14:52.035398215,2019-07-30,2019-07-30,2019-07-30,9.0,-1.77,-6.39,0.0,162.0,           ,1.0,1.0,90.0
8747,Hyvinvointijakauneus,2019-07-30 15:04:46.725663702,2019-07-30,2019-07-30,2019-07-30,9.0,-16.72,-23.11,0.0,162.0,           ,1.0,1.0,176.0
8748,Ravintolat_kahvilat,2019-07-31 17:24:57.345132728,2019-07-31,2019-07-31,2019-07-31,9.0,-8.19,-31.3,0.0,162.0,           ,1.0,1.0,111.0
8749,Tulot,2019-08-01 12:17:51.074380165,2019-08-01,2019-08-01,2019-08-01,9.0,64.3,33.0,0.0,506.0,           ,1.0,1.0,221.0
8750,Tulot,2019-08-02 00:35:42.148760330,2019-08-02,2019-08-02,2019-08-02,9.0,165.64,198.64,701.0,521.0,           ,1.0,1.0,235.0
8751,Ruoka_paivittaistavarakauppa,2019-08-02 01:11:24.297520660,2019-08-02,2019-08-02,2019-08-02,9.0,-30.92,167.72,0.0,162.0,           ,1.0,1.0,140.0
8752,Ruoka_paivittaistavarakauppa,2019-08-02 12:53:33.223140495,2019-08-02,2019-08-02,2019-08-02,9.0,-8.04,159.68,0.0,162.0,           ,1.0,1.0,196.0
8753,Muut,2019-08-04 01:47:06.446280990,2019-08-04,2019-08-04,2019-08-04,9.0,-13.48,146.2,0.0,106.0,OKOYFIHH   ,1.0,0.0,14.0
8754,Lemmikit,2019-08-04 14:04:57.520661155,2019-08-04,2019-08-04,2019-08-04,9.0,-41.44,104.76,0.0,106.0,OKOYFIHH   ,0.0,0.0,25.0
8755,Luokittelemattomat,2019-08-04 15:16:21.818181815,2019-08-04,2019-08-04,2019-08-04,9.0,-37.98,66.78,0.0,106.0,SBANFIHH   ,1.0,0.0,44.0
8756,Saastot_sijoitukset,2019-08-05 02:22:48.595041320,2019-08-05,2019-08-05,2019-08-05,9.0,-48.79,17.99,0.0,106.0,OKOYFIHH   ,0.0,0.0,28.0
8757,Muut,2019-08-05 02:58:30.743801650,2019-08-05,2019-08-05,2019-08-05,9.0,-8.7,9.29,0.0,106.0,OKOYFIHH   ,0.0,0.0,27.0
8758,Matkailu,2019-08-05 14:40:39.669421485,2019-08-05,2019-08-05,2019-08-05,9.0,-50.18,-40.89,0.0,106.0,NDEAFIHH   ,0.0,0.0,15.0
8759,Tulot,2019-08-06 04:09:55.041322310,2019-08-06,2019-08-08,2019-08-06,9.0,-13.39,-54.28,0.0,162.0,           ,1.0,1.0,113.0
8760,Ruoka_paivittaistavarakauppa,2019-08-06 13:29:15.371900825,2019-08-06,2019-08-06,2019-08-06,9.0,-2.83,-57.11,0.0,162.0,           ,1.0,1.0,69.0
8761,Muut,2019-08-07 03:34:12.892561980,2019-08-07,2019-08-09,2019-08-07,9.0,-7.67,-64.78,0.0,163.0,           ,1.0,1.0,207.0
8762,Ruoka_paivittaistavarakauppa,2019-08-07 15:52:03.966942145,2019-08-07,2019-08-07,2019-08-07,9.0,-11.89,-76.67,0.0,162.0,           ,1.0,1.0,57.0
8763,Asuminen,2019-08-09 04:45:37.190082640,2019-08-09,2019-08-09,2019-08-09,9.0,-10.21,-86.88,706.0,129.0,OKOYFIHH   ,0.0,0.0,249.0
8764,Ruoka_paivittaistavarakauppa,2019-08-09 05:21:19.338842970,2019-08-09,2019-08-09,2019-08-09,9.0,-1.13,-88.01,0.0,162.0,           ,1.0,1.0,148.0
8765,Ruoka_paivittaistavarakauppa,2019-08-09 16:27:46.115702475,2019-08-09,2019-08-09,2019-08-09,9.0,-3.9,-91.91,0.0,162.0,           ,1.0,1.0,73.0
8766,Ruoka_paivittaistavarakauppa,2019-08-09 17:03:28.264462805,2019-08-09,2019-08-09,2019-08-09,9.0,-4.44,-96.35,0.0,162.0,           ,1.0,1.0,150.0
8767,Muut,2019-08-09 17:39:10.413223135,2019-08-09,2019-08-09,2019-08-09,9.0,-73.4,-169.75,0.0,163.0,           ,1.0,1.0,204.0
8768,Ruoka_paivittaistavarakauppa,2019-08-12 05:57:01.487603300,2019-08-12,2019-08-14,2019-08-12,9.0,-0.59,-170.34,0.0,162.0,           ,1.0,1.0,115.0
8769,Lapset,2019-08-12 06:32:43.636363630,2019-08-12,2019-08-12,2019-08-12,9.0,-4.51,-174.85,0.0,162.0,           ,1.0,1.0,173.0
8770,Hyvinvointijakauneus,2019-08-12 18:14:52.561983465,2019-08-12,2019-08-12,2019-08-12,9.0,-5.44,-180.29,0.0,162.0,           ,1.0,1.0,165.0
8771,Muut,2019-08-12 18:50:34.710743795,2019-08-12,2019-08-12,2019-08-12,9.0,-0.85,-181.14,0.0,162.0,           ,1.0,1.0,57.0
8772,Ruoka_paivittaistavarakauppa,2019-08-12 19:26:16.859504125,2019-08-12,2019-08-12,2019-08-12,9.0,-15.11,-196.25,0.0,162.0,           ,1.0,1.0,145.0
8773,Ruoka_paivittaistavarakauppa,2019-08-13 07:08:25.785123960,2019-08-13,2019-08-13,2019-08-13,9.0,-4.83,-201.08,0.0,162.0,           ,1.0,1.0,69.0
8774,Liikkuminen,2019-08-13 07:44:07.933884290,2019-08-13,2019-08-13,2019-08-13,9.0,-4.06,-205.14,0.0,162.0,           ,1.0,1.0,148.0
8775,Asuminen,2019-08-15 08:19:50.082644620,2019-08-15,2019-08-15,2019-08-15,9.0,-20.79,-225.93,0.0,106.0,DABAFIHH   ,0.0,0.0,42.0
8776,Lapset,2019-08-16 08:55:32.231404950,2019-08-16,2019-08-16,2019-08-16,9.0,-7.14,-233.07,0.0,162.0,           ,1.0,1.0,141.0
8777,Ruoka_paivittaistavarakauppa,2019-08-16 20:01:59.008264455,2019-08-16,2019-08-16,2019-08-16,9.0,-3.36,-236.43,0.0,162.0,           ,1.0,1.0,123.0
8778,Ruoka_paivittaistavarakauppa,2019-08-16 20:37:41.157024785,2019-08-16,2019-08-16,2019-08-16,9.0,-8.95,-245.38,0.0,162.0,           ,1.0,1.0,95.0
8779,Ravintolat_kahvilat,2019-08-16 21:13:23.305785115,2019-08-16,2019-08-16,2019-08-16,9.0,-0.39,-245.77,0.0,162.0,           ,1.0,1.0,162.0
8780,Luokittelemattomat,2019-08-19 09:31:14.380165280,2019-08-19,2019-08-19,2019-08-19,9.0,-3.06,-248.83,0.0,162.0,           ,1.0,1.0,121.0
8781,Hyvinvointijakauneus,2019-08-19 10:06:56.528925610,2019-08-19,2019-08-19,2019-08-19,9.0,-6.25,-255.08,0.0,162.0,           ,1.0,1.0,141.0
8782,Ravintolat_kahvilat,2019-08-19 10:42:38.677685940,2019-08-19,2019-08-19,2019-08-19,9.0,-2.12,-257.2,0.0,162.0,           ,1.0,1.0,173.0
8783,Ravintolat_kahvilat,2019-08-19 21:49:05.454545445,2019-08-19,2019-08-19,2019-08-19,9.0,-4.6,-261.8,0.0,162.0,           ,1.0,1.0,57.0
8784,Ravintolat_kahvilat,2019-08-19 22:24:47.603305775,2019-08-19,2019-08-19,2019-08-19,9.0,-2.86,-264.66,0.0,162.0,           ,1.0,1.0,125.0
8785,Ruoka_paivittaistavarakauppa,2019-08-19 23:00:29.752066105,2019-08-19,2019-08-19,2019-08-19,9.0,-4.84,-269.5,0.0,162.0,           ,1.0,1.0,129.0
8786,Ruoka_paivittaistavarakauppa,2019-08-20 23:36:11.900826435,2019-08-20,2019-08-20,2019-08-20,9.0,-0.3,-269.8,0.0,162.0,           ,1.0,1.0,116.0
8787,Tulot,2019-08-21 11:18:20.826446270,2019-08-21,2019-08-22,2019-08-21,9.0,90.6,-179.2,0.0,506.0,           ,1.0,1.0,219.0
8788,Muut,2019-08-22 00:47:36.198347095,2019-08-22,2019-08-23,2019-08-22,9.0,-7.46,-186.66,0.0,103.0,           ,0.0,1.0,3.0
8789,Asuminen,2019-08-22 11:54:02.975206600,2019-08-22,2019-08-22,2019-08-19,9.0,-12.05,-198.71,0.0,106.0,OKOYFIHH   ,0.0,0.0,17.0
8790,Tulot,2019-08-22 13:05:27.272727260,2019-08-22,2019-08-22,2019-08-22,9.0,286.54,87.83,0.0,559.0,           ,1.0,1.0,224.0
8791,Ravintolat_kahvilat,2019-08-23 00:11:54.049586765,2019-08-23,2019-08-23,2019-08-23,9.0,-5.71,82.12,0.0,162.0,           ,1.0,1.0,133.0
8792,Luottojen_maksut,2019-08-23 01:23:18.347107425,2019-08-23,2019-08-23,2019-08-23,9.0,-22.2,59.92,706.0,129.0,OKOYFIHH   ,0.0,0.0,240.0
8793,Ruoka_paivittaistavarakauppa,2019-08-23 01:59:00.495867755,2019-08-23,2019-08-23,2019-08-23,9.0,-17.23,42.69,0.0,162.0,           ,1.0,1.0,118.0
8794,Matkailu,2019-08-23 12:29:45.123966930,2019-08-23,2019-08-23,2019-08-23,9.0,-33.49,9.2,0.0,162.0,           ,1.0,1.0,131.0
8795,Muut,2019-08-23 13:41:09.421487590,2019-08-23,2019-08-23,2019-08-23,9.0,-15.52,-6.32,0.0,163.0,           ,1.0,1.0,204.0
8796,Ruoka_paivittaistavarakauppa,2019-08-26 02:34:42.644628085,2019-08-26,2019-08-26,2019-08-26,9.0,-2.14,-8.46,0.0,162.0,           ,1.0,1.0,60.0
8797,Luokittelemattomat,2019-08-26 14:16:51.570247920,2019-08-26,2019-08-26,2019-08-26,9.0,-1.98,-10.44,0.0,162.0,           ,1.0,1.0,176.0
8798,Ruoka_paivittaistavarakauppa,2019-08-26 14:52:33.719008250,2019-08-26,2019-08-26,2019-08-26,9.0,-2.91,-13.35,0.0,162.0,           ,1.0,1.0,162.0
8799,Ruoka_paivittaistavarakauppa,2019-08-27 03:10:24.793388415,2019-08-27,2019-08-27,2019-08-27,9.0,-13.25,-26.6,0.0,162.0,           ,1.0,1.0,127.0
8800,Hyvinvointijakauneus,2019-08-27 15:28:15.867768580,2019-08-27,2019-08-27,2019-08-27,9.0,-54.18,-80.78,706.0,129.0,OKOYFIHH   ,0.0,0.0,248.0
8801,Ravintolat_kahvilat,2019-08-29 03:46:06.942148745,2019-08-29,2019-08-29,2019-08-29,9.0,-4.94,-85.72,0.0,162.0,           ,1.0,1.0,147.0
8802,Ruoka_paivittaistavarakauppa,2019-08-29 04:21:49.090909075,2019-08-29,2019-08-29,2019-08-29,9.0,-4.31,-90.03,0.0,162.0,           ,1.0,1.0,77.0
8803,Harrastukset,2019-08-29 16:03:58.016528910,2019-08-29,2019-08-29,2019-08-29,9.0,-7.43,-97.46,0.0,106.0,NDEAFIHH   ,0.0,0.0,13.0
8804,Harrastukset,2019-08-29 17:15:22.314049570,2019-08-29,2019-08-29,2019-08-28,9.0,-1.41,-98.87,0.0,162.0,           ,1.0,1.0,58.0
8805,Ravintolat_kahvilat,2019-08-29 17:51:04.462809900,2019-08-29,2019-08-29,2019-08-29,9.0,-10.13,-109.0,0.0,162.0,           ,1.0,1.0,121.0
8806,Lapset,2019-08-30 04:57:31.239669405,2019-08-30,2019-08-30,2019-08-30,9.0,-4.67,-113.67,0.0,162.0,           ,1.0,1.0,147.0
8807,Tulot,2019-08-30 05:33:13.388429735,2019-08-30,2019-08-30,2019-08-30,9.0,63.21,-50.46,701.0,510.0,           ,1.0,1.0,230.0
8808,Ruoka_paivittaistavarakauppa,2019-08-30 16:39:40.165289240,2019-08-30,2019-08-30,2019-08-30,9.0,-6.4,-56.86,0.0,162.0,           ,1.0,1.0,117.0
8809,Ruoka_paivittaistavarakauppa,2019-09-04 03:47:22.105263157,2019-09-04,2019-09-04,2019-09-04,9.0,-13.49,-70.35,0.0,162.0,           ,1.0,1.0,135.0
8810,Tulot,2019-09-06 07:34:44.210526314,2019-09-06,2019-09-06,2019-09-06,9.0,66.47,-3.88,710.0,506.0,           ,1.0,1.0,259.0
8811,Luottojen_maksut,2019-09-10 11:22:06.315789471,2019-09-10,2019-09-10,2019-09-10,9.0,-8.78,-12.66,0.0,106.0,NDEAFIHH   ,1.0,0.0,16.0
8812,Tulot,2019-09-13 15:09:28.421052628,2019-09-13,2019-09-13,2019-09-13,9.0,1.54,-11.12,710.0,506.0,           ,1.0,1.0,257.0
8813,Asuminen,2019-09-16 18:56:50.526315785,2019-09-16,2019-09-16,2019-09-16,9.0,-41.67,-52.79,0.0,106.0,OKOYFIHH   ,0.0,0.0,17.0
8814,Ruoka_paivittaistavarakauppa,2019-09-19 22:44:12.631578942,2019-09-19,2019-09-19,2019-09-19,9.0,-1.83,-54.62,0.0,162.0,           ,1.0,1.0,112.0
8815,Lapset,2019-09-22 02:31:34.736842099,2019-09-22,2019-09-22,2019-09-22,9.0,-21.76,-76.38,0.0,106.0,OKOYFIHH   ,0.0,0.0,19.0
8816,Luottojen_maksut,2019-09-26 06:18:56.842105256,2019-09-26,2019-09-27,2019-09-26,9.0,-28.45,-104.83,0.0,106.0,SBANFIHH   ,1.0,0.0,13.0
8817,Matkailu,2019-09-30 10:06:18.947368413,2019-09-30,2019-09-30,2019-09-30,9.0,-60.77,-165.6,0.0,106.0,NDEAFIHH   ,0.0,0.0,13.0
8818,Matkailu,2019-10-01 23:37:08.571428571,2019-10-01,2019-10-01,2019-10-01,9.0,-15.03,-180.63,0.0,106.0,OKOYFIHH   ,0.0,0.0,45.0
8819,Ravintolat_kahvilat,2019-10-02 23:14:17.142857142,2019-10-02,2019-10-04,2019-10-02,9.0,-3.04,-183.67,0.0,162.0,           ,1.0,1.0,89.0
8820,Ravintolat_kahvilat,2019-10-03 22:51:25.714285713,2019-10-03,2019-10-03,2019-10-03,9.0,-22.13,-205.8,0.0,106.0,OKOYFIHH   ,0.0,0.0,18.0
8821,Liikkuminen,2019-10-04 22:05:42.857142855,2019-10-04,2019-10-04,2019-10-04,9.0,-5.83,-211.63,0.0,162.0,           ,1.0,1.0,97.0
8822,Luokittelemattomat,2019-10-04 22:28:34.285714284,2019-10-04,2019-10-04,2019-10-04,9.0,-32.62,-244.25,0.0,162.0,           ,1.0,1.0,83.0
8823,Saastot_sijoitukset,2019-10-07 21:19:59.999999997,2019-10-07,2019-10-07,2019-10-07,9.0,-3.77,-248.02,0.0,162.0,           ,1.0,1.0,100.0
8824,Ruoka_paivittaistavarakauppa,2019-10-07 21:42:51.428571426,2019-10-07,2019-10-07,2019-10-07,9.0,-32.58,-280.6,0.0,162.0,           ,1.0,1.0,168.0
8825,Saastot_sijoitukset,2019-10-08 20:57:08.571428568,2019-10-08,2019-10-08,2019-10-08,9.0,-4.06,-284.66,0.0,162.0,           ,1.0,1.0,184.0
8826,Luokittelemattomat,2019-10-09 20:11:25.714285710,2019-10-09,2019-10-11,2019-10-09,9.0,-2.96,-287.62,0.0,162.0,           ,1.0,1.0,136.0
8827,Ruoka_paivittaistavarakauppa,2019-10-09 20:34:17.142857139,2019-10-09,2019-10-09,2019-10-09,9.0,-10.69,-298.31,0.0,162.0,           ,1.0,1.0,113.0
8828,Ruoka_paivittaistavarakauppa,2019-10-11 19:25:42.857142852,2019-10-11,2019-10-11,2019-10-11,9.0,-3.64,-301.95,0.0,162.0,           ,1.0,1.0,113.0
8829,Hyvinvointijakauneus,2019-10-11 19:48:34.285714281,2019-10-11,2019-10-11,2019-10-11,9.0,-3.61,-305.56,0.0,162.0,           ,1.0,1.0,146.0
8830,Ruoka_paivittaistavarakauppa,2019-10-14 18:39:59.999999994,2019-10-14,2019-10-14,2019-10-14,9.0,-1.16,-306.72,0.0,162.0,           ,1.0,1.0,161.0
8831,Luokittelemattomat,2019-10-14 19:02:51.428571423,2019-10-14,2019-10-14,2019-10-14,9.0,-5.07,-311.79,0.0,162.0,           ,1.0,1.0,144.0
8832,Muut,2019-10-16 18:17:08.571428565,2019-10-16,2019-10-16,2019-10-16,9.0,-50.42,-362.21,0.0,163.0,           ,1.0,1.0,205.0
8833,Ruoka_paivittaistavarakauppa,2019-10-17 17:54:17.142857136,2019-10-17,2019-10-17,2019-10-17,9.0,-0.67,-362.88,0.0,162.0,           ,1.0,1.0,125.0
8834,Ruoka_paivittaistavarakauppa,2019-10-18 17:08:34.285714278,2019-10-18,2019-10-18,2019-10-18,9.0,-6.94,-369.82,0.0,162.0,           ,1.0,1.0,111.0
8835,Liikkuminen,2019-10-18 17:31:25.714285707,2019-10-18,2019-10-18,2019-10-18,9.0,-2.79,-372.61,0.0,162.0,           ,1.0,1.0,202.0
8836,Ruoka_paivittaistavarakauppa,2019-10-21 15:59:59.999999991,2019-10-21,2019-10-21,2019-10-21,9.0,-12.64,-385.25,0.0,162.0,           ,1.0,1.0,140.0
8837,Lemmikit,2019-10-21 16:22:51.428571420,2019-10-21,2019-10-21,2019-10-21,9.0,-86.69,-471.94,0.0,162.0,           ,1.0,1.0,112.0
8838,Ravintolat_kahvilat,2019-10-21 16:45:42.857142849,2019-10-21,2019-10-21,2019-10-21,9.0,-2.81,-474.75,0.0,162.0,           ,1.0,1.0,137.0
8839,Liikkuminen,2019-10-22 15:37:08.571428562,2019-10-22,2019-10-22,2019-10-22,9.0,-11.28,-486.03,0.0,162.0,           ,1.0,1.0,120.0
8840,Ruoka_paivittaistavarakauppa,2019-10-23 15:14:17.142857133,2019-10-23,2019-10-23,2019-10-23,9.0,-11.14,-497.17,0.0,162.0,           ,1.0,1.0,121.0
8841,Ruoka_paivittaistavarakauppa,2019-10-24 14:51:25.714285704,2019-10-24,2019-10-24,2019-10-24,9.0,-6.23,-503.4,0.0,162.0,           ,1.0,1.0,129.0
8842,Muut,2019-10-25 14:28:34.285714275,2019-10-25,2019-10-25,2019-10-25,9.0,-2.59,-505.99,0.0,162.0,           ,1.0,1.0,129.0
8843,Matkailu,2019-10-26 14:05:42.857142846,2019-10-26,2019-10-26,2019-10-26,9.0,-21.41,-527.4,0.0,106.0,NDEAFIHH   ,0.0,0.0,17.0
8844,Tulot,2019-10-28 13:19:59.999999988,2019-10-28,2019-10-28,2019-10-28,9.0,231.36,-296.04,710.0,506.0,           ,1.0,1.0,255.0
8845,Ruoka_paivittaistavarakauppa,2019-10-28 13:42:51.428571417,2019-10-28,2019-10-28,2019-10-28,9.0,-2.72,-298.76,0.0,162.0,           ,1.0,1.0,108.0
8846,Ravintolat_kahvilat,2019-10-29 12:57:08.571428559,2019-10-29,2019-10-29,2019-10-29,9.0,-7.52,-306.28,0.0,162.0,           ,1.0,1.0,141.0
8847,Ruoka_paivittaistavarakauppa,2019-10-31 12:11:25.714285701,2019-10-31,2019-10-31,2019-10-31,9.0,-6.29,-312.57,0.0,162.0,           ,1.0,1.0,115.0
8848,Ruoka_paivittaistavarakauppa,2019-10-31 12:34:17.142857130,2019-10-31,2019-10-31,2019-10-31,9.0,-1.21,-313.78,0.0,162.0,           ,1.0,1.0,79.0
8849,Ruoka_paivittaistavarakauppa,2019-11-01 03:10:11.320754715,2019-11-01,2019-11-01,2019-11-01,9.0,-10.53,-324.31,0.0,162.0,           ,1.0,1.0,69.0
8850,Ravintolat_kahvilat,2019-11-01 09:03:23.773584905,2019-11-01,2019-11-01,2019-10-31,9.0,-1.75,-326.06,0.0,162.0,           ,1.0,1.0,151.0
8851,Ruoka_paivittaistavarakauppa,2019-11-01 12:13:35.094339620,2019-11-01,2019-11-01,2019-11-01,9.0,-7.73,-333.79,0.0,162.0,           ,1.0,1.0,115.0
8852,Ruoka_paivittaistavarakauppa,2019-11-01 18:06:47.547169810,2019-11-01,2019-11-01,2019-11-01,9.0,-8.16,-341.95,0.0,162.0,           ,1.0,1.0,158.0
8853,Ravintolat_kahvilat,2019-11-01 21:16:58.867924525,2019-11-01,2019-11-01,2019-11-01,9.0,-1.36,-343.31,0.0,162.0,           ,1.0,1.0,151.0
8854,Ruoka_paivittaistavarakauppa,2019-11-04 00:27:10.188679240,2019-11-04,2019-11-04,2019-11-04,9.0,-3.02,-346.33,0.0,162.0,           ,1.0,1.0,57.0
8855,Ruoka_paivittaistavarakauppa,2019-11-04 06:20:22.641509430,2019-11-04,2019-11-06,2019-11-04,9.0,-9.89,-356.22,0.0,162.0,           ,1.0,1.0,148.0
8856,Liikkuminen,2019-11-04 09:30:33.962264145,2019-11-04,2019-11-04,2019-11-04,9.0,-24.68,-380.9,0.0,162.0,           ,1.0,1.0,161.0
8857,Luokittelemattomat,2019-11-04 15:23:46.415094335,2019-11-04,2019-11-04,2019-11-04,9.0,-5.49,-386.39,0.0,106.0,OKOYFIHH   ,1.0,0.0,13.0
8858,Lapset,2019-11-04 18:33:57.735849050,2019-11-04,2019-11-04,2019-11-04,9.0,-3.89,-390.28,0.0,162.0,           ,1.0,1.0,125.0
8859,Matkailu,2019-11-05 03:37:21.509433955,2019-11-05,2019-11-05,2019-11-05,9.0,-0.67,-390.95,0.0,105.0,OKOYFIHH   ,1.0,0.0,5.0
8860,Saastot_sijoitukset,2019-11-05 06:47:32.830188670,2019-11-05,2019-11-05,2019-11-05,9.0,-2.43,-393.38,0.0,162.0,           ,1.0,1.0,145.0
8861,Liikkuminen,2019-11-05 12:40:45.283018860,2019-11-05,2019-11-05,2019-11-05,9.0,-2.48,-395.86,0.0,162.0,           ,1.0,1.0,87.0
8862,Ruoka_paivittaistavarakauppa,2019-11-05 21:44:09.056603765,2019-11-05,2019-11-05,2019-11-05,9.0,-2.37,-398.23,0.0,162.0,           ,1.0,1.0,173.0
8863,Liikkuminen,2019-11-06 19:01:07.924528290,2019-11-06,2019-11-06,2019-11-06,9.0,-17.12,-415.35,0.0,106.0,OKOYFIHH   ,0.0,0.0,22.0
8864,Ruoka_paivittaistavarakauppa,2019-11-07 00:54:20.377358480,2019-11-07,2019-11-07,2019-11-07,9.0,-6.63,-421.98,0.0,162.0,           ,1.0,1.0,58.0
8865,Hyvinvointijakauneus,2019-11-07 07:14:43.018867910,2019-11-07,2019-11-07,2019-11-07,9.0,-9.94,-431.92,0.0,106.0,OKOYFIHH   ,0.0,0.0,30.0
8866,Lemmikit,2019-11-07 09:57:44.150943385,2019-11-07,2019-11-07,2019-11-07,9.0,-4.03,-435.95,0.0,162.0,           ,1.0,1.0,159.0
8867,Ravintolat_kahvilat,2019-11-07 22:11:19.245283005,2019-11-07,2019-11-07,2019-11-07,9.0,-0.73,-436.68,0.0,162.0,           ,1.0,1.0,128.0
8868,Ruoka_paivittaistavarakauppa,2019-11-08 04:04:31.698113195,2019-11-08,2019-11-08,2019-11-08,9.0,-5.17,-441.85,0.0,162.0,           ,1.0,1.0,57.0
8869,Ruoka_paivittaistavarakauppa,2019-11-08 13:07:55.471698100,2019-11-08,2019-11-08,2019-11-08,9.0,-7.83,-449.68,0.0,162.0,           ,1.0,1.0,105.0
8870,Liikkuminen,2019-11-08 15:50:56.603773575,2019-11-08,2019-11-08,2019-11-08,9.0,-2.76,-452.44,0.0,162.0,           ,1.0,1.0,145.0
8871,Lemmikit,2019-11-08 16:18:06.792452815,2019-11-08,2019-11-08,2019-11-08,9.0,-10.97,-463.41,0.0,106.0,OKOYFIHH   ,0.0,0.0,44.0
8872,Lemmikit,2019-11-11 01:48:40.754716960,2019-11-11,2019-11-11,2019-11-11,9.0,-2.89,-466.3,0.0,162.0,           ,1.0,1.0,58.0
8873,Matkailu,2019-11-11 04:31:41.886792435,2019-11-11,2019-11-11,2019-11-11,9.0,-2.27,-468.57,0.0,162.0,           ,1.0,1.0,134.0
8874,Asuminen,2019-11-11 07:41:53.207547150,2019-11-11,2019-11-11,2019-11-11,9.0,-18.19,-486.76,0.0,106.0,OKOYFIHH   ,0.0,0.0,21.0
8875,Ravintolat_kahvilat,2019-11-11 10:24:54.339622625,2019-11-11,2019-11-11,2019-11-11,9.0,-3.54,-490.3,0.0,162.0,           ,1.0,1.0,185.0
8876,Vakuutukset,2019-11-11 13:35:05.660377340,2019-11-11,2019-11-11,2019-11-11,9.0,-31.04,-521.34,706.0,106.0,NDEAFIHH   ,0.0,0.0,239.0
8877,Ruoka_paivittaistavarakauppa,2019-11-11 19:28:18.113207530,2019-11-11,2019-11-11,2019-11-11,9.0,-9.51,-530.85,0.0,162.0,           ,1.0,1.0,120.0
8878,Liikkuminen,2019-11-11 19:55:28.301886770,2019-11-11,2019-11-11,2019-11-11,9.0,-65.13,-595.98,0.0,162.0,           ,1.0,1.0,123.0
8879,Saastot_sijoitukset,2019-11-11 22:38:29.433962245,2019-11-11,2019-11-11,2019-11-11,9.0,-1.41,-597.39,0.0,162.0,           ,1.0,1.0,57.0
8880,Ravintolat_kahvilat,2019-11-12 01:21:30.566037720,2019-11-12,2019-11-12,2019-11-12,9.0,-5.34,-602.73,0.0,162.0,           ,1.0,1.0,141.0
8881,Lemmikit,2019-11-12 16:45:16.981132055,2019-11-12,2019-11-12,2019-11-12,9.0,-13.73,-616.46,0.0,106.0,OKOYFIHH   ,0.0,0.0,35.0
8882,Ruoka_paivittaistavarakauppa,2019-11-13 10:52:04.528301865,2019-11-13,2019-11-13,2019-11-13,9.0,-14.14,-630.6,0.0,162.0,           ,1.0,1.0,121.0
8883,Ruoka_paivittaistavarakauppa,2019-11-14 02:15:50.943396200,2019-11-14,2019-11-14,2019-11-14,9.0,-33.31,-663.91,0.0,162.0,           ,1.0,1.0,195.0
8884,Ruoka_paivittaistavarakauppa,2019-11-14 04:58:52.075471675,2019-11-14,2019-11-14,2019-11-14,9.0,-3.37,-667.28,0.0,162.0,           ,1.0,1.0,108.0
8885,Ruoka_paivittaistavarakauppa,2019-11-14 14:02:15.849056580,2019-11-14,2019-11-14,2019-11-14,9.0,-5.62,-672.9,0.0,162.0,           ,1.0,1.0,69.0
8886,Lapset,2019-11-14 20:22:38.490566010,2019-11-14,2019-11-14,2019-11-14,9.0,-5.24,-678.14,0.0,162.0,           ,1.0,1.0,137.0
8887,Lapset,2019-11-14 23:05:39.622641485,2019-11-14,2019-11-14,2019-11-14,9.0,-4.4,-682.54,0.0,162.0,           ,1.0,1.0,127.0
8888,Saastot_sijoitukset,2019-11-15 17:12:27.169811295,2019-11-15,2019-11-15,2019-11-15,9.0,-2.43,-684.97,0.0,162.0,           ,1.0,1.0,153.0
8889,Ruoka_paivittaistavarakauppa,2019-11-18 05:26:02.264150915,2019-11-18,2019-11-18,2019-11-18,9.0,-8.54,-693.51,0.0,162.0,           ,1.0,1.0,95.0
8890,Ruoka_paivittaistavarakauppa,2019-11-18 08:09:03.396226390,2019-11-18,2019-11-18,2019-11-18,9.0,-8.91,-702.42,0.0,162.0,           ,1.0,1.0,199.0
8891,Luokittelemattomat,2019-11-18 08:36:13.584905630,2019-11-18,2019-11-18,2019-11-18,9.0,-4.01,-706.43,0.0,162.0,           ,1.0,1.0,116.0
8892,Ravintolat_kahvilat,2019-11-18 11:19:14.716981105,2019-11-18,2019-11-18,2019-11-18,9.0,-13.15,-719.58,0.0,162.0,           ,1.0,1.0,158.0
8893,Ruoka_paivittaistavarakauppa,2019-11-18 14:29:26.037735820,2019-11-18,2019-11-18,2019-11-18,9.0,-7.79,-727.37,0.0,162.0,           ,1.0,1.0,133.0
8894,Muut,2019-11-18 17:39:37.358490535,2019-11-18,2019-11-18,2019-11-18,9.0,-2.29,-729.66,0.0,162.0,           ,1.0,1.0,180.0
8895,Ravintolat_kahvilat,2019-11-18 23:32:49.811320725,2019-11-18,2019-11-18,2019-11-18,9.0,-2.15,-731.81,0.0,162.0,           ,1.0,1.0,121.0
8896,Ruoka_paivittaistavarakauppa,2019-11-19 02:43:01.132075440,2019-11-19,2019-11-19,2019-11-19,9.0,-10.01,-741.82,0.0,162.0,           ,1.0,1.0,111.0
8897,Liikkuminen,2019-11-19 11:46:24.905660345,2019-11-19,2019-11-19,2019-11-19,9.0,-3.04,-744.86,0.0,162.0,           ,1.0,1.0,186.0
8898,Ruoka_paivittaistavarakauppa,2019-11-19 20:49:48.679245250,2019-11-19,2019-11-19,2019-11-19,9.0,-10.04,-754.9,0.0,162.0,           ,1.0,1.0,195.0
8899,Luottojen_maksut,2019-11-19 23:59:59.999999965,2019-11-19,2019-11-19,2019-11-19,9.0,-7.72,-762.62,0.0,162.0,           ,1.0,1.0,113.0
8900,Ruoka_paivittaistavarakauppa,2019-11-20 05:53:12.452830155,2019-11-20,2019-11-20,2019-11-20,9.0,-6.24,-768.86,0.0,162.0,           ,1.0,1.0,178.0
8901,Ruoka_paivittaistavarakauppa,2019-11-20 18:06:47.547169775,2019-11-20,2019-11-20,2019-11-20,9.0,-4.21,-773.07,0.0,162.0,           ,1.0,1.0,154.0
8902,Matkailu,2019-11-21 09:03:23.773584870,2019-11-21,2019-11-21,2019-11-21,9.0,-8.15,-781.22,0.0,162.0,           ,1.0,1.0,155.0
8903,Ruoka_paivittaistavarakauppa,2019-11-21 14:56:36.226415060,2019-11-21,2019-11-21,2019-11-21,9.0,-6.32,-787.54,0.0,162.0,           ,1.0,1.0,173.0
8904,Ruoka_paivittaistavarakauppa,2019-11-22 00:27:10.188679205,2019-11-22,2019-11-22,2019-11-22,9.0,-0.96,-788.5,0.0,162.0,           ,1.0,1.0,116.0
8905,Ruoka_paivittaistavarakauppa,2019-11-22 12:13:35.094339585,2019-11-22,2019-11-22,2019-11-22,9.0,-4.47,-792.97,0.0,162.0,           ,1.0,1.0,64.0
8906,Ravintolat_kahvilat,2019-11-22 15:23:46.415094300,2019-11-22,2019-11-22,2019-11-22,9.0,-3.03,-796.0,0.0,162.0,           ,1.0,1.0,72.0
8907,Ruoka_paivittaistavarakauppa,2019-11-22 21:16:58.867924490,2019-11-22,2019-11-22,2019-11-22,9.0,-9.63,-805.63,0.0,162.0,           ,1.0,1.0,105.0
8908,Ruoka_paivittaistavarakauppa,2019-11-25 03:10:11.320754680,2019-11-25,2019-11-25,2019-11-25,9.0,-0.72,-806.35,0.0,162.0,           ,1.0,1.0,117.0
8909,Liikkuminen,2019-11-25 03:37:21.509433920,2019-11-25,2019-11-25,2019-11-25,9.0,-5.44,-811.79,0.0,162.0,           ,1.0,1.0,180.0
8910,Ruoka_paivittaistavarakauppa,2019-11-25 06:20:22.641509395,2019-11-25,2019-11-25,2019-11-25,9.0,-3.13,-814.92,0.0,162.0,           ,1.0,1.0,152.0
8911,Ravintolat_kahvilat,2019-11-25 09:30:33.962264110,2019-11-25,2019-11-25,2019-11-25,9.0,-8.81,-823.73,0.0,162.0,           ,1.0,1.0,195.0
8912,Liikkuminen,2019-11-25 12:40:45.283018825,2019-11-25,2019-11-25,2019-11-25,9.0,-11.86,-835.59,0.0,162.0,           ,1.0,1.0,90.0
8913,Matkailu,2019-11-25 15:50:56.603773540,2019-11-25,2019-11-25,2019-11-25,9.0,-32.38,-867.97,0.0,106.0,OKOYFIHH   ,1.0,0.0,33.0
8914,Ruoka_paivittaistavarakauppa,2019-11-25 18:33:57.735849015,2019-11-25,2019-11-25,2019-11-25,9.0,-15.08,-883.05,0.0,162.0,           ,1.0,1.0,172.0
8915,Kulttuuri_viihde,2019-11-25 21:44:09.056603730,2019-11-25,2019-11-25,2019-11-25,9.0,-6.35,-889.4,0.0,162.0,           ,1.0,1.0,181.0
8916,Ruoka_paivittaistavarakauppa,2019-11-25 22:11:19.245282970,2019-11-25,2019-11-25,2019-11-25,9.0,-39.4,-928.8,0.0,162.0,           ,1.0,1.0,57.0
8917,Ruoka_paivittaistavarakauppa,2019-11-26 06:47:32.830188635,2019-11-26,2019-11-26,2019-11-26,9.0,-0.93,-929.73,0.0,162.0,           ,1.0,1.0,156.0
8918,Lapset,2019-11-27 00:54:20.377358445,2019-11-27,2019-11-27,2019-11-27,9.0,-7.14,-936.87,0.0,162.0,           ,1.0,1.0,121.0
8919,Ruoka_paivittaistavarakauppa,2019-11-27 09:57:44.150943350,2019-11-27,2019-11-27,2019-11-27,9.0,-4.62,-941.49,0.0,162.0,           ,1.0,1.0,59.0
8920,Asuminen,2019-11-27 19:01:07.924528255,2019-11-27,2019-11-27,2019-11-27,9.0,-4.8,-946.29,0.0,162.0,           ,1.0,1.0,120.0
8921,Ruoka_paivittaistavarakauppa,2019-11-28 04:04:31.698113160,2019-11-28,2019-11-28,2019-11-28,9.0,-5.32,-951.61,0.0,162.0,           ,1.0,1.0,198.0
8922,Shoppailu,2019-11-28 10:24:54.339622590,2019-11-28,2019-11-28,2019-11-28,9.0,-0.92,-952.53,0.0,162.0,           ,1.0,1.0,190.0
8923,Ruoka_paivittaistavarakauppa,2019-11-28 13:07:55.471698065,2019-11-28,2019-11-28,2019-11-28,9.0,-4.74,-957.27,0.0,162.0,           ,1.0,1.0,125.0
8924,Liikkuminen,2019-11-29 01:21:30.566037685,2019-11-29,2019-11-29,2019-11-29,9.0,-11.53,-968.8,0.0,162.0,           ,1.0,1.0,129.0
8925,Ruoka_paivittaistavarakauppa,2019-11-29 07:14:43.018867875,2019-11-29,2019-11-29,2019-11-29,9.0,-1.2,-970.0,0.0,162.0,           ,1.0,1.0,157.0
8926,Liikkuminen,2019-11-29 16:18:06.792452780,2019-11-29,2019-11-29,2019-11-28,9.0,-4.96,-974.96,0.0,162.0,           ,1.0,1.0,57.0
8927,Asuminen,2019-11-29 19:28:18.113207495,2019-11-29,2019-11-29,2019-11-29,9.0,-1.4,-976.36,0.0,162.0,           ,1.0,1.0,170.0
8928,Liikkuminen,2019-12-02 04:20:34.285714284,2019-12-02,2019-12-03,2019-12-02,9.0,-65.72,-1042.08,0.0,162.0,           ,1.0,1.0,151.0
8929,Ravintolat_kahvilat,2019-12-02 14:10:17.142857142,2019-12-02,2019-12-04,2019-12-02,9.0,-4.7,-1046.78,0.0,162.0,           ,1.0,1.0,105.0
8930,Ruoka_paivittaistavarakauppa,2019-12-02 18:30:51.428571426,2019-12-02,2019-12-02,2019-12-02,9.0,-3.76,-1050.54,0.0,162.0,           ,1.0,1.0,146.0
8931,Matkailu,2019-12-03 08:41:08.571428568,2019-12-03,2019-12-03,2019-12-03,9.0,-47.74,-1098.28,706.0,105.0,OKOYFIHH   ,1.0,0.0,237.0
8932,Asuminen,2019-12-03 22:51:25.714285710,2019-12-03,2019-12-03,2019-12-03,9.0,-41.35,-1139.63,706.0,129.0,OKOYFIHH   ,0.0,0.0,240.0
8933,Ruoka_paivittaistavarakauppa,2019-12-04 03:11:59.999999994,2019-12-04,2019-12-04,2019-12-04,9.0,-1.1,-1140.73,0.0,162.0,           ,1.0,1.0,150.0
8934,Kulttuuri_viihde,2019-12-04 13:01:42.857142852,2019-12-04,2019-12-04,2019-12-04,9.0,-0.77,-1141.5,0.0,162.0,           ,1.0,1.0,173.0
8935,Ruoka_paivittaistavarakauppa,2019-12-05 17:22:17.142857136,2019-12-05,2019-12-05,2019-12-05,9.0,-3.72,-1145.22,0.0,162.0,           ,1.0,1.0,58.0
8936,Ravintolat_kahvilat,2019-12-06 02:03:25.714285704,2019-12-06,2019-12-06,2019-12-06,9.0,-3.78,-1149.0,0.0,162.0,           ,1.0,1.0,75.0
8937,Saastot_sijoitukset,2019-12-06 07:32:34.285714278,2019-12-06,2019-12-06,2019-12-06,9.0,-25.18,-1174.18,0.0,162.0,           ,1.0,1.0,117.0
8938,Ruoka_paivittaistavarakauppa,2019-12-06 11:53:08.571428562,2019-12-06,2019-12-06,2019-12-06,9.0,-5.26,-1179.44,0.0,162.0,           ,1.0,1.0,123.0
8939,Ravintolat_kahvilat,2019-12-06 21:42:51.428571420,2019-12-06,2019-12-06,2019-12-06,9.0,-19.47,-1198.91,0.0,162.0,           ,1.0,1.0,203.0
8940,Ravintolat_kahvilat,2019-12-09 06:23:59.999999988,2019-12-09,2019-12-09,2019-12-09,9.0,-11.37,-1210.28,0.0,162.0,           ,1.0,1.0,136.0
8941,Ruoka_paivittaistavarakauppa,2019-12-09 16:13:42.857142846,2019-12-09,2019-12-09,2019-12-09,9.0,-2.12,-1212.4,0.0,162.0,           ,1.0,1.0,145.0
8942,Ravintolat_kahvilat,2019-12-09 20:34:17.142857130,2019-12-09,2019-12-09,2019-12-09,9.0,-4.61,-1217.01,0.0,162.0,           ,1.0,1.0,69.0
8943,Ruoka_paivittaistavarakauppa,2019-12-10 10:44:34.285714272,2019-12-10,2019-12-10,2019-12-09,9.0,-0.45,-1217.46,0.0,162.0,           ,1.0,1.0,115.0
8944,Ruoka_paivittaistavarakauppa,2019-12-11 00:54:51.428571414,2019-12-11,2019-12-11,2019-12-11,9.0,-29.02,-1246.48,0.0,162.0,           ,1.0,1.0,59.0
8945,Hyvinvointijakauneus,2019-12-11 15:05:08.571428556,2019-12-11,2019-12-11,2019-12-11,9.0,-3.91,-1250.39,0.0,162.0,           ,1.0,1.0,111.0
8946,Ruoka_paivittaistavarakauppa,2019-12-12 05:15:25.714285698,2019-12-12,2019-12-12,2019-12-12,9.0,-15.36,-1265.75,0.0,162.0,           ,1.0,1.0,132.0
8947,Liikkuminen,2019-12-12 09:35:59.999999982,2019-12-12,2019-12-12,2019-12-12,9.0,-1.73,-1267.48,0.0,162.0,           ,1.0,1.0,138.0
8948,Ruoka_paivittaistavarakauppa,2019-12-12 19:25:42.857142840,2019-12-12,2019-12-12,2019-12-12,9.0,-2.99,-1270.47,0.0,162.0,           ,1.0,1.0,133.0
8949,Tulot,2019-12-12 23:46:17.142857124,2019-12-12,2019-12-12,2019-12-12,9.0,-4.46,-1274.93,0.0,162.0,           ,1.0,1.0,121.0
8950,Lapset,2019-12-14 13:56:34.285714266,2019-12-14,2019-12-14,2019-12-14,9.0,-21.31,-1296.24,0.0,106.0,OKOYFIHH   ,0.0,0.0,37.0
8951,Luokittelemattomat,2019-12-15 04:06:51.428571408,2019-12-15,2019-12-15,2019-12-15,9.0,-39.02,-1335.26,0.0,106.0,OKOYFIHH   ,1.0,0.0,13.0
8952,Ruoka_paivittaistavarakauppa,2019-12-16 08:27:25.714285692,2019-12-16,2019-12-16,2019-12-16,9.0,-2.1,-1337.36,0.0,162.0,           ,1.0,1.0,90.0
8953,Muut,2019-12-16 18:17:08.571428550,2019-12-16,2019-12-16,2019-12-16,9.0,-5.04,-1342.4,0.0,162.0,           ,1.0,1.0,147.0
8954,Liikkuminen,2019-12-16 22:37:42.857142834,2019-12-16,2019-12-16,2019-12-16,9.0,-3.56,-1345.96,0.0,162.0,           ,1.0,1.0,115.0
8955,Tulot,2019-12-18 02:58:17.142857118,2019-12-18,2019-12-18,2019-12-18,9.0,-3.1,-1349.06,0.0,162.0,           ,1.0,1.0,136.0
8956,Ruoka_paivittaistavarakauppa,2019-12-18 12:47:59.999999976,2019-12-18,2019-12-18,2019-12-18,9.0,-0.87,-1349.93,0.0,162.0,           ,1.0,1.0,173.0
8957,Ruoka_paivittaistavarakauppa,2019-12-18 17:08:34.285714260,2019-12-18,2019-12-18,2019-12-18,9.0,-1.69,-1351.62,0.0,162.0,           ,1.0,1.0,167.0
8958,Liikkuminen,2019-12-19 15:59:59.999999970,2019-12-19,2019-12-19,2019-12-19,9.0,-4.68,-1356.3,0.0,162.0,           ,1.0,1.0,147.0
8959,Lapset,2019-12-19 21:29:08.571428544,2019-12-19,2019-12-19,2019-12-19,9.0,-9.64,-1365.94,0.0,162.0,           ,1.0,1.0,69.0
8960,Ravintolat_kahvilat,2019-12-20 01:49:42.857142828,2019-12-20,2019-12-20,2019-12-20,9.0,-1.9,-1367.84,0.0,162.0,           ,1.0,1.0,96.0
8961,Tulot,2019-12-20 07:18:51.428571402,2019-12-20,2019-12-20,2019-12-20,9.0,102.97,-1264.87,0.0,505.0,           ,1.0,1.0,215.0
8962,Ravintolat_kahvilat,2019-12-20 11:39:25.714285686,2019-12-20,2019-12-20,2019-12-20,9.0,-2.69,-1267.56,0.0,162.0,           ,1.0,1.0,145.0
8963,Ruoka_paivittaistavarakauppa,2019-12-23 00:41:08.571428538,2019-12-23,2019-12-23,2019-12-23,9.0,-9.26,-1276.82,0.0,162.0,           ,1.0,1.0,108.0
8964,Ravintolat_kahvilat,2019-12-23 06:10:17.142857112,2019-12-23,2019-12-25,2019-12-23,9.0,-3.44,-1280.26,0.0,162.0,           ,1.0,1.0,123.0
8965,Ruoka_paivittaistavarakauppa,2019-12-23 10:30:51.428571396,2019-12-23,2019-12-23,2019-12-23,9.0,-7.67,-1287.93,0.0,162.0,           ,1.0,1.0,128.0
8966,Ruoka_paivittaistavarakauppa,2019-12-23 20:20:34.285714254,2019-12-23,2019-12-23,2019-12-23,9.0,-14.95,-1302.88,0.0,162.0,           ,1.0,1.0,177.0
8967,Ruoka_paivittaistavarakauppa,2019-12-24 14:51:25.714285680,2019-12-24,2019-12-24,2019-12-24,9.0,-4.34,-1307.22,0.0,162.0,           ,1.0,1.0,137.0
8968,Ruoka_paivittaistavarakauppa,2019-12-24 23:32:34.285714248,2019-12-24,2019-12-24,2019-12-24,9.0,-27.06,-1334.28,0.0,162.0,           ,1.0,1.0,69.0
8969,Kulttuuri_viihde,2019-12-26 05:01:42.857142822,2019-12-26,2019-12-26,2019-12-26,9.0,-4.83,-1339.11,0.0,162.0,           ,1.0,1.0,118.0
8970,Ravintolat_kahvilat,2019-12-27 09:22:17.142857106,2019-12-27,2019-12-27,2019-12-27,9.0,-3.93,-1343.04,0.0,162.0,           ,1.0,1.0,105.0
8971,Ravintolat_kahvilat,2019-12-27 13:42:51.428571390,2019-12-27,2019-12-27,2019-12-27,9.0,-0.25,-1343.29,0.0,162.0,           ,1.0,1.0,129.0
8972,Ruoka_paivittaistavarakauppa,2019-12-27 19:11:59.999999964,2019-12-27,2019-12-27,2019-12-27,9.0,-7.72,-1351.01,0.0,162.0,           ,1.0,1.0,108.0
8973,Tulot,2019-12-28 18:03:25.714285674,2019-12-28,2019-12-28,2019-12-28,9.0,421.3,-929.71,0.0,505.0,           ,1.0,1.0,214.0
8974,Asuminen,2019-12-29 16:54:51.428571384,2019-12-29,2019-12-29,2019-12-29,9.0,-19.77,-949.48,0.0,106.0,DABAFIHH   ,0.0,0.0,14.0
8975,Luottojen_maksut,2019-12-29 22:23:59.999999958,2019-12-29,2019-12-29,2019-12-29,9.0,-57.8,-1007.28,0.0,106.0,NDEAFIHH   ,0.0,0.0,42.0
8976,Luokittelemattomat,2019-12-30 02:44:34.285714242,2019-12-30,2019-12-30,2019-12-30,9.0,-36.89,-1044.17,0.0,106.0,OKOYFIHH   ,1.0,0.0,36.0
8977,Liikkuminen,2019-12-30 08:13:42.857142816,2019-12-30,2019-12-30,2019-12-30,9.0,-6.3,-1050.47,0.0,162.0,           ,1.0,1.0,74.0
8978,Ravintolat_kahvilat,2019-12-30 12:34:17.142857100,2019-12-30,2019-12-30,2019-12-30,9.0,-5.59,-1056.06,0.0,106.0,OKOYFIHH   ,0.0,0.0,16.0
8979,Ruoka_paivittaistavarakauppa,2019-12-31 03:53:08.571428532,2019-12-31,2019-12-31,2019-12-31,9.0,-1.79,-1057.85,0.0,162.0,           ,1.0,1.0,112.0
8980,Ruoka_paivittaistavarakauppa,2020-01-01 13:24:19.459459459,2020-01-01,2020-01-01,2020-01-01,9.0,-2.43,-1060.28,0.0,162.0,           ,1.0,1.0,63.0
8981,Ruoka_paivittaistavarakauppa,2020-01-02 02:48:38.918918918,2020-01-02,2020-01-02,2020-01-02,9.0,-5.43,-1065.71,0.0,162.0,           ,1.0,1.0,140.0
8982,Kulttuuri_viihde,2020-01-02 16:12:58.378378377,2020-01-02,2020-01-02,2020-01-02,9.0,-6.35,-1072.06,0.0,162.0,           ,1.0,1.0,118.0
8983,Kulttuuri_viihde,2020-01-03 05:37:17.837837836,2020-01-03,2020-01-03,2020-01-03,9.0,-4.65,-1076.71,0.0,162.0,           ,1.0,1.0,163.0
8984,Ravintolat_kahvilat,2020-01-03 19:01:37.297297295,2020-01-03,2020-01-03,2020-01-03,9.0,-4.26,-1080.97,0.0,162.0,           ,1.0,1.0,127.0
8985,Lemmikit,2020-01-06 00:38:55.135135131,2020-01-06,2020-01-06,2020-01-06,9.0,-38.98,-1119.95,0.0,106.0,OKOYFIHH   ,0.0,0.0,14.0
8986,Ravintolat_kahvilat,2020-01-06 08:25:56.756756754,2020-01-07,2020-01-06,2020-01-06,9.0,-1.24,-1121.19,0.0,162.0,           ,1.0,1.0,158.0
8987,Ruoka_paivittaistavarakauppa,2020-01-06 11:14:35.675675672,2020-01-06,2020-01-06,2020-01-06,9.0,-7.34,-1128.53,0.0,162.0,           ,1.0,1.0,144.0
8988,Ruoka_paivittaistavarakauppa,2020-01-06 14:03:14.594594590,2020-01-06,2020-01-06,2020-01-06,9.0,-0.54,-1129.07,0.0,162.0,           ,1.0,1.0,158.0
8989,Ruoka_paivittaistavarakauppa,2020-01-07 03:27:34.054054049,2020-01-07,2020-01-08,2020-01-07,9.0,-6.79,-1135.86,0.0,162.0,           ,1.0,1.0,136.0
8990,Ruoka_paivittaistavarakauppa,2020-01-07 06:16:12.972972967,2020-01-07,2020-01-07,2020-01-07,9.0,-4.39,-1140.25,0.0,162.0,           ,1.0,1.0,131.0
8991,Liikkuminen,2020-01-07 16:51:53.513513508,2020-01-07,2020-01-07,2020-01-07,9.0,-7.81,-1148.06,0.0,162.0,           ,1.0,1.0,116.0
8992,Ruoka_paivittaistavarakauppa,2020-01-07 19:40:32.432432426,2020-01-07,2020-01-07,2020-01-07,9.0,-5.79,-1153.85,0.0,162.0,           ,1.0,1.0,200.0
8993,Ruoka_paivittaistavarakauppa,2020-01-07 21:50:16.216216213,2020-01-07,2020-01-07,2020-01-07,9.0,-12.42,-1166.27,0.0,162.0,           ,1.0,1.0,137.0
8994,Ruoka_paivittaistavarakauppa,2020-01-09 09:04:51.891891885,2020-01-09,2020-01-09,2020-01-09,9.0,-8.19,-1174.46,0.0,162.0,           ,1.0,1.0,118.0
8995,Ruoka_paivittaistavarakauppa,2020-01-09 22:29:11.351351344,2020-01-09,2020-01-09,2020-01-09,9.0,-1.97,-1176.43,0.0,162.0,           ,1.0,1.0,69.0
8996,Ruoka_paivittaistavarakauppa,2020-01-10 01:17:50.270270262,2020-01-10,2020-01-10,2020-01-10,9.0,-1.52,-1177.95,0.0,162.0,           ,1.0,1.0,173.0
8997,Tulot,2020-01-12 14:42:09.729729721,2020-01-12,2020-01-12,2020-01-12,9.0,1464.92,286.97,0.0,505.0,           ,1.0,1.0,213.0
8998,Ruoka_paivittaistavarakauppa,2020-01-13 04:06:29.189189180,2020-01-13,2020-01-13,2020-01-13,9.0,-20.55,266.42,0.0,162.0,           ,1.0,1.0,136.0
8999,Terveys,2020-01-13 06:55:08.108108098,2020-01-13,2020-01-13,2020-01-13,9.0,-6.76,259.66,0.0,162.0,           ,1.0,1.0,60.0
9000,Ravintolat_kahvilat,2020-01-13 09:43:47.027027016,2020-01-13,2020-01-13,2020-01-13,9.0,-1.24,258.42,0.0,162.0,           ,1.0,1.0,118.0
9001,Ruoka_paivittaistavarakauppa,2020-01-13 11:53:30.810810803,2020-01-13,2020-01-14,2020-01-13,9.0,-31.4,227.02,0.0,162.0,           ,1.0,1.0,195.0
9002,Ruoka_paivittaistavarakauppa,2020-01-13 17:30:48.648648639,2020-01-13,2020-01-14,2020-01-13,9.0,-59.23,167.79,0.0,162.0,           ,1.0,1.0,117.0
9003,Matkailu,2020-01-13 20:19:27.567567557,2020-01-13,2020-01-13,2020-01-13,9.0,-17.5,150.29,0.0,162.0,           ,1.0,1.0,174.0
9004,Ruoka_paivittaistavarakauppa,2020-01-15 12:32:25.945945934,2020-01-15,2020-01-15,2020-01-15,9.0,-35.0,115.29,0.0,162.0,           ,1.0,1.0,65.0
9005,Ravintolat_kahvilat,2020-01-15 23:08:06.486486475,2020-01-15,2020-01-15,2020-01-15,9.0,-9.16,106.13,0.0,162.0,           ,1.0,1.0,111.0
9006,Ravintolat_kahvilat,2020-01-16 01:56:45.405405393,2020-01-16,2020-01-16,2020-01-16,9.0,-10.41,95.72,0.0,162.0,           ,1.0,1.0,147.0
9007,Ruoka_paivittaistavarakauppa,2020-01-16 15:21:04.864864852,2020-01-16,2020-01-16,2020-01-16,9.0,-70.56,25.16,0.0,162.0,           ,1.0,1.0,150.0
9008,Ravintolat_kahvilat,2020-01-17 04:45:24.324324311,2020-01-17,2020-01-17,2020-01-17,9.0,-2.8,22.36,0.0,162.0,           ,1.0,1.0,117.0
9009,Ravintolat_kahvilat,2020-01-17 18:09:43.783783770,2020-01-17,2020-01-17,2020-01-17,9.0,-4.57,17.79,0.0,162.0,           ,1.0,1.0,141.0
9010,Liikkuminen,2020-01-19 23:47:01.621621606,2020-01-19,2020-01-19,2020-01-19,9.0,-56.19,-38.4,0.0,106.0,OKOYFIHH   ,0.0,0.0,19.0
9011,Ruoka_paivittaistavarakauppa,2020-01-20 02:35:40.540540524,2020-01-20,2020-01-20,2020-01-20,9.0,-2.78,-41.18,0.0,162.0,           ,1.0,1.0,146.0
9012,Ravintolat_kahvilat,2020-01-20 07:34:03.243243229,2020-01-20,2020-01-20,2020-01-20,9.0,-0.08,-41.26,0.0,162.0,           ,1.0,1.0,123.0
9013,Ruoka_paivittaistavarakauppa,2020-01-20 13:11:21.081081065,2020-01-20,2020-01-20,2020-01-20,9.0,-2.67,-43.93,0.0,162.0,           ,1.0,1.0,146.0
9014,Luottojen_maksut,2020-01-20 20:58:22.702702688,2020-01-20,2020-01-20,2020-01-20,9.0,-7.15,-51.08,0.0,162.0,           ,1.0,1.0,144.0
9015,Ruoka_paivittaistavarakauppa,2020-01-21 10:22:42.162162147,2020-01-21,2020-01-22,2020-01-21,9.0,-7.22,-58.3,0.0,162.0,           ,1.0,1.0,142.0
9016,Liikkuminen,2020-01-21 15:59:59.999999983,2020-01-21,2020-01-21,2020-01-21,9.0,-2.5,-60.8,0.0,162.0,           ,1.0,1.0,168.0
9017,Ruoka_paivittaistavarakauppa,2020-01-22 18:48:38.918918901,2020-01-22,2020-01-22,2020-01-22,9.0,-12.71,-73.51,0.0,162.0,           ,1.0,1.0,58.0
9018,Ruoka_paivittaistavarakauppa,2020-01-23 05:24:19.459459442,2020-01-23,2020-01-23,2020-01-23,9.0,-11.17,-84.68,0.0,162.0,           ,1.0,1.0,77.0
9019,Ruoka_paivittaistavarakauppa,2020-01-23 08:12:58.378378360,2020-01-23,2020-01-23,2020-01-23,9.0,-4.0,-88.68,0.0,162.0,           ,1.0,1.0,128.0
9020,Luokittelemattomat,2020-01-23 21:37:17.837837819,2020-01-23,2020-01-23,2020-01-23,9.0,-14.11,-102.79,0.0,162.0,           ,1.0,1.0,125.0
9021,Ravintolat_kahvilat,2020-01-24 11:01:37.297297278,2020-01-24,2020-01-24,2020-01-24,9.0,-10.45,-113.24,0.0,162.0,           ,1.0,1.0,201.0
9022,Tulot,2020-01-24 16:38:55.135135114,2020-01-24,2020-01-24,2020-01-24,9.0,246.14,132.9,701.0,522.0,           ,1.0,1.0,236.0
9023,Asuminen,2020-01-27 00:25:56.756756737,2020-01-27,2020-01-27,2020-01-27,9.0,-27.16,105.74,0.0,162.0,           ,1.0,1.0,90.0
9024,Ravintolat_kahvilat,2020-01-27 03:14:35.675675655,2020-01-27,2020-01-27,2020-01-27,9.0,-5.32,100.42,0.0,162.0,           ,1.0,1.0,112.0
9025,Ruoka_paivittaistavarakauppa,2020-01-27 06:03:14.594594573,2020-01-27,2020-01-27,2020-01-27,9.0,-34.92,65.5,0.0,162.0,           ,1.0,1.0,113.0
9026,Luottojen_maksut,2020-01-27 13:50:16.216216196,2020-01-27,2020-01-27,2020-01-27,9.0,-10.87,54.63,0.0,162.0,           ,1.0,1.0,95.0
9027,Ruoka_paivittaistavarakauppa,2020-01-27 19:27:34.054054032,2020-01-27,2020-01-27,2020-01-27,9.0,-4.67,49.96,0.0,162.0,           ,1.0,1.0,87.0
9028,Ruoka_paivittaistavarakauppa,2020-01-27 22:16:12.972972950,2020-01-27,2020-01-27,2020-01-27,9.0,-0.46,49.5,0.0,162.0,           ,1.0,1.0,128.0
9029,Liikkuminen,2020-01-29 01:04:51.891891868,2020-01-29,2020-01-29,2020-01-29,9.0,-12.15,37.35,0.0,162.0,           ,1.0,1.0,57.0
9030,Ruoka_paivittaistavarakauppa,2020-01-30 08:51:53.513513491,2020-01-30,2020-01-30,2020-01-30,9.0,-7.66,29.69,0.0,162.0,           ,1.0,1.0,170.0
9031,Ruoka_paivittaistavarakauppa,2020-01-30 11:40:32.432432409,2020-01-30,2020-01-30,2020-01-30,9.0,-6.52,23.17,0.0,162.0,           ,1.0,1.0,118.0
9032,Ruoka_paivittaistavarakauppa,2020-01-31 03:53:30.810810786,2020-01-31,2020-01-31,2020-01-31,9.0,-2.26,20.91,0.0,162.0,           ,1.0,1.0,105.0
9033,Kulttuuri_viihde,2020-01-31 14:29:11.351351327,2020-01-31,2020-01-31,2020-01-31,9.0,-10.4,10.51,0.0,162.0,           ,1.0,1.0,179.0
9034,Lemmikit,2020-01-31 17:17:50.270270245,2020-01-31,2020-01-31,2020-01-31,9.0,-2.51,8.0,0.0,162.0,           ,1.0,1.0,77.0
9035,Muut,2020-02-02 12:18:46.956521739,2020-02-02,2020-02-02,2020-02-02,9.0,-2.7,5.3,0.0,105.0,OKOYFIHH   ,1.0,0.0,11.0
9036,Tulot,2020-02-03 00:25:02.608695652,2020-02-03,2020-02-03,2020-02-03,9.0,44.56,49.86,710.0,505.0,           ,1.0,1.0,254.0
9037,Tulot,2020-02-03 12:06:15.652173913,2020-02-03,2020-02-03,2020-02-03,9.0,29.78,79.64,710.0,505.0,           ,1.0,1.0,254.0
9038,Ruoka_paivittaistavarakauppa,2020-02-03 12:31:18.260869565,2020-02-03,2020-02-03,2020-02-03,9.0,-4.83,74.81,0.0,162.0,           ,1.0,1.0,112.0
9039,Tulot,2020-02-04 00:12:31.304347826,2020-02-04,2020-02-04,2020-02-04,9.0,21.56,96.37,710.0,505.0,           ,1.0,1.0,254.0
9040,Ruoka_paivittaistavarakauppa,2020-02-04 00:37:33.913043478,2020-02-04,2020-02-04,2020-02-04,9.0,-3.1,93.27,0.0,162.0,           ,1.0,1.0,82.0
9041,Ruoka_paivittaistavarakauppa,2020-02-04 00:50:05.217391304,2020-02-04,2020-02-04,2020-02-04,9.0,-13.46,79.81,0.0,162.0,           ,1.0,1.0,71.0
9042,Ruoka_paivittaistavarakauppa,2020-02-04 12:43:49.565217391,2020-02-04,2020-02-04,2020-02-04,9.0,-1.57,78.24,0.0,162.0,           ,1.0,1.0,74.0
9043,Ruoka_paivittaistavarakauppa,2020-02-04 12:56:20.869565217,2020-02-04,2020-02-04,2020-02-04,9.0,-21.29,56.95,0.0,162.0,           ,1.0,1.0,144.0
9044,Ruoka_paivittaistavarakauppa,2020-02-05 01:02:36.521739130,2020-02-05,2020-02-05,2020-02-04,9.0,-6.26,50.69,0.0,162.0,           ,1.0,1.0,131.0
9045,Lapset,2020-02-06 13:08:52.173913043,2020-02-06,2020-02-06,2020-02-06,9.0,-44.25,6.44,0.0,162.0,           ,1.0,1.0,151.0
9046,Ravintolat_kahvilat,2020-02-07 01:15:07.826086956,2020-02-07,2020-02-07,2020-02-07,9.0,-9.55,-3.11,706.0,147.0,OKOYFIHH   ,0.0,0.0,251.0
9047,Lemmikit,2020-02-07 13:21:23.478260869,2020-02-07,2020-02-07,2020-02-07,9.0,-33.52,-36.63,0.0,106.0,OKOYFIHH   ,1.0,0.0,14.0
9048,Ruoka_paivittaistavarakauppa,2020-02-10 01:27:39.130434782,2020-02-10,2020-02-11,2020-02-10,9.0,-70.55,-107.18,0.0,162.0,           ,1.0,1.0,138.0
9049,Ruoka_paivittaistavarakauppa,2020-02-10 01:40:10.434782608,2020-02-10,2020-02-10,2020-02-10,9.0,-4.04,-111.22,0.0,162.0,           ,1.0,1.0,145.0
9050,Ravintolat_kahvilat,2020-02-10 01:52:41.739130434,2020-02-10,2020-02-10,2020-02-10,9.0,-8.41,-119.63,0.0,162.0,           ,1.0,1.0,131.0
9051,Lemmikit,2020-02-10 13:33:54.782608695,2020-02-10,2020-02-10,2020-02-10,9.0,-8.86,-128.49,0.0,162.0,           ,1.0,1.0,100.0
9052,Ruoka_paivittaistavarakauppa,2020-02-10 13:46:26.086956521,2020-02-10,2020-02-10,2020-02-10,9.0,-4.26,-132.75,0.0,162.0,           ,1.0,1.0,158.0
9053,Kulttuuri_viihde,2020-02-10 13:58:57.391304347,2020-02-10,2020-02-11,2020-02-10,9.0,-20.44,-153.19,0.0,162.0,           ,1.0,1.0,57.0
9054,Harrastukset,2020-02-11 02:05:13.043478260,2020-02-11,2020-02-11,2020-02-11,9.0,-0.79,-153.98,0.0,162.0,           ,1.0,1.0,143.0
9055,Ruoka_paivittaistavarakauppa,2020-02-11 14:11:28.695652173,2020-02-11,2020-02-12,2020-02-11,9.0,-0.66,-154.64,0.0,162.0,           ,1.0,1.0,138.0
9056,Ruoka_paivittaistavarakauppa,2020-02-11 14:23:59.999999999,2020-02-11,2020-02-11,2020-02-11,9.0,-3.61,-158.25,0.0,162.0,           ,1.0,1.0,58.0
9057,Ruoka_paivittaistavarakauppa,2020-02-12 02:17:44.347826086,2020-02-12,2020-02-12,2020-02-12,9.0,-2.17,-160.42,0.0,162.0,           ,1.0,1.0,144.0
9058,Kulttuuri_viihde,2020-02-12 14:49:02.608695651,2020-02-12,2020-02-12,2020-02-12,9.0,-8.67,-169.09,0.0,162.0,           ,1.0,1.0,172.0
9059,Ruoka_paivittaistavarakauppa,2020-02-13 02:55:18.260869564,2020-02-13,2020-02-13,2020-02-13,9.0,-4.94,-174.03,0.0,162.0,           ,1.0,1.0,180.0
9060,Muut,2020-02-13 15:01:33.913043477,2020-02-13,2020-02-13,2020-02-13,9.0,-1.03,-175.06,0.0,162.0,           ,1.0,1.0,139.0
9061,Matkailu,2020-02-14 02:30:15.652173912,2020-02-14,2020-02-14,2020-02-14,9.0,-12.68,-187.74,0.0,162.0,           ,1.0,1.0,122.0
9062,Ruoka_paivittaistavarakauppa,2020-02-14 02:42:46.956521738,2020-02-14,2020-02-14,2020-02-14,9.0,-6.24,-193.98,0.0,162.0,           ,1.0,1.0,162.0
9063,Ruoka_paivittaistavarakauppa,2020-02-14 14:36:31.304347825,2020-02-14,2020-02-14,2020-02-14,9.0,-0.51,-194.49,0.0,162.0,           ,1.0,1.0,116.0
9064,Ruoka_paivittaistavarakauppa,2020-02-17 03:07:49.565217390,2020-02-17,2020-02-17,2020-02-17,9.0,-8.92,-203.41,0.0,162.0,           ,1.0,1.0,58.0
9065,Ruoka_paivittaistavarakauppa,2020-02-17 03:20:20.869565216,2020-02-17,2020-02-17,2020-02-17,9.0,-2.95,-206.36,0.0,162.0,           ,1.0,1.0,57.0
9066,Asuminen,2020-02-17 03:32:52.173913042,2020-02-17,2020-02-17,2020-02-17,9.0,-19.13,-225.49,0.0,129.0,DABAFIHH   ,0.0,0.0,48.0
9067,Ruoka_paivittaistavarakauppa,2020-02-17 15:14:05.217391303,2020-02-17,2020-02-17,2020-02-17,9.0,-2.45,-227.94,0.0,162.0,           ,1.0,1.0,81.0
9068,Ruoka_paivittaistavarakauppa,2020-02-17 15:26:36.521739129,2020-02-17,2020-02-17,2020-02-17,9.0,-7.67,-235.61,0.0,162.0,           ,1.0,1.0,146.0
9069,Muut,2020-02-18 03:45:23.478260868,2020-02-18,2020-02-18,2020-02-18,9.0,-17.87,-253.48,0.0,103.0,           ,0.0,1.0,2.0
9070,Asuminen,2020-02-18 15:39:07.826086955,2020-02-18,2020-02-18,2020-02-18,9.0,-13.38,-266.86,706.0,129.0,NDEAFIHH   ,0.0,0.0,240.0
9071,Ravintolat_kahvilat,2020-02-19 15:51:39.130434781,2020-02-19,2020-02-20,2020-02-19,9.0,-0.52,-267.38,0.0,162.0,           ,1.0,1.0,197.0
9072,Ruoka_paivittaistavarakauppa,2020-02-20 03:57:54.782608694,2020-02-20,2020-02-20,2020-02-20,9.0,-1.05,-268.43,0.0,162.0,           ,1.0,1.0,117.0
9073,Ruoka_paivittaistavarakauppa,2020-02-20 04:10:26.086956520,2020-02-20,2020-02-20,2020-02-20,9.0,-1.04,-269.47,0.0,162.0,           ,1.0,1.0,138.0
9074,Ruoka_paivittaistavarakauppa,2020-02-20 04:22:57.391304346,2020-02-20,2020-02-20,2020-02-20,9.0,-10.89,-280.36,0.0,162.0,           ,1.0,1.0,195.0
9075,Ruoka_paivittaistavarakauppa,2020-02-20 16:04:10.434782607,2020-02-20,2020-02-20,2020-02-20,9.0,-3.96,-284.32,0.0,162.0,           ,1.0,1.0,112.0
9076,Ruoka_paivittaistavarakauppa,2020-02-21 16:16:41.739130433,2020-02-21,2020-02-21,2020-02-20,9.0,-1.0,-285.32,0.0,162.0,           ,1.0,1.0,115.0
9077,Shoppailu,2020-02-21 16:29:13.043478259,2020-02-21,2020-02-21,2020-02-21,9.0,-13.24,-298.56,0.0,162.0,           ,1.0,1.0,69.0
9078,Ruoka_paivittaistavarakauppa,2020-02-24 04:35:28.695652172,2020-02-24,2020-02-24,2020-02-24,9.0,-0.69,-299.25,0.0,162.0,           ,1.0,1.0,162.0
9079,Muut,2020-02-24 04:47:59.999999998,2020-02-24,2020-02-26,2020-02-24,9.0,-1.56,-300.81,0.0,162.0,           ,1.0,1.0,132.0
9080,Ruoka_paivittaistavarakauppa,2020-02-24 05:00:31.304347824,2020-02-24,2020-02-24,2020-02-24,9.0,-9.14,-309.95,0.0,162.0,           ,1.0,1.0,108.0
9081,Ruoka_paivittaistavarakauppa,2020-02-24 16:41:44.347826085,2020-02-24,2020-02-24,2020-02-24,9.0,-4.67,-314.62,0.0,162.0,           ,1.0,1.0,124.0
9082,Ruoka_paivittaistavarakauppa,2020-02-24 16:54:15.652173911,2020-02-24,2020-02-24,2020-02-24,9.0,-0.66,-315.28,0.0,162.0,           ,1.0,1.0,112.0
9083,Ruoka_paivittaistavarakauppa,2020-02-26 05:13:02.608695650,2020-02-26,2020-02-26,2020-02-26,9.0,-3.2,-318.48,0.0,162.0,           ,1.0,1.0,186.0
9084,Tulot,2020-02-26 05:25:33.913043476,2020-02-26,2020-02-26,2020-02-26,9.0,546.54,228.06,0.0,505.0,           ,1.0,1.0,215.0
9085,Ravintolat_kahvilat,2020-02-26 17:06:46.956521737,2020-02-26,2020-02-26,2020-02-26,9.0,-3.67,224.39,0.0,162.0,           ,1.0,1.0,135.0
9086,Ruoka_paivittaistavarakauppa,2020-02-27 05:38:05.217391302,2020-02-27,2020-02-27,2020-02-27,9.0,-13.09,211.3,0.0,162.0,           ,1.0,1.0,169.0
9087,Ruoka_paivittaistavarakauppa,2020-02-27 05:50:36.521739128,2020-02-27,2020-02-27,2020-02-27,9.0,-16.03,195.27,0.0,162.0,           ,1.0,1.0,111.0
9088,Muut,2020-02-27 17:19:18.260869563,2020-02-27,2020-02-27,2020-02-27,9.0,-13.16,182.11,0.0,105.0,OKOYFIHH   ,1.0,0.0,6.0
9089,Muut,2020-02-27 17:31:49.565217389,2020-02-27,2020-02-27,2020-02-27,9.0,-29.87,152.24,706.0,129.0,NDEAFIHH   ,0.0,0.0,241.0
9090,Ruoka_paivittaistavarakauppa,2020-02-28 17:44:20.869565215,2020-02-28,2020-02-28,2020-02-28,9.0,-6.27,145.97,0.0,162.0,           ,1.0,1.0,178.0
9091,Hyvinvointijakauneus,2020-02-28 17:56:52.173913041,2020-02-28,2020-02-28,2020-02-28,9.0,-48.99,96.98,0.0,162.0,           ,1.0,1.0,123.0
9092,Ruoka_paivittaistavarakauppa,2020-03-02 13:40:15.189873416,2020-03-02,2020-03-02,2020-03-02,9.0,-4.05,92.93,0.0,162.0,           ,1.0,1.0,162.0
9093,Ruoka_paivittaistavarakauppa,2020-03-03 08:30:22.784810124,2020-03-03,2020-03-03,2020-03-03,9.0,-55.81,37.12,0.0,162.0,           ,1.0,1.0,171.0
9094,Ruoka_paivittaistavarakauppa,2020-03-03 18:50:07.594936708,2020-03-03,2020-03-03,2020-03-03,9.0,-12.27,24.85,0.0,162.0,           ,1.0,1.0,133.0
9095,Ruoka_paivittaistavarakauppa,2020-03-04 03:20:30.379746832,2020-03-04,2020-03-04,2020-03-04,9.0,-25.3,-0.45,0.0,162.0,           ,1.0,1.0,132.0
9096,Ruoka_paivittaistavarakauppa,2020-03-04 22:10:37.974683540,2020-03-04,2020-03-04,2020-03-04,9.0,-8.89,-9.34,0.0,162.0,           ,1.0,1.0,116.0
9097,Matkailu,2020-03-05 17:00:45.569620248,2020-03-05,2020-03-05,2020-03-05,9.0,-3.14,-12.48,0.0,170.0,           ,1.0,1.0,209.0
9098,Ruoka_paivittaistavarakauppa,2020-03-06 06:41:00.759493664,2020-03-06,2020-03-06,2020-03-06,9.0,-0.79,-13.27,0.0,162.0,           ,1.0,1.0,105.0
9099,Ravintolat_kahvilat,2020-03-06 11:50:53.164556956,2020-03-06,2020-03-06,2020-03-06,9.0,-0.65,-13.92,0.0,162.0,           ,1.0,1.0,120.0
9100,Matkailu,2020-03-09 01:31:08.354430372,2020-03-09,2020-03-09,2020-03-09,9.0,-5.15,-19.07,0.0,162.0,           ,1.0,1.0,184.0
9101,Ruoka_paivittaistavarakauppa,2020-03-09 15:11:23.544303788,2020-03-09,2020-03-09,2020-03-09,9.0,-6.97,-26.04,0.0,162.0,           ,1.0,1.0,184.0
9102,Ravintolat_kahvilat,2020-03-10 04:51:38.734177204,2020-03-10,2020-03-10,2020-03-10,9.0,-6.06,-32.1,0.0,162.0,           ,1.0,1.0,155.0
9103,Ravintolat_kahvilat,2020-03-10 10:01:31.139240496,2020-03-10,2020-03-10,2020-03-10,9.0,-6.43,-38.53,0.0,162.0,           ,1.0,1.0,137.0
9104,Ruoka_paivittaistavarakauppa,2020-03-10 13:22:01.518987328,2020-03-10,2020-03-12,2020-03-10,9.0,-2.28,-40.81,0.0,162.0,           ,1.0,1.0,76.0
9105,Luokittelemattomat,2020-03-10 20:21:15.949367080,2020-03-10,2020-03-10,2020-03-10,9.0,-4.09,-44.9,0.0,162.0,           ,1.0,1.0,160.0
9106,Kulttuuri_viihde,2020-03-11 23:41:46.329113912,2020-03-11,2020-03-11,2020-03-11,9.0,-9.15,-54.05,0.0,106.0,OKOYFIHH   ,0.0,0.0,26.0
9107,Ruoka_paivittaistavarakauppa,2020-03-12 18:31:53.924050620,2020-03-12,2020-03-12,2020-03-12,9.0,-3.6,-57.65,0.0,162.0,           ,1.0,1.0,175.0
9108,Asuminen,2020-03-13 08:12:09.113924036,2020-03-13,2020-03-13,2020-03-13,9.0,-3.53,-61.18,706.0,106.0,NDEAFIHH   ,0.0,0.0,238.0
9109,Liikkuminen,2020-03-16 03:02:16.708860744,2020-03-16,2020-03-16,2020-03-16,9.0,-87.77,-148.95,0.0,162.0,           ,1.0,1.0,132.0
9110,Hyvinvointijakauneus,2020-03-16 11:32:39.493670868,2020-03-16,2020-03-16,2020-03-16,9.0,-7.9,-156.85,0.0,162.0,           ,1.0,1.0,191.0
9111,Ravintolat_kahvilat,2020-03-16 16:42:31.898734160,2020-03-16,2020-03-16,2020-03-16,9.0,-0.72,-157.57,0.0,162.0,           ,1.0,1.0,163.0
9112,Luottojen_maksut,2020-03-16 21:52:24.303797452,2020-03-16,2020-03-16,2020-03-16,9.0,-12.35,-169.92,0.0,162.0,           ,1.0,1.0,144.0
9113,Ruoka_paivittaistavarakauppa,2020-03-18 06:22:47.088607576,2020-03-18,2020-03-18,2020-03-20,9.0,-1.26,-171.18,0.0,162.0,           ,1.0,1.0,57.0
9114,Luottojen_maksut,2020-03-18 09:43:17.468354408,2020-03-18,2020-03-18,2020-03-18,9.0,-5.9,-177.08,0.0,103.0,           ,0.0,1.0,4.0
9115,Ruoka_paivittaistavarakauppa,2020-03-19 01:12:54.683544284,2020-03-19,2020-03-19,2020-03-19,9.0,-5.02,-182.1,0.0,162.0,           ,1.0,1.0,129.0
9116,Liikkuminen,2020-03-19 20:03:02.278480992,2020-03-19,2020-03-20,2020-03-19,9.0,-10.6,-192.7,0.0,162.0,           ,1.0,1.0,121.0
9117,Ruoka_paivittaistavarakauppa,2020-03-20 14:53:09.873417700,2020-03-20,2020-03-20,2020-03-20,9.0,-3.87,-196.57,0.0,162.0,           ,1.0,1.0,102.0
9118,Ravintolat_kahvilat,2020-03-23 04:33:25.063291116,2020-03-23,2020-03-23,2020-03-23,9.0,-10.5,-207.07,0.0,162.0,           ,1.0,1.0,129.0
9119,Liikkuminen,2020-03-23 07:53:55.443037948,2020-03-23,2020-03-23,2020-03-23,9.0,-3.81,-210.88,0.0,162.0,           ,1.0,1.0,195.0
9120,Ruoka_paivittaistavarakauppa,2020-03-23 13:03:47.848101240,2020-03-23,2020-03-23,2020-03-23,9.0,-1.61,-212.49,0.0,162.0,           ,1.0,1.0,103.0
9121,Ruoka_paivittaistavarakauppa,2020-03-23 18:13:40.253164532,2020-03-23,2020-03-23,2020-03-23,9.0,-1.57,-214.06,0.0,162.0,           ,1.0,1.0,57.0
9122,Kulttuuri_viihde,2020-03-23 23:23:32.658227824,2020-03-23,2020-03-23,2020-03-23,9.0,-2.55,-216.61,0.0,162.0,           ,1.0,1.0,112.0
9123,Ruoka_paivittaistavarakauppa,2020-03-25 02:44:03.037974656,2020-03-25,2020-03-25,2020-03-25,9.0,-3.53,-220.14,0.0,162.0,           ,1.0,1.0,80.0
9124,Lemmikit,2020-03-27 06:04:33.417721488,2020-03-27,2020-03-27,2020-03-27,9.0,-8.53,-228.67,0.0,162.0,           ,1.0,1.0,162.0
9125,Ravintolat_kahvilat,2020-03-27 11:14:25.822784780,2020-03-27,2020-03-27,2020-03-27,9.0,-14.45,-243.12,0.0,162.0,           ,1.0,1.0,162.0
9126,Ruoka_paivittaistavarakauppa,2020-03-27 16:24:18.227848072,2020-03-27,2020-03-27,2020-03-27,9.0,-6.48,-249.6,0.0,162.0,           ,1.0,1.0,158.0
9127,Ruoka_paivittaistavarakauppa,2020-03-27 21:34:10.632911364,2020-03-27,2020-03-27,2020-03-27,9.0,-12.67,-262.27,0.0,162.0,           ,1.0,1.0,173.0
9128,Ruoka_paivittaistavarakauppa,2020-03-30 00:54:41.012658196,2020-03-30,2020-03-30,2020-03-30,9.0,-1.59,-263.86,0.0,162.0,           ,1.0,1.0,66.0
9129,Asuminen,2020-03-30 19:44:48.607594904,2020-03-30,2020-03-30,2020-03-30,9.0,-10.96,-274.82,706.0,129.0,NDEAFIHH   ,0.0,0.0,244.0
9130,Ruoka_paivittaistavarakauppa,2020-03-31 14:34:56.202531612,2020-03-31,2020-03-31,2020-03-30,9.0,-7.83,-282.65,0.0,162.0,           ,1.0,1.0,59.0
9131,Tulot,2020-04-01 17:46:40.000000000,2020-04-01,2020-04-01,2020-04-01,9.0,458.78,176.13,0.0,505.0,           ,1.0,1.0,214.0
9132,Ruoka_paivittaistavarakauppa,2020-04-02 11:33:20.000000000,2020-04-02,2020-04-02,2020-04-02,9.0,-5.91,170.22,0.0,162.0,           ,1.0,1.0,174.0
9133,Luokittelemattomat,2020-04-03 05:20:00.000000000,2020-04-03,2020-04-03,2020-04-03,9.0,-28.77,141.45,0.0,162.0,           ,1.0,1.0,69.0
9134,Ruoka_paivittaistavarakauppa,2020-04-03 23:06:40.000000000,2020-04-03,2020-04-03,2020-04-03,9.0,-17.84,123.61,0.0,162.0,           ,1.0,1.0,173.0
9135,Luokittelemattomat,2020-04-06 04:26:40.000000000,2020-04-06,2020-04-06,2020-04-06,9.0,-8.53,115.08,0.0,162.0,           ,1.0,1.0,162.0
9136,Ruoka_paivittaistavarakauppa,2020-04-06 09:46:40.000000000,2020-04-06,2020-04-06,2020-04-06,9.0,-34.65,80.43,0.0,162.0,           ,1.0,1.0,127.0
9137,Ruoka_paivittaistavarakauppa,2020-04-06 10:40:00.000000000,2020-04-06,2020-04-06,2020-04-06,9.0,-24.67,55.76,0.0,162.0,           ,1.0,1.0,165.0
9138,Ruoka_paivittaistavarakauppa,2020-04-06 16:53:20.000000000,2020-04-06,2020-04-06,2020-04-06,9.0,-2.85,52.91,0.0,162.0,           ,1.0,1.0,57.0
9139,Ravintolat_kahvilat,2020-04-06 22:13:20.000000000,2020-04-06,2020-04-06,2020-04-06,9.0,-5.35,47.56,0.0,162.0,           ,1.0,1.0,150.0
9140,Ruoka_paivittaistavarakauppa,2020-04-07 16:00:00.000000000,2020-04-07,2020-04-07,2020-04-07,9.0,-11.03,36.53,0.0,162.0,           ,1.0,1.0,200.0
9141,Ruoka_paivittaistavarakauppa,2020-04-09 03:33:20.000000000,2020-04-09,2020-04-09,2020-04-09,9.0,-11.09,25.44,0.0,162.0,           ,1.0,1.0,82.0
9142,Ruoka_paivittaistavarakauppa,2020-04-09 21:20:00.000000000,2020-04-09,2020-04-09,2020-04-09,9.0,-18.39,7.05,0.0,162.0,           ,1.0,1.0,118.0
9143,Lapset,2020-04-10 08:53:20.000000000,2020-04-10,2020-04-10,2020-04-10,9.0,-9.31,-2.26,0.0,162.0,           ,1.0,1.0,112.0
9144,Ruoka_paivittaistavarakauppa,2020-04-10 15:06:40.000000000,2020-04-10,2020-04-10,2020-04-10,9.0,-1.95,-4.21,0.0,162.0,           ,1.0,1.0,173.0
9145,Ravintolat_kahvilat,2020-04-10 20:26:40.000000000,2020-04-10,2020-04-10,2020-04-10,9.0,-7.1,-11.31,0.0,162.0,           ,1.0,1.0,58.0
9146,Ruoka_paivittaistavarakauppa,2020-04-13 02:40:00.000000000,2020-04-13,2020-04-13,2020-04-13,9.0,-7.93,-19.24,0.0,162.0,           ,1.0,1.0,57.0
9147,Hyvinvointijakauneus,2020-04-13 08:00:00.000000000,2020-04-13,2020-04-13,2020-04-13,9.0,-3.86,-23.1,0.0,162.0,           ,1.0,1.0,140.0
9148,Tulot,2020-04-13 14:13:20.000000000,2020-04-13,2020-04-13,2020-04-13,9.0,101.32,78.22,0.0,505.0,           ,1.0,1.0,213.0
9149,Liikkuminen,2020-04-14 19:33:20.000000000,2020-04-14,2020-04-14,2020-04-14,9.0,-19.91,58.31,0.0,162.0,           ,1.0,1.0,140.0
9150,Luokittelemattomat,2020-04-15 01:46:40.000000000,2020-04-15,2020-04-15,2020-04-15,9.0,-2.5,55.81,0.0,162.0,           ,1.0,1.0,145.0
9151,Ravintolat_kahvilat,2020-04-16 00:53:20.000000000,2020-04-16,2020-04-16,2020-04-16,9.0,-8.76,47.05,0.0,162.0,           ,1.0,1.0,121.0
9152,Lemmikit,2020-04-16 13:20:00.000000000,2020-04-16,2020-04-16,2020-04-16,9.0,-48.88,-1.83,0.0,162.0,           ,1.0,1.0,125.0
9153,Saastot_sijoitukset,2020-04-17 07:06:40.000000000,2020-04-17,2020-04-17,2020-04-17,9.0,-0.71,-2.54,0.0,162.0,           ,1.0,1.0,162.0
9154,Hyvinvointijakauneus,2020-04-17 18:40:00.000000000,2020-04-17,2020-04-17,2020-04-17,9.0,-3.36,-5.9,0.0,162.0,           ,1.0,1.0,147.0
9155,Muut,2020-04-20 00:00:00.000000000,2020-04-20,2020-04-20,2020-04-20,9.0,-4.36,-10.26,0.0,162.0,           ,1.0,1.0,194.0
9156,Muut,2020-04-20 06:13:20.000000000,2020-04-20,2020-04-20,2020-04-20,9.0,-8.72,-18.98,0.0,162.0,           ,1.0,1.0,184.0
9157,Ruoka_paivittaistavarakauppa,2020-04-20 11:33:20.000000000,2020-04-20,2020-04-20,2020-04-20,9.0,-12.79,-31.77,0.0,162.0,           ,1.0,1.0,118.0
9158,Liikkuminen,2020-04-20 12:26:40.000000000,2020-04-20,2020-04-20,2020-04-20,9.0,-16.69,-48.46,0.0,162.0,           ,1.0,1.0,156.0
9159,Ruoka_paivittaistavarakauppa,2020-04-20 17:46:40.000000000,2020-04-20,2020-04-20,2020-04-20,9.0,-14.79,-63.25,0.0,162.0,           ,1.0,1.0,140.0
9160,Lemmikit,2020-04-21 23:06:40.000000000,2020-04-21,2020-04-21,2020-04-21,9.0,-16.51,-79.76,0.0,162.0,           ,1.0,1.0,118.0
9161,Liikkuminen,2020-04-23 16:53:20.000000000,2020-04-23,2020-04-23,2020-04-23,9.0,-12.5,-92.26,0.0,162.0,           ,1.0,1.0,127.0
9162,Ruoka_paivittaistavarakauppa,2020-04-24 05:20:00.000000000,2020-04-24,2020-04-24,2020-04-24,9.0,-25.7,-117.96,0.0,162.0,           ,1.0,1.0,84.0
9163,Asuminen,2020-04-24 10:40:00.000000000,2020-04-24,2020-04-24,2020-04-24,9.0,-2.61,-120.57,0.0,162.0,           ,1.0,1.0,195.0
9164,Saastot_sijoitukset,2020-04-27 04:26:40.000000000,2020-04-27,2020-04-27,2020-04-27,9.0,-3.64,-124.21,0.0,162.0,           ,1.0,1.0,58.0
9165,Ruoka_paivittaistavarakauppa,2020-04-27 16:00:00.000000000,2020-04-27,2020-04-27,2020-04-27,9.0,-6.81,-131.02,0.0,162.0,           ,1.0,1.0,164.0
9166,Ruoka_paivittaistavarakauppa,2020-04-27 22:13:20.000000000,2020-04-27,2020-04-27,2020-04-27,9.0,-5.13,-136.15,0.0,162.0,           ,1.0,1.0,127.0
9167,Ruoka_paivittaistavarakauppa,2020-04-28 09:46:40.000000000,2020-04-28,2020-04-28,2020-04-28,9.0,-5.52,-141.67,0.0,162.0,           ,1.0,1.0,57.0
9168,Ravintolat_kahvilat,2020-04-29 03:33:20.000000000,2020-04-29,2020-04-29,2020-04-29,9.0,-1.95,-143.62,0.0,162.0,           ,1.0,1.0,186.0
9169,Tulot,2020-04-29 15:06:40.000000000,2020-04-29,2020-04-29,2020-04-29,9.0,129.29,-14.33,0.0,505.0,           ,1.0,1.0,218.0
9170,Liikkuminen,2020-04-30 21:20:00.000000000,2020-04-30,2020-04-30,2020-04-30,9.0,-26.36,-40.69,0.0,162.0,           ,1.0,1.0,60.0
9171,Tulot,2020-05-01 06:59:09.295774647,2020-05-01,2020-05-01,2020-05-01,9.0,35.54,-5.15,0.0,505.0,           ,1.0,1.0,216.0
9172,Tulot,2020-05-01 10:55:46.478873235,2020-05-01,2020-05-01,2020-05-01,9.0,96.54,91.39,710.0,506.0,           ,1.0,1.0,255.0
9173,Ruoka_paivittaistavarakauppa,2020-05-01 13:58:18.591549294,2020-05-01,2020-05-01,2020-05-01,9.0,-7.46,83.93,0.0,162.0,           ,1.0,1.0,123.0
9174,Ravintolat_kahvilat,2020-05-01 20:57:27.887323941,2020-05-01,2020-05-01,2020-05-01,9.0,-5.73,78.2,0.0,162.0,           ,1.0,1.0,77.0
9175,Ruoka_paivittaistavarakauppa,2020-05-04 00:54:05.070422529,2020-05-04,2020-05-04,2020-05-04,9.0,-1.48,76.72,0.0,162.0,           ,1.0,1.0,127.0
9176,Ravintolat_kahvilat,2020-05-04 03:56:37.183098588,2020-05-04,2020-05-04,2020-05-04,9.0,-0.8,75.92,0.0,162.0,           ,1.0,1.0,121.0
9177,Ravintolat_kahvilat,2020-05-04 04:50:42.253521117,2020-05-04,2020-05-04,2020-05-04,9.0,-0.19,75.73,0.0,162.0,           ,1.0,1.0,161.0
9178,Ruoka_paivittaistavarakauppa,2020-05-04 07:53:14.366197176,2020-05-04,2020-05-04,2020-05-04,9.0,-14.47,61.26,0.0,162.0,           ,1.0,1.0,58.0
9179,Asuminen,2020-05-04 11:49:51.549295764,2020-05-04,2020-05-04,2020-05-04,9.0,-5.5,55.76,0.0,162.0,           ,1.0,1.0,151.0
9180,Kulttuuri_viihde,2020-05-04 14:52:23.661971823,2020-05-04,2020-05-06,2020-05-04,9.0,-2.48,53.28,0.0,162.0,           ,1.0,1.0,174.0
9181,Ruoka_paivittaistavarakauppa,2020-05-04 17:54:55.774647882,2020-05-04,2020-05-04,2020-05-04,9.0,-4.51,48.77,0.0,162.0,           ,1.0,1.0,108.0
9182,Saastot_sijoitukset,2020-05-04 18:49:00.845070411,2020-05-04,2020-05-04,2020-05-04,9.0,-5.64,43.13,0.0,162.0,           ,1.0,1.0,123.0
9183,Ruoka_paivittaistavarakauppa,2020-05-04 21:51:32.957746470,2020-05-04,2020-05-04,2020-05-04,9.0,-3.42,39.71,0.0,162.0,           ,1.0,1.0,111.0
9184,Saastot_sijoitukset,2020-05-05 01:48:10.140845058,2020-05-05,2020-05-05,2020-05-05,9.0,-17.2,22.51,0.0,106.0,NDEAFIHH   ,0.0,0.0,30.0
9185,Terveys,2020-05-05 15:46:28.732394352,2020-05-05,2020-05-05,2020-05-05,9.0,-34.91,-12.4,0.0,162.0,           ,1.0,1.0,193.0
9186,Ruoka_paivittaistavarakauppa,2020-05-05 19:43:05.915492940,2020-05-05,2020-05-05,2020-05-05,9.0,-2.85,-15.25,0.0,162.0,           ,1.0,1.0,135.0
9187,Ruoka_paivittaistavarakauppa,2020-05-06 05:44:47.323943646,2020-05-06,2020-05-06,2020-05-06,9.0,-3.35,-18.6,0.0,162.0,           ,1.0,1.0,57.0
9188,Tulot,2020-05-06 08:47:19.436619705,2020-05-06,2020-05-06,2020-05-06,9.0,6.54,-12.06,0.0,505.0,           ,1.0,1.0,217.0
9189,Ravintolat_kahvilat,2020-05-06 12:43:56.619718293,2020-05-06,2020-05-06,2020-05-06,9.0,-3.07,-15.13,0.0,162.0,           ,1.0,1.0,155.0
9190,Tulot,2020-05-06 22:45:38.028168999,2020-05-06,2020-05-06,2020-05-06,9.0,92.07,76.94,0.0,505.0,           ,1.0,1.0,218.0
9191,Liikkuminen,2020-05-07 02:42:15.211267587,2020-05-07,2020-05-07,2020-05-07,9.0,-1.76,75.18,0.0,162.0,           ,1.0,1.0,123.0
9192,Ruoka_paivittaistavarakauppa,2020-05-07 06:38:52.394366175,2020-05-07,2020-05-07,2020-05-07,9.0,-1.78,73.4,0.0,162.0,           ,1.0,1.0,129.0
9193,Ravintolat_kahvilat,2020-05-07 09:41:24.507042234,2020-05-07,2020-05-07,2020-05-07,9.0,-3.95,69.45,0.0,162.0,           ,1.0,1.0,112.0
9194,Ruoka_paivittaistavarakauppa,2020-05-07 16:40:33.802816881,2020-05-07,2020-05-07,2020-05-07,9.0,-1.1,68.35,0.0,162.0,           ,1.0,1.0,82.0
9195,Ruoka_paivittaistavarakauppa,2020-05-07 20:37:10.985915469,2020-05-07,2020-05-07,2020-05-07,9.0,-7.38,60.97,0.0,162.0,           ,1.0,1.0,57.0
9196,Liikkuminen,2020-05-07 23:39:43.098591528,2020-05-07,2020-05-07,2020-05-07,9.0,-3.43,57.54,0.0,162.0,           ,1.0,1.0,177.0
9197,Ruoka_paivittaistavarakauppa,2020-05-08 10:35:29.577464763,2020-05-08,2020-05-08,2020-05-08,9.0,-1.44,56.1,0.0,162.0,           ,1.0,1.0,120.0
9198,Ravintolat_kahvilat,2020-05-08 13:38:01.690140822,2020-05-08,2020-05-08,2020-05-08,9.0,-7.62,48.48,0.0,162.0,           ,1.0,1.0,162.0
9199,Liikkuminen,2020-05-08 17:34:38.873239410,2020-05-08,2020-05-08,2020-05-08,9.0,-1.62,46.86,0.0,162.0,           ,1.0,1.0,155.0
9200,Muut,2020-05-11 00:33:48.169014057,2020-05-11,2020-05-11,2020-05-11,9.0,-0.72,46.14,0.0,162.0,           ,1.0,1.0,117.0
9201,Asuminen,2020-05-11 01:27:53.239436586,2020-05-11,2020-05-11,2020-05-11,9.0,-7.24,38.9,706.0,129.0,DABAFIHH   ,0.0,0.0,241.0
9202,Ravintolat_kahvilat,2020-05-11 03:36:20.281690116,2020-05-11,2020-05-11,2020-05-11,9.0,-6.75,32.15,0.0,162.0,           ,1.0,1.0,140.0
9203,Matkailu,2020-05-11 04:30:25.352112645,2020-05-11,2020-05-11,2020-05-11,9.0,-7.82,24.33,0.0,162.0,           ,1.0,1.0,101.0
9204,Ruoka_paivittaistavarakauppa,2020-05-11 05:24:30.422535174,2020-05-11,2020-05-11,2020-05-11,9.0,-2.1,22.23,0.0,162.0,           ,1.0,1.0,95.0
9205,Ravintolat_kahvilat,2020-05-11 11:29:34.647887292,2020-05-11,2020-05-11,2020-05-11,9.0,-6.88,15.35,0.0,162.0,           ,1.0,1.0,90.0
9206,Ruoka_paivittaistavarakauppa,2020-05-11 14:32:06.760563351,2020-05-11,2020-05-11,2020-05-11,9.0,-0.6,14.75,0.0,162.0,           ,1.0,1.0,108.0
9207,Tulot,2020-05-11 18:28:43.943661939,2020-05-11,2020-05-11,2020-05-11,9.0,29.16,43.91,0.0,505.0,           ,1.0,1.0,213.0
9208,Ravintolat_kahvilat,2020-05-11 21:31:16.056337998,2020-05-11,2020-05-11,2020-05-11,9.0,-7.75,36.16,0.0,162.0,           ,1.0,1.0,57.0
9209,Saastot_sijoitukset,2020-05-12 07:32:57.464788704,2020-05-12,2020-05-12,2020-05-12,9.0,-22.93,13.23,0.0,162.0,           ,1.0,1.0,82.0
9210,Ruoka_paivittaistavarakauppa,2020-05-12 08:27:02.535211233,2020-05-12,2020-05-12,2020-05-12,9.0,-0.93,12.3,0.0,162.0,           ,1.0,1.0,147.0
9211,Ruoka_paivittaistavarakauppa,2020-05-12 12:23:39.718309821,2020-05-12,2020-05-12,2020-05-12,9.0,-4.51,7.79,0.0,162.0,           ,1.0,1.0,69.0
9212,Ruoka_paivittaistavarakauppa,2020-05-12 15:26:11.830985880,2020-05-12,2020-05-12,2020-05-12,9.0,-4.28,3.51,0.0,162.0,           ,1.0,1.0,100.0
9213,Ruoka_paivittaistavarakauppa,2020-05-12 22:25:21.126760527,2020-05-12,2020-05-12,2020-05-12,9.0,-1.73,1.78,0.0,162.0,           ,1.0,1.0,127.0
9214,Ruoka_paivittaistavarakauppa,2020-05-13 02:21:58.309859115,2020-05-13,2020-05-13,2020-05-13,9.0,-4.1,-2.32,0.0,162.0,           ,1.0,1.0,179.0
9215,Ruoka_paivittaistavarakauppa,2020-05-13 16:20:16.901408409,2020-05-13,2020-05-13,2020-05-13,9.0,-3.97,-6.29,0.0,162.0,           ,1.0,1.0,196.0
9216,Hyvinvointijakauneus,2020-05-13 19:22:49.014084468,2020-05-13,2020-05-13,2020-05-13,9.0,-2.19,-8.48,0.0,162.0,           ,1.0,1.0,57.0
9217,Muut,2020-05-14 10:15:12.676056291,2020-05-14,2020-05-14,2020-05-14,9.0,-2.92,-11.4,0.0,162.0,           ,1.0,1.0,177.0
9218,Lemmikit,2020-05-14 23:19:26.197183056,2020-05-14,2020-05-14,2020-05-14,9.0,-19.78,-31.18,0.0,162.0,           ,1.0,1.0,111.0
9219,Kulttuuri_viihde,2020-05-15 03:16:03.380281644,2020-05-15,2020-05-15,2020-05-15,9.0,-5.37,-36.55,0.0,162.0,           ,1.0,1.0,116.0
9220,Muut,2020-05-15 06:18:35.492957703,2020-05-15,2020-05-15,2020-05-14,9.0,-2.26,-38.81,0.0,162.0,           ,1.0,1.0,176.0
9221,Ruoka_paivittaistavarakauppa,2020-05-15 09:21:07.605633762,2020-05-15,2020-05-15,2020-05-15,9.0,-4.96,-43.77,0.0,162.0,           ,1.0,1.0,92.0
9222,Ravintolat_kahvilat,2020-05-15 13:17:44.788732350,2020-05-15,2020-05-15,2020-05-15,9.0,-3.73,-47.5,0.0,162.0,           ,1.0,1.0,133.0
9223,Lemmikit,2020-05-15 14:11:49.859154879,2020-05-15,2020-05-15,2020-05-15,9.0,-16.35,-63.85,0.0,162.0,           ,1.0,1.0,145.0
9224,Tulot,2020-05-15 17:14:21.971830938,2020-05-15,2020-05-15,2020-05-15,9.0,41.73,-22.12,0.0,505.0,           ,1.0,1.0,214.0
9225,Ruoka_paivittaistavarakauppa,2020-05-15 20:16:54.084506997,2020-05-15,2020-05-15,2020-05-15,9.0,-3.92,-26.04,0.0,162.0,           ,1.0,1.0,148.0
9226,Lemmikit,2020-05-18 00:13:31.267605585,2020-05-18,2020-05-18,2020-05-18,9.0,-3.87,-29.91,0.0,162.0,           ,1.0,1.0,69.0
9227,Ruoka_paivittaistavarakauppa,2020-05-18 04:10:08.450704173,2020-05-18,2020-05-18,2020-05-18,9.0,-2.36,-32.27,0.0,162.0,           ,1.0,1.0,149.0
9228,Ruoka_paivittaistavarakauppa,2020-05-18 07:12:40.563380232,2020-05-18,2020-05-19,2020-05-18,9.0,-24.16,-56.43,0.0,162.0,           ,1.0,1.0,128.0
9229,Liikkuminen,2020-05-18 11:09:17.746478820,2020-05-18,2020-05-18,2020-05-18,9.0,-1.39,-57.82,0.0,162.0,           ,1.0,1.0,158.0
9230,Ruoka_paivittaistavarakauppa,2020-05-18 18:08:27.042253467,2020-05-18,2020-05-18,2020-05-18,9.0,-6.3,-64.12,0.0,162.0,           ,1.0,1.0,111.0
9231,Lemmikit,2020-05-18 21:10:59.154929526,2020-05-18,2020-05-20,2020-05-18,9.0,-15.76,-79.88,0.0,162.0,           ,1.0,1.0,146.0
9232,Ravintolat_kahvilat,2020-05-19 01:07:36.338028114,2020-05-19,2020-05-19,2020-05-19,9.0,-8.57,-88.45,0.0,162.0,           ,1.0,1.0,108.0
9233,Ruoka_paivittaistavarakauppa,2020-05-19 05:04:13.521126702,2020-05-19,2020-05-19,2020-05-19,9.0,-1.48,-89.93,0.0,162.0,           ,1.0,1.0,192.0
9234,Ravintolat_kahvilat,2020-05-19 08:06:45.633802761,2020-05-19,2020-05-19,2020-05-19,9.0,-19.76,-109.69,0.0,162.0,           ,1.0,1.0,153.0
9235,Liikkuminen,2020-05-19 15:05:54.929577408,2020-05-19,2020-05-19,2020-05-19,9.0,-103.64,-213.33,0.0,162.0,           ,1.0,1.0,58.0
9236,Luokittelemattomat,2020-05-19 22:05:04.225352055,2020-05-19,2020-05-19,2020-05-19,9.0,-7.11,-220.44,0.0,162.0,           ,1.0,1.0,132.0
9237,Lemmikit,2020-05-20 12:03:22.816901349,2020-05-20,2020-05-20,2020-05-20,9.0,-1.62,-222.06,0.0,162.0,           ,1.0,1.0,116.0
9238,Tulot,2020-05-20 19:02:32.112675996,2020-05-20,2020-05-21,2020-05-20,9.0,110.75,-111.31,0.0,505.0,           ,1.0,1.0,214.0
9239,Kulttuuri_viihde,2020-05-21 12:57:27.887323878,2020-05-21,2020-05-21,2020-05-21,9.0,-4.09,-115.4,0.0,162.0,           ,1.0,1.0,126.0
9240,Asuminen,2020-05-21 15:59:59.999999937,2020-05-21,2020-05-21,2020-05-21,9.0,-0.96,-116.36,0.0,162.0,           ,1.0,1.0,117.0
9241,Ruoka_paivittaistavarakauppa,2020-05-21 22:59:09.295774584,2020-05-21,2020-05-21,2020-05-21,9.0,-0.69,-117.05,0.0,162.0,           ,1.0,1.0,82.0
9242,Ruoka_paivittaistavarakauppa,2020-05-22 02:01:41.408450643,2020-05-22,2020-05-22,2020-05-22,9.0,-18.31,-135.36,0.0,162.0,           ,1.0,1.0,57.0
9243,Ruoka_paivittaistavarakauppa,2020-05-22 02:55:46.478873172,2020-05-22,2020-05-22,2020-05-22,9.0,-3.75,-139.11,0.0,162.0,           ,1.0,1.0,127.0
9244,Liikkuminen,2020-05-22 05:58:18.591549231,2020-05-22,2020-05-22,2020-05-22,9.0,-4.58,-143.69,0.0,162.0,           ,1.0,1.0,113.0
9245,Ravintolat_kahvilat,2020-05-22 09:00:50.704225290,2020-05-22,2020-05-22,2020-05-22,9.0,-3.42,-147.11,0.0,162.0,           ,1.0,1.0,59.0
9246,Ruoka_paivittaistavarakauppa,2020-05-22 09:54:55.774647819,2020-05-22,2020-05-22,2020-05-22,9.0,-3.6,-150.71,0.0,162.0,           ,1.0,1.0,189.0
9247,Ravintolat_kahvilat,2020-05-22 16:54:05.070422466,2020-05-22,2020-05-22,2020-05-22,9.0,-2.64,-153.35,0.0,162.0,           ,1.0,1.0,163.0
9248,Muut,2020-05-22 19:56:37.183098525,2020-05-22,2020-05-22,2020-05-22,9.0,-0.58,-153.93,0.0,162.0,           ,1.0,1.0,59.0
9249,Liikkuminen,2020-05-22 23:53:14.366197113,2020-05-22,2020-05-22,2020-05-22,9.0,-4.04,-157.97,0.0,162.0,           ,1.0,1.0,82.0
9250,Ruoka_paivittaistavarakauppa,2020-05-25 03:49:51.549295701,2020-05-25,2020-05-25,2020-05-25,9.0,-0.63,-158.6,0.0,162.0,           ,1.0,1.0,173.0
9251,Liikkuminen,2020-05-25 06:52:23.661971760,2020-05-25,2020-05-25,2020-05-25,9.0,-3.04,-161.64,0.0,162.0,           ,1.0,1.0,82.0
9252,Liikkuminen,2020-05-25 10:49:00.845070348,2020-05-25,2020-05-25,2020-05-25,9.0,-4.28,-165.92,0.0,162.0,           ,1.0,1.0,133.0
9253,Ruoka_paivittaistavarakauppa,2020-05-25 13:51:32.957746407,2020-05-25,2020-05-27,2020-05-25,9.0,-12.22,-178.14,0.0,162.0,           ,1.0,1.0,150.0
9254,Ruoka_paivittaistavarakauppa,2020-05-25 17:48:10.140844995,2020-05-25,2020-05-25,2020-05-25,9.0,-3.18,-181.32,0.0,162.0,           ,1.0,1.0,87.0
9255,Ruoka_paivittaistavarakauppa,2020-05-25 20:50:42.253521054,2020-05-25,2020-05-25,2020-05-25,9.0,-6.85,-188.17,0.0,162.0,           ,1.0,1.0,125.0
9256,Harrastukset,2020-05-26 00:47:19.436619642,2020-05-26,2020-05-26,2020-05-26,9.0,-1.42,-189.59,0.0,162.0,           ,1.0,1.0,125.0
9257,Ruoka_paivittaistavarakauppa,2020-05-26 07:46:28.732394289,2020-05-26,2020-05-26,2020-05-26,9.0,-1.39,-190.98,0.0,162.0,           ,1.0,1.0,128.0
9258,Ruoka_paivittaistavarakauppa,2020-05-26 14:45:38.028168936,2020-05-26,2020-05-26,2020-05-26,9.0,-6.97,-197.95,0.0,162.0,           ,1.0,1.0,171.0
9259,Ravintolat_kahvilat,2020-05-26 21:44:47.323943583,2020-05-26,2020-05-26,2020-05-26,9.0,-0.91,-198.86,0.0,162.0,           ,1.0,1.0,137.0
9260,Tulot,2020-05-27 01:41:24.507042171,2020-05-27,2020-05-27,2020-05-27,9.0,75.04,-123.82,0.0,551.0,           ,1.0,1.0,222.0
9261,Ruoka_paivittaistavarakauppa,2020-05-27 04:43:56.619718230,2020-05-27,2020-05-27,2020-05-27,9.0,-4.26,-128.08,0.0,162.0,           ,1.0,1.0,82.0
9262,Ravintolat_kahvilat,2020-05-27 08:40:33.802816818,2020-05-27,2020-05-27,2020-05-27,9.0,-5.86,-133.94,0.0,162.0,           ,1.0,1.0,59.0
9263,Liikkuminen,2020-05-27 11:43:05.915492877,2020-05-27,2020-05-27,2020-05-27,9.0,-2.67,-136.61,0.0,162.0,           ,1.0,1.0,162.0
9264,Ravintolat_kahvilat,2020-05-27 18:42:15.211267524,2020-05-27,2020-05-27,2020-05-27,9.0,-2.33,-138.94,0.0,162.0,           ,1.0,1.0,140.0
9265,Muut,2020-05-27 22:38:52.394366112,2020-05-27,2020-05-27,2020-05-27,9.0,-16.11,-155.05,0.0,162.0,           ,1.0,1.0,95.0
9266,Ruoka_paivittaistavarakauppa,2020-05-28 12:37:10.985915406,2020-05-28,2020-05-28,2020-05-28,9.0,-14.96,-170.01,0.0,162.0,           ,1.0,1.0,195.0
9267,Hyvinvointi,2020-05-28 15:39:43.098591465,2020-05-28,2020-05-28,2020-05-28,9.0,-8.82,-178.83,0.0,162.0,           ,1.0,1.0,125.0
9268,Kulttuuri_viihde,2020-05-28 16:33:48.169013994,2020-05-28,2020-05-28,2020-05-28,9.0,-7.67,-186.5,0.0,162.0,           ,1.0,1.0,161.0
9269,Ravintolat_kahvilat,2020-05-29 02:35:29.577464700,2020-05-29,2020-05-29,2020-05-29,9.0,-7.36,-193.86,0.0,162.0,           ,1.0,1.0,154.0
9270,Ruoka_paivittaistavarakauppa,2020-05-29 05:38:01.690140759,2020-05-29,2020-05-29,2020-05-29,9.0,-5.87,-199.73,0.0,162.0,           ,1.0,1.0,57.0
9271,Ruoka_paivittaistavarakauppa,2020-05-29 06:32:06.760563288,2020-05-29,2020-05-29,2020-05-29,9.0,-3.17,-202.9,0.0,162.0,           ,1.0,1.0,145.0
9272,Hyvinvointijakauneus,2020-05-29 09:34:38.873239347,2020-05-29,2020-05-29,2020-05-29,9.0,-13.95,-216.85,0.0,162.0,           ,1.0,1.0,125.0
9273,Ruoka_paivittaistavarakauppa,2020-05-29 13:31:16.056337935,2020-05-29,2020-05-29,2020-05-29,9.0,-7.71,-224.56,0.0,162.0,           ,1.0,1.0,99.0
9274,Asuminen,2020-05-29 19:36:20.281690053,2020-05-29,2020-05-29,2020-05-29,9.0,-9.96,-234.52,0.0,162.0,           ,1.0,1.0,82.0
9275,Muut,2020-05-29 20:30:25.352112582,2020-05-29,2020-05-29,2020-05-29,9.0,-2.41,-236.93,0.0,162.0,           ,1.0,1.0,185.0
9276,Ruoka_paivittaistavarakauppa,2020-05-29 23:32:57.464788641,2020-05-29,2020-05-29,2020-05-29,9.0,-1.95,-238.88,0.0,162.0,           ,1.0,1.0,120.0
9277,Tulot,2020-06-01 03:51:38.123324396,2020-06-01,2020-06-01,2020-06-01,9.0,135.62,-103.26,0.0,505.0,           ,1.0,1.0,215.0
9278,Ruoka_paivittaistavarakauppa,2020-06-01 07:43:16.246648792,2020-06-01,2020-06-03,2020-06-01,9.0,-3.37,-106.63,0.0,162.0,           ,1.0,1.0,108.0
9279,Muut,2020-06-01 11:34:54.369973188,2020-06-01,2020-06-01,2020-06-01,9.0,-9.83,-116.46,0.0,163.0,           ,1.0,1.0,204.0
9280,Ruoka_paivittaistavarakauppa,2020-06-01 15:26:32.493297584,2020-06-01,2020-06-01,2020-06-01,9.0,-50.58,-167.04,0.0,162.0,           ,1.0,1.0,68.0
9281,Ruoka_paivittaistavarakauppa,2020-06-01 19:18:10.616621980,2020-06-01,2020-06-01,2020-06-01,9.0,-2.51,-169.55,0.0,162.0,           ,1.0,1.0,105.0
9282,Ravintolat_kahvilat,2020-06-01 23:09:48.739946376,2020-06-01,2020-06-01,2020-06-01,9.0,-3.18,-172.73,0.0,162.0,           ,1.0,1.0,121.0
9283,Ravintolat_kahvilat,2020-06-02 03:01:26.863270772,2020-06-02,2020-06-02,2020-06-02,9.0,-7.75,-180.48,0.0,162.0,           ,1.0,1.0,140.0
9284,Liikkuminen,2020-06-02 06:53:04.986595168,2020-06-02,2020-06-02,2020-06-02,9.0,-2.1,-182.58,0.0,162.0,           ,1.0,1.0,138.0
9285,Tulot,2020-06-02 10:44:43.109919564,2020-06-02,2020-06-02,2020-06-02,9.0,-4.95,-187.53,0.0,162.0,           ,1.0,1.0,127.0
9286,Shoppailu,2020-06-02 14:36:21.233243960,2020-06-02,2020-06-02,2020-06-02,9.0,327.78,140.25,0.0,505.0,           ,1.0,1.0,213.0
9287,Ruoka_paivittaistavarakauppa,2020-06-02 18:27:59.356568356,2020-06-02,2020-06-02,2020-06-02,9.0,-39.39,100.86,0.0,162.0,           ,1.0,1.0,121.0
9288,Ruoka_paivittaistavarakauppa,2020-06-02 22:19:37.479892752,2020-06-02,2020-06-02,2020-06-02,9.0,-3.72,97.14,0.0,162.0,           ,1.0,1.0,90.0
9289,Hyvinvointi,2020-06-03 02:11:15.603217148,2020-06-03,2020-06-03,2020-06-03,9.0,-5.67,91.47,0.0,162.0,           ,1.0,1.0,108.0
9290,Luokittelemattomat,2020-06-03 06:02:53.726541544,2020-06-03,2020-06-03,2020-06-03,9.0,-26.36,65.11,0.0,151.0,           ,1.0,1.0,51.0
9291,Liikkuminen,2020-06-03 09:54:31.849865940,2020-06-03,2020-06-03,2020-06-03,9.0,-13.62,51.49,0.0,162.0,           ,1.0,1.0,140.0
9292,Ruoka_paivittaistavarakauppa,2020-06-03 13:46:09.973190336,2020-06-03,2020-06-03,2020-06-03,9.0,-1.88,49.61,0.0,162.0,           ,1.0,1.0,111.0
9293,Tulot,2020-06-03 17:37:48.096514732,2020-06-03,2020-06-03,2020-06-03,9.0,7.99,57.6,0.0,506.0,           ,1.0,1.0,219.0
9294,Ruoka_paivittaistavarakauppa,2020-06-03 21:29:26.219839128,2020-06-03,2020-06-03,2020-06-03,9.0,-1.13,56.47,0.0,162.0,           ,1.0,1.0,69.0
9295,Ruoka_paivittaistavarakauppa,2020-06-04 01:21:04.343163524,2020-06-04,2020-06-04,2020-06-04,9.0,-14.39,42.08,0.0,162.0,           ,1.0,1.0,95.0
9296,Luokittelemattomat,2020-06-04 05:12:42.466487920,2020-06-04,2020-06-04,2020-06-04,9.0,-21.43,20.65,0.0,151.0,           ,1.0,1.0,51.0
9297,Luokittelemattomat,2020-06-04 09:04:20.589812316,2020-06-04,2020-06-04,2020-06-04,9.0,-8.6,12.05,0.0,162.0,           ,1.0,1.0,132.0
9298,Ruoka_paivittaistavarakauppa,2020-06-04 12:55:58.713136712,2020-06-04,2020-06-04,2020-06-04,9.0,-6.07,5.98,0.0,162.0,           ,1.0,1.0,127.0
9299,Liikkuminen,2020-06-04 16:47:36.836461108,2020-06-04,2020-06-04,2020-06-04,9.0,-5.13,0.85,0.0,162.0,           ,1.0,1.0,90.0
9300,Ruoka_paivittaistavarakauppa,2020-06-04 20:39:14.959785504,2020-06-04,2020-06-04,2020-06-04,9.0,-15.98,-15.13,0.0,162.0,           ,1.0,1.0,147.0
9301,Tulot,2020-06-05 00:30:53.083109900,2020-06-05,2020-06-05,2020-06-05,9.0,62.2,47.07,0.0,551.0,           ,1.0,1.0,222.0
9302,Hyvinvointijakauneus,2020-06-05 04:22:31.206434296,2020-06-05,2020-06-05,2020-06-05,9.0,-1.47,45.6,0.0,162.0,           ,1.0,1.0,173.0
9303,Ruoka_paivittaistavarakauppa,2020-06-05 07:23:58.069705068,2020-06-05,2020-06-05,2020-06-05,9.0,-18.43,27.17,0.0,162.0,           ,1.0,1.0,161.0
9304,Ruoka_paivittaistavarakauppa,2020-06-05 08:14:09.329758692,2020-06-05,2020-06-05,2020-06-05,9.0,-2.4,24.77,0.0,162.0,           ,1.0,1.0,151.0
9305,Lemmikit,2020-06-05 12:05:47.453083088,2020-06-05,2020-06-05,2020-06-05,9.0,-9.36,15.41,0.0,162.0,           ,1.0,1.0,57.0
9306,Liikkuminen,2020-06-05 15:07:14.316353860,2020-06-05,2020-06-05,2020-06-05,9.0,-13.56,1.85,0.0,162.0,           ,1.0,1.0,151.0
9307,Ruoka_paivittaistavarakauppa,2020-06-05 15:57:25.576407484,2020-06-05,2020-06-05,2020-06-05,9.0,-23.09,-21.24,0.0,162.0,           ,1.0,1.0,184.0
9308,Liikkuminen,2020-06-05 19:49:03.699731880,2020-06-05,2020-06-05,2020-06-05,9.0,-2.43,-23.67,0.0,162.0,           ,1.0,1.0,101.0
9309,Hyvinvointi,2020-06-05 22:50:30.563002652,2020-06-05,2020-06-05,2020-06-05,9.0,-2.24,-25.91,0.0,162.0,           ,1.0,1.0,127.0
9310,Luokittelemattomat,2020-06-05 23:40:41.823056276,2020-06-05,2020-06-05,2020-06-05,9.0,-3.12,-29.03,0.0,162.0,           ,1.0,1.0,129.0
9311,Luottojen_maksut,2020-06-06 03:32:19.946380672,2020-06-06,2020-06-06,2020-06-06,9.0,-3.07,-32.1,0.0,151.0,           ,1.0,1.0,52.0
9312,Tulot,2020-06-07 01:01:46.166219800,2020-06-07,2020-06-07,2020-06-05,9.0,68.28,36.18,0.0,551.0,           ,1.0,1.0,222.0
9313,Muut,2020-06-07 04:53:24.289544196,2020-06-07,2020-06-07,2020-06-07,9.0,-8.06,28.12,0.0,105.0,OKOYFIHH   ,1.0,0.0,10.0
9314,Tulot,2020-06-08 01:51:57.426273424,2020-06-08,2020-06-08,2020-06-08,9.0,5.16,33.28,0.0,500.0,OKOYFIHH   ,1.0,0.0,212.0
9315,Lemmikit,2020-06-08 02:42:08.686327048,2020-06-08,2020-06-08,2020-06-08,9.0,-6.73,26.55,0.0,162.0,           ,1.0,1.0,184.0
9316,Luokittelemattomat,2020-06-08 05:43:35.549597820,2020-06-08,2020-06-08,2020-06-08,9.0,-17.7,8.85,0.0,151.0,           ,1.0,1.0,51.0
9317,Ruoka_paivittaistavarakauppa,2020-06-08 06:33:46.809651444,2020-06-08,2020-06-08,2020-06-08,9.0,-2.08,6.77,0.0,162.0,           ,1.0,1.0,116.0
9318,Muut,2020-06-08 09:35:13.672922216,2020-06-08,2020-06-08,2020-06-08,9.0,-14.3,-7.53,0.0,105.0,OKOYFIHH   ,1.0,0.0,5.0
9319,Ruoka_paivittaistavarakauppa,2020-06-08 10:25:24.932975840,2020-06-08,2020-06-08,2020-06-08,9.0,-6.54,-14.07,0.0,162.0,           ,1.0,1.0,82.0
9320,Ruoka_paivittaistavarakauppa,2020-06-08 11:15:36.193029464,2020-06-08,2020-06-08,2020-06-08,9.0,-10.65,-24.72,0.0,162.0,           ,1.0,1.0,137.0
9321,Shoppailu,2020-06-08 13:26:51.796246612,2020-06-08,2020-06-08,2020-06-08,9.0,-34.41,-59.13,0.0,106.0,DABAFIHH   ,0.0,0.0,46.0
9322,Ruoka_paivittaistavarakauppa,2020-06-08 17:18:29.919571008,2020-06-08,2020-06-08,2020-06-08,9.0,-8.13,-67.26,0.0,162.0,           ,1.0,1.0,95.0
9323,Ruoka_paivittaistavarakauppa,2020-06-08 18:08:41.179624632,2020-06-08,2020-06-08,2020-06-08,9.0,-8.61,-75.87,0.0,162.0,           ,1.0,1.0,161.0
9324,Lemmikit,2020-06-08 18:58:52.439678256,2020-06-08,2020-06-08,2020-06-08,9.0,-1.93,-77.8,0.0,162.0,           ,1.0,1.0,113.0
9325,Muut,2020-06-08 20:19:56.782841780,2020-06-08,2020-06-12,2020-06-08,9.0,-18.4,-96.2,0.0,105.0,OKOYFIHH   ,1.0,0.0,5.0
9326,Muut,2020-06-08 21:10:08.042895404,2020-06-08,2020-06-08,2020-06-08,9.0,-5.55,-101.75,0.0,105.0,OKOYFIHH   ,1.0,0.0,7.0
9327,Luokittelemattomat,2020-06-09 08:45:02.412868592,2020-06-09,2020-06-09,2020-06-09,9.0,-1.73,-103.48,0.0,151.0,           ,1.0,1.0,52.0
9328,Luokittelemattomat,2020-06-09 11:46:29.276139364,2020-06-09,2020-06-09,2020-06-09,9.0,-27.36,-130.84,0.0,106.0,OKOYFIHH   ,1.0,0.0,14.0
9329,Muut,2020-06-09 12:36:40.536192988,2020-06-09,2020-06-09,2020-06-09,9.0,-14.99,-145.83,0.0,105.0,OKOYFIHH   ,1.0,0.0,6.0
9330,Ravintolat_kahvilat,2020-06-09 14:17:03.056300236,2020-06-09,2020-06-09,2020-06-09,9.0,-4.58,-150.41,0.0,162.0,           ,1.0,1.0,195.0
9331,Luokittelemattomat,2020-06-09 15:38:07.399463760,2020-06-09,2020-06-09,2020-06-09,9.0,-1.88,-152.29,0.0,151.0,           ,1.0,1.0,52.0
9332,Ruoka_paivittaistavarakauppa,2020-06-09 22:00:19.302949028,2020-06-05,2020-06-09,2020-06-09,9.0,-3.88,-156.17,0.0,162.0,           ,1.0,1.0,82.0
9333,Luokittelemattomat,2020-06-10 00:11:34.906166176,2020-06-10,2020-06-10,2020-06-10,9.0,-2.18,-158.35,0.0,151.0,           ,1.0,1.0,52.0
9334,Muut,2020-06-10 07:54:51.152814968,2020-06-10,2020-06-10,2020-06-10,9.0,-37.8,-196.15,0.0,149.0,           ,1.0,1.0,50.0
9335,Saastot_sijoitukset,2020-06-10 16:28:18.659517384,2020-06-10,2020-06-10,2020-06-10,9.0,-0.3,-196.45,0.0,151.0,           ,1.0,1.0,52.0
9336,Muut,2020-06-11 03:13:01.769436948,2020-06-11,2020-06-11,2020-06-11,9.0,-5.42,-201.87,0.0,105.0,OKOYFIHH   ,1.0,0.0,5.0
9337,Ruoka_paivittaistavarakauppa,2020-06-11 04:03:13.029490572,2020-06-11,2020-06-11,2020-06-11,9.0,-56.88,-258.75,0.0,162.0,           ,1.0,1.0,137.0
9338,Muut,2020-06-11 07:04:39.892761344,2020-06-11,2020-06-11,2020-06-11,9.0,-2.05,-260.8,0.0,105.0,OKOYFIHH   ,1.0,0.0,9.0
9339,Hyvinvointijakauneus,2020-06-11 13:07:33.619302888,2020-06-11,2020-06-11,2020-06-11,9.0,-2.14,-262.94,0.0,162.0,           ,1.0,1.0,196.0
9340,Muut,2020-06-11 14:47:56.139410136,2020-06-11,2020-06-11,2020-06-11,9.0,-10.11,-273.05,0.0,105.0,OKOYFIHH   ,1.0,0.0,7.0
9341,Lapset,2020-06-11 18:39:34.262734532,2020-06-11,2020-06-12,2020-06-11,9.0,-5.25,-278.3,0.0,162.0,           ,1.0,1.0,172.0
9342,Luokittelemattomat,2020-06-11 19:29:45.522788156,2020-06-11,2020-06-11,2020-06-11,9.0,-0.45,-278.75,0.0,151.0,           ,1.0,1.0,51.0
9343,Tulot,2020-06-11 22:31:12.386058928,2020-06-11,2020-06-11,2020-06-11,9.0,259.26,-19.49,0.0,574.0,           ,1.0,1.0,226.0
9344,Lapset,2020-06-11 23:21:23.646112552,2020-06-12,2020-06-11,2020-06-11,9.0,-33.4,-52.89,0.0,106.0,OKOYFIHH   ,1.0,0.0,17.0
9345,Ruoka_paivittaistavarakauppa,2020-06-12 01:32:39.249329700,2020-06-12,2020-06-12,2020-06-12,9.0,-2.3,-55.19,0.0,162.0,           ,1.0,1.0,144.0
9346,Lemmikit,2020-06-12 02:22:50.509383324,2020-06-12,2020-06-12,2020-06-12,9.0,-57.42,-112.61,0.0,106.0,OKOYFIHH   ,0.0,0.0,21.0
9347,Ruoka_paivittaistavarakauppa,2020-06-12 05:24:17.372654096,2020-06-12,2020-06-12,2020-06-12,9.0,-3.95,-116.56,0.0,162.0,           ,1.0,1.0,144.0
9348,Vakuutukset,2020-06-12 06:14:28.632707720,2020-06-12,2020-06-12,2020-06-12,9.0,-8.8,-125.36,0.0,106.0,OKOYFIHH   ,0.0,0.0,46.0
9349,Ruoka_paivittaistavarakauppa,2020-06-12 09:15:55.495978492,2020-06-12,2020-06-12,2020-06-12,9.0,-7.68,-133.04,0.0,162.0,           ,1.0,1.0,118.0
9350,Luokittelemattomat,2020-06-12 10:06:06.756032116,2020-06-12,2020-06-12,2020-06-12,9.0,-35.39,-168.43,0.0,151.0,           ,1.0,1.0,51.0
9351,Hyvinvointijakauneus,2020-06-12 10:56:18.016085740,2020-06-12,2020-06-12,2020-06-12,9.0,-13.12,-181.55,0.0,106.0,OKOYFIHH   ,0.0,0.0,38.0
9352,Tulot,2020-06-12 13:57:44.879356512,2020-06-12,2020-06-12,2020-06-12,9.0,144.27,-37.28,0.0,551.0,           ,1.0,1.0,222.0
9353,Luokittelemattomat,2020-06-12 17:49:23.002680908,2020-06-12,2020-06-12,2020-06-12,9.0,-0.5,-37.78,0.0,151.0,           ,1.0,1.0,51.0
9354,Ruoka_paivittaistavarakauppa,2020-06-12 20:50:49.865951680,2020-06-12,2020-06-12,2020-06-12,9.0,-10.18,-47.96,0.0,162.0,           ,1.0,1.0,159.0
9355,Muut,2020-06-12 21:41:01.126005304,2020-06-12,2020-06-12,2020-06-12,9.0,-23.86,-71.82,0.0,105.0,OKOYFIHH   ,1.0,0.0,7.0
9356,Liikkuminen,2020-06-14 20:00:38.605898056,2020-06-14,2020-06-14,2020-06-14,9.0,-1.63,-73.45,0.0,151.0,           ,1.0,1.0,51.0
9357,Muut,2020-06-15 00:42:27.989276076,2020-06-15,2020-06-15,2020-06-15,9.0,-0.36,-73.81,0.0,105.0,OKOYFIHH   ,1.0,0.0,5.0
9358,Tulot,2020-06-15 03:43:54.852546848,2020-06-15,2020-06-15,2020-06-15,9.0,144.26,70.45,0.0,551.0,           ,1.0,1.0,223.0
9359,Muut,2020-06-15 04:34:06.112600472,2020-06-15,2020-06-18,2020-06-15,9.0,-60.68,9.77,0.0,105.0,OKOYFIHH   ,1.0,0.0,7.0
9360,Ravintolat_kahvilat,2020-06-15 07:35:32.975871244,2020-06-15,2020-06-15,2020-06-15,9.0,-4.72,5.05,0.0,162.0,           ,1.0,1.0,162.0
9361,Ruoka_paivittaistavarakauppa,2020-06-15 11:27:11.099195640,2020-06-15,2020-06-15,2020-06-15,9.0,-33.77,-28.72,0.0,162.0,           ,1.0,1.0,173.0
9362,Muut,2020-06-15 12:17:22.359249264,2020-06-15,2020-06-15,2020-06-15,9.0,-8.04,-36.76,0.0,105.0,OKOYFIHH   ,1.0,0.0,8.0
9363,Tulot,2020-06-15 15:18:49.222520036,2020-06-15,2020-06-15,2020-06-15,9.0,-3.64,-40.4,0.0,162.0,           ,1.0,1.0,115.0
9364,Lemmikit,2020-06-15 16:59:11.742627284,2020-06-15,2020-06-15,2020-06-15,9.0,-8.84,-49.24,0.0,162.0,           ,1.0,1.0,121.0
9365,Lemmikit,2020-06-15 19:10:27.345844432,2020-06-15,2020-06-15,2020-06-15,9.0,-18.82,-68.06,0.0,162.0,           ,1.0,1.0,146.0
9366,Liikkuminen,2020-06-15 23:02:05.469168828,2020-06-15,2020-06-15,2020-06-15,9.0,-5.32,-73.38,0.0,151.0,           ,1.0,1.0,52.0
9367,Luokittelemattomat,2020-06-15 23:52:16.729222452,2020-06-15,2020-06-15,2020-06-15,9.0,-20.58,-93.96,0.0,151.0,           ,1.0,1.0,51.0
9368,Ruoka_paivittaistavarakauppa,2020-06-16 02:53:43.592493224,2020-06-16,2020-06-16,2020-06-16,9.0,-8.58,-102.54,0.0,162.0,           ,1.0,1.0,163.0
9369,Lemmikit,2020-06-16 05:55:10.455763996,2020-06-16,2020-06-16,2020-06-16,9.0,-5.14,-107.68,0.0,151.0,           ,1.0,1.0,51.0
9370,Ruoka_paivittaistavarakauppa,2020-06-16 06:45:21.715817620,2020-06-16,2020-06-16,2020-06-16,9.0,-1.42,-109.1,0.0,162.0,           ,1.0,1.0,77.0
9371,Luokittelemattomat,2020-06-16 08:25:44.235924868,2020-06-16,2020-06-16,2020-06-16,9.0,-2.16,-111.26,0.0,151.0,           ,1.0,1.0,55.0
9372,Lemmikit,2020-06-16 10:36:59.839142016,2020-06-16,2020-06-16,2020-06-16,9.0,-13.05,-124.31,0.0,162.0,           ,1.0,1.0,140.0
9373,Muut,2020-06-16 14:28:37.962466412,2020-06-16,2020-06-16,2020-06-16,9.0,-23.7,-148.01,0.0,105.0,OKOYFIHH   ,1.0,0.0,5.0
9374,Liikkuminen,2020-06-16 16:09:00.482573660,2020-06-16,2020-06-16,2020-06-16,9.0,-2.61,-150.62,0.0,151.0,           ,1.0,1.0,52.0
9375,Lemmikit,2020-06-16 17:30:04.825737184,2020-06-16,2020-06-16,2020-06-16,9.0,-8.38,-159.0,0.0,162.0,           ,1.0,1.0,136.0
9376,Muut,2020-06-16 18:20:16.085790808,2020-06-16,2020-06-16,2020-06-16,9.0,-27.21,-186.21,0.0,105.0,OKOYFIHH   ,1.0,0.0,5.0
9377,Luottojen_maksut,2020-06-16 22:11:54.209115204,2020-06-16,2020-06-16,2020-06-16,9.0,-6.73,-192.94,0.0,172.0,           ,1.0,1.0,210.0
9378,Tulot,2020-06-18 01:13:21.072385976,2020-06-18,2020-06-18,2020-06-18,9.0,45.81,-147.13,710.0,506.0,           ,1.0,1.0,256.0
9379,Liikkuminen,2020-06-18 02:03:32.332439600,2020-06-18,2020-06-18,2020-06-18,9.0,-1.13,-148.26,0.0,151.0,           ,1.0,1.0,56.0
9380,Muut,2020-06-18 05:04:59.195710372,2020-06-18,2020-06-18,2020-06-18,9.0,-9.05,-157.31,0.0,105.0,OKOYFIHH   ,1.0,0.0,8.0
9381,Muut,2020-06-18 08:56:37.319034768,2020-06-18,2020-06-18,2020-06-18,9.0,-10.49,-167.8,0.0,105.0,OKOYFIHH   ,1.0,0.0,5.0
9382,Liikkuminen,2020-06-18 09:46:48.579088392,2020-06-18,2020-06-18,2020-06-18,9.0,-2.51,-170.31,0.0,151.0,           ,1.0,1.0,53.0
9383,Muut,2020-06-18 16:39:53.565683560,2020-06-18,2020-06-18,2020-06-18,9.0,-3.11,-173.42,0.0,105.0,OKOYFIHH   ,1.0,0.0,5.0
9384,Tulot,2020-06-18 18:51:09.168900708,2020-06-18,2020-06-18,2020-06-18,9.0,71.52,-101.9,0.0,551.0,           ,1.0,1.0,223.0
9385,Muut,2020-06-18 20:31:31.689007956,2020-06-18,2020-06-18,2020-06-18,9.0,-3.08,-104.98,0.0,105.0,OKOYFIHH   ,1.0,0.0,8.0
9386,Tulot,2020-06-18 21:21:42.949061580,2020-06-18,2020-06-18,2020-06-18,9.0,116.61,11.63,0.0,506.0,           ,1.0,1.0,220.0
9387,Muut,2020-06-18 23:32:58.552278728,2020-06-18,2020-06-18,2020-06-18,9.0,-10.47,1.16,0.0,106.0,OKOYFIHH   ,0.0,0.0,27.0
9388,Liikkuminen,2020-06-19 00:23:09.812332352,2020-06-19,2020-06-19,2020-06-18,9.0,-0.79,0.37,0.0,151.0,           ,1.0,1.0,51.0
9389,Muut,2020-06-19 04:14:47.935656748,2020-06-19,2020-06-19,2020-06-19,9.0,-24.55,-24.18,0.0,105.0,OKOYFIHH   ,1.0,0.0,7.0
9390,Muut,2020-06-19 08:06:26.058981144,2020-06-19,2020-06-19,2020-06-19,9.0,-10.53,-34.71,0.0,105.0,OKOYFIHH   ,1.0,0.0,6.0
9391,Luokittelemattomat,2020-06-19 11:07:52.922251916,2020-06-15,2020-06-19,2020-06-19,9.0,-12.03,-46.74,0.0,151.0,           ,1.0,1.0,51.0
9392,Muut,2020-06-19 11:58:04.182305540,2020-06-19,2020-06-19,2020-06-19,9.0,-1.22,-47.96,0.0,105.0,OKOYFIHH   ,1.0,0.0,5.0
9393,Ravintolat_kahvilat,2020-06-19 12:48:15.442359164,2020-06-19,2020-06-19,2020-06-19,9.0,-1.5,-49.46,0.0,151.0,           ,1.0,1.0,52.0
9394,Asuminen,2020-06-19 14:59:31.045576312,2020-06-19,2020-06-19,2020-06-19,9.0,-30.34,-79.8,0.0,106.0,OKOYFIHH   ,0.0,0.0,46.0
9395,Muut,2020-06-19 15:49:42.305629936,2020-06-19,2020-06-19,2020-06-19,9.0,-4.49,-84.29,0.0,105.0,OKOYFIHH   ,1.0,0.0,8.0
9396,Muut,2020-06-19 19:41:20.428954332,2020-06-19,2020-06-19,2020-06-19,9.0,-8.28,-92.57,0.0,105.0,OKOYFIHH   ,1.0,0.0,8.0
9397,Muut,2020-06-19 22:42:47.292225104,2020-06-19,2020-06-19,2020-06-19,9.0,-6.61,-99.18,0.0,105.0,OKOYFIHH   ,1.0,0.0,6.0
9398,Muut,2020-06-20 06:26:03.538873896,2020-06-22,2020-06-22,2020-06-22,9.0,-104.3,-203.48,0.0,105.0,OKOYFIHH   ,1.0,0.0,12.0
9399,Muut,2020-06-20 07:16:14.798927520,2020-06-22,2020-06-22,2020-06-22,9.0,-3.26,-206.74,0.0,105.0,OKOYFIHH   ,1.0,0.0,5.0
9400,Matkailu,2020-06-20 13:19:08.525469064,2020-06-20,2020-06-20,2020-06-20,9.0,-1.41,-208.15,0.0,151.0,           ,1.0,1.0,51.0
9401,Luottojen_maksut,2020-06-20 13:38:26.702412788,2020-06-20,2020-06-20,2020-06-20,9.0,-1.93,-210.08,0.0,151.0,           ,1.0,1.0,51.0
9402,Muut,2020-06-21 01:44:14.155495876,2020-06-21,2020-06-21,2020-06-21,9.0,-5.27,-215.35,0.0,105.0,OKOYFIHH   ,1.0,0.0,6.0
9403,Luokittelemattomat,2020-06-21 02:34:25.415549500,2020-06-21,2020-06-21,2020-06-21,9.0,-0.67,-216.02,0.0,151.0,           ,1.0,1.0,51.0
9404,Muut,2020-06-21 03:24:36.675603124,2020-06-21,2020-06-21,2020-06-21,9.0,-2.26,-218.28,0.0,105.0,OKOYFIHH   ,1.0,0.0,6.0
9405,Muut,2020-06-21 08:37:19.142091044,2020-06-21,2020-06-21,2020-06-21,9.0,-1.9,-220.18,0.0,105.0,OKOYFIHH   ,1.0,0.0,6.0
9406,Muut,2020-06-21 14:09:19.785522688,2020-06-21,2020-06-21,2020-06-21,9.0,-18.53,-238.71,0.0,105.0,OKOYFIHH   ,1.0,0.0,5.0
9407,Liikkuminen,2020-06-21 18:00:57.908847084,2020-06-21,2020-06-21,2020-06-21,9.0,-1.3,-240.01,0.0,151.0,           ,1.0,1.0,51.0
9408,Muut,2020-06-22 04:45:41.018766648,2020-06-22,2020-06-22,2020-06-22,9.0,-0.74,-240.75,0.0,105.0,OKOYFIHH   ,1.0,0.0,5.0
9409,Hyvinvointi,2020-06-22 05:35:52.278820272,2020-06-22,2020-06-22,2020-06-22,9.0,-1.51,-242.26,0.0,162.0,           ,1.0,1.0,177.0
9410,Ravintolat_kahvilat,2020-06-22 07:47:07.882037420,2020-06-22,2020-06-22,2020-06-22,9.0,-2.48,-244.74,0.0,105.0,OKOYFIHH   ,1.0,0.0,5.0
9411,Ruoka_paivittaistavarakauppa,2020-06-22 09:27:30.402144668,2020-06-22,2020-06-22,2020-06-22,9.0,-0.28,-245.02,0.0,105.0,OKOYFIHH   ,1.0,0.0,6.0
9412,Muut,2020-06-22 10:17:41.662198292,2020-06-22,2020-06-22,2020-06-22,9.0,-1.43,-246.45,0.0,105.0,OKOYFIHH   ,1.0,0.0,8.0
9413,Muut,2020-06-22 17:10:46.648793460,2020-06-22,2020-06-22,2020-06-22,9.0,-0.64,-247.09,0.0,105.0,OKOYFIHH   ,1.0,0.0,6.0
9414,Matkailu,2020-06-22 20:12:13.512064232,2020-06-22,2020-06-22,2020-06-22,9.0,-1.55,-248.64,0.0,151.0,           ,1.0,1.0,52.0
9415,Muut,2020-06-22 21:02:24.772117856,2020-06-22,2020-06-22,2020-06-22,9.0,-16.86,-265.5,0.0,105.0,OKOYFIHH   ,1.0,0.0,6.0
9416,Muut,2020-06-23 00:54:02.895442252,2020-06-23,2020-06-24,2020-06-23,9.0,-4.73,-270.23,0.0,105.0,OKOYFIHH   ,1.0,0.0,6.0
9417,Lapset,2020-06-23 06:56:56.621983796,2020-06-23,2020-06-23,2020-06-23,9.0,-6.18,-276.41,0.0,106.0,OKOYFIHH   ,0.0,0.0,31.0
9418,Muut,2020-06-23 16:20:35.388739836,2020-06-23,2020-06-23,2020-06-23,9.0,-26.21,-302.62,0.0,105.0,OKOYFIHH   ,1.0,0.0,5.0
9419,Ravintolat_kahvilat,2020-06-23 21:52:36.032171480,2020-06-23,2020-06-23,2020-06-23,9.0,-9.09,-311.71,0.0,106.0,NDEAFIHH   ,0.0,0.0,30.0
9420,Muut,2020-06-23 23:13:40.375335004,2020-06-23,2020-06-23,2020-06-23,9.0,-31.93,-343.64,0.0,105.0,OKOYFIHH   ,1.0,0.0,7.0
9421,Luokittelemattomat,2020-06-24 03:05:18.498659400,2020-06-24,2020-06-24,2020-06-24,9.0,-5.36,-349.0,0.0,151.0,           ,1.0,1.0,54.0
9422,Lemmikit,2020-06-24 03:55:29.758713024,2020-06-24,2020-06-24,2020-06-24,9.0,-9.32,-358.32,0.0,106.0,OKOYFIHH   ,0.0,0.0,35.0
9423,Liikkuminen,2020-06-24 12:28:57.265415440,2020-06-24,2020-06-24,2020-06-24,9.0,-26.12,-384.44,0.0,106.0,OKOYFIHH   ,1.0,0.0,30.0
9424,Asuminen,2020-06-24 19:22:02.252010608,2020-06-24,2020-06-25,2020-06-24,9.0,-38.91,-423.35,0.0,106.0,NDEAFIHH   ,0.0,0.0,13.0
9425,Kulttuuri_viihde,2020-06-25 00:03:51.635388628,2020-06-25,2020-06-25,2020-06-25,9.0,-8.67,-432.02,0.0,106.0,OKOYFIHH   ,0.0,0.0,14.0
9426,Muut,2020-06-25 10:48:34.745308192,2020-06-25,2020-06-25,2020-06-25,9.0,-22.96,-454.98,0.0,105.0,OKOYFIHH   ,1.0,0.0,6.0
9427,Muut,2020-06-25 11:38:46.005361816,2020-06-25,2020-06-25,2020-06-25,9.0,-8.74,-463.72,0.0,105.0,OKOYFIHH   ,1.0,0.0,5.0
9428,Muut,2020-06-25 13:50:01.608578964,2020-06-25,2020-06-25,2020-06-25,9.0,-2.79,-466.51,0.0,103.0,           ,0.0,1.0,2.0
9429,Luokittelemattomat,2020-06-25 14:40:12.868632588,2020-06-25,2020-06-25,2020-06-25,9.0,-41.45,-507.96,0.0,106.0,OKOYFIHH   ,1.0,0.0,30.0
9430,Asuminen,2020-06-25 18:31:50.991956984,2020-06-25,2020-06-25,2020-06-25,9.0,-60.07,-568.03,0.0,106.0,DABAFIHH   ,0.0,0.0,20.0
9431,Muut,2020-06-25 22:23:29.115281380,2020-06-25,2020-06-25,2020-06-25,9.0,-13.5,-581.53,0.0,105.0,OKOYFIHH   ,1.0,0.0,7.0
9432,Tulot,2020-06-26 01:24:55.978552152,2020-06-26,2020-06-26,2020-06-26,9.0,465.9,-115.63,701.0,506.0,           ,1.0,1.0,228.0
9433,Muut,2020-06-26 02:15:07.238605776,2020-06-26,2020-06-26,2020-06-26,9.0,-11.59,-127.22,0.0,105.0,OKOYFIHH   ,1.0,0.0,10.0
9434,Muut,2020-06-26 06:06:45.361930172,2020-06-26,2020-06-26,2020-06-26,9.0,-1.25,-128.47,0.0,105.0,OKOYFIHH   ,1.0,0.0,11.0
9435,Liikkuminen,2020-06-26 09:08:12.225200944,2020-06-26,2020-06-26,2020-06-26,9.0,-21.98,-150.45,0.0,106.0,OKOYFIHH   ,0.0,0.0,40.0
9436,Muut,2020-06-26 09:58:23.485254568,2020-06-26,2020-06-26,2020-06-26,9.0,-20.1,-170.55,0.0,105.0,OKOYFIHH   ,1.0,0.0,5.0
9437,Muut,2020-06-26 15:30:24.128686212,2020-06-26,2020-06-26,2020-06-26,9.0,-7.53,-178.08,0.0,105.0,OKOYFIHH   ,1.0,0.0,6.0
9438,Asuminen,2020-06-26 16:51:28.471849736,2020-06-26,2020-06-26,2020-06-26,9.0,-56.9,-234.98,0.0,129.0,NDEAFIHH   ,0.0,0.0,47.0
9439,Muut,2020-06-26 17:41:39.731903360,2020-06-26,2020-06-26,2020-06-26,9.0,-13.42,-248.4,0.0,105.0,OKOYFIHH   ,1.0,0.0,5.0
9440,Asuminen,2020-06-26 20:43:06.595174132,2020-06-26,2020-06-26,2020-06-26,9.0,-15.95,-264.35,0.0,106.0,OKOYFIHH   ,0.0,0.0,27.0
9441,Tulot,2020-06-26 21:33:17.855227756,2020-06-26,2020-06-26,2020-06-26,9.0,97.6,-166.75,710.0,506.0,           ,1.0,1.0,260.0
9442,Liikkuminen,2020-06-27 05:16:34.101876548,2020-06-27,2020-06-27,2020-06-27,9.0,-11.18,-177.93,0.0,106.0,OKOYFIHH   ,0.0,0.0,45.0
9443,Luottojen_maksut,2020-06-27 12:59:50.348525340,2020-06-27,2020-06-27,2020-06-27,9.0,-9.09,-187.02,0.0,106.0,OKOYFIHH   ,1.0,0.0,19.0
9444,Luottojen_maksut,2020-06-28 00:34:44.718498528,2020-06-28,2020-06-28,2020-06-28,9.0,-1.5,-188.52,0.0,151.0,           ,1.0,1.0,51.0
9445,Vakuutukset,2020-06-28 03:36:11.581769300,2020-06-28,2020-06-28,2020-06-28,9.0,-3.64,-192.16,0.0,106.0,OKOYFIHH   ,0.0,0.0,16.0
9446,Muut,2020-06-28 08:18:00.965147320,2020-06-28,2020-06-28,2020-06-28,9.0,-2.7,-194.86,0.0,105.0,OKOYFIHH   ,1.0,0.0,6.0
9447,Kulttuuri_viihde,2020-06-28 19:02:44.075066884,2020-06-28,2020-06-28,2020-06-28,9.0,-13.16,-208.02,0.0,106.0,OKOYFIHH   ,0.0,0.0,13.0
9448,Muut,2020-06-28 23:44:33.458444904,2020-06-28,2020-06-28,2020-06-28,9.0,-32.2,-240.22,0.0,105.0,OKOYFIHH   ,1.0,0.0,12.0
9449,Ruoka_paivittaistavarakauppa,2020-06-29 06:37:38.445040072,2020-06-29,2020-06-29,2020-06-29,9.0,-4.88,-245.1,0.0,162.0,           ,1.0,1.0,151.0
9450,Luokittelemattomat,2020-06-29 10:29:16.568364468,2020-06-29,2020-06-29,2020-06-29,9.0,-2.15,-247.25,0.0,162.0,           ,1.0,1.0,108.0
9451,Luokittelemattomat,2020-06-29 14:20:54.691688864,2020-06-29,2020-06-29,2020-06-29,9.0,-7.31,-254.56,0.0,106.0,OKOYFIHH   ,1.0,0.0,24.0
9452,Muut,2020-06-29 16:01:17.211796112,2020-06-29,2020-06-29,2020-06-29,9.0,-16.32,-270.88,0.0,105.0,OKOYFIHH   ,1.0,0.0,5.0
9453,Muut,2020-06-29 19:52:55.335120508,2020-06-29,2020-06-29,2020-06-29,9.0,-1.78,-272.66,0.0,105.0,OKOYFIHH   ,1.0,0.0,6.0
9454,Ravintolat_kahvilat,2020-06-29 22:04:10.938337656,2020-06-29,2020-06-29,2020-06-29,9.0,-13.81,-286.47,0.0,162.0,           ,1.0,1.0,82.0
9455,Muut,2020-06-29 22:54:22.198391280,2020-06-29,2020-06-29,2020-06-29,9.0,-2.54,-289.01,0.0,105.0,OKOYFIHH   ,1.0,0.0,5.0
9456,Ravintolat_kahvilat,2020-06-30 02:46:00.321715676,2020-06-30,2020-06-30,2020-06-30,9.0,-5.08,-294.09,0.0,162.0,           ,1.0,1.0,58.0
9457,Muut,2020-06-30 04:26:22.841822924,2020-06-30,2020-06-30,2020-06-30,9.0,-40.7,-334.79,0.0,105.0,OKOYFIHH   ,1.0,0.0,5.0
9458,Luottojen_maksut,2020-06-30 07:27:49.705093696,2020-06-30,2020-06-30,2020-06-30,9.0,-14.0,-348.79,0.0,106.0,NDEAFIHH   ,0.0,0.0,15.0
9459,Muut,2020-06-30 11:19:27.828418092,2020-06-30,2020-06-30,2020-06-30,9.0,-0.9,-349.69,0.0,105.0,OKOYFIHH   ,1.0,0.0,5.0
9460,Muut,2020-06-30 15:11:05.951742488,2020-06-30,2020-06-30,2020-07-02,9.0,-8.95,-358.64,0.0,105.0,OKOYFIHH   ,1.0,0.0,6.0
9461,Muut,2020-06-30 18:12:32.815013260,2020-06-30,2020-06-30,2020-06-30,9.0,-0.4,-359.04,0.0,105.0,OKOYFIHH   ,1.0,0.0,5.0
9462,Lemmikit,2020-07-01 09:28:39.745222929,2020-07-01,2020-07-01,2020-07-01,9.0,-70.78,-429.82,0.0,106.0,OKOYFIHH   ,0.0,0.0,34.0
9463,Luottojen_maksut,2020-07-01 18:57:19.490445858,2020-07-01,2020-07-01,2020-07-01,9.0,-4.41,-434.23,0.0,106.0,OKOYFIHH   ,0.0,0.0,13.0
9464,Ruoka_paivittaistavarakauppa,2020-07-02 04:25:59.235668787,2020-07-02,2020-07-02,2020-07-02,9.0,-1.57,-435.8,0.0,162.0,           ,1.0,1.0,166.0
9465,Tulot,2020-07-02 13:54:38.980891716,2020-07-02,2020-07-02,2020-07-02,9.0,398.29,-37.51,0.0,506.0,           ,1.0,1.0,219.0
9466,Muut,2020-07-02 23:23:18.726114645,2020-07-02,2020-07-02,2020-07-02,9.0,-11.79,-49.3,0.0,105.0,OKOYFIHH   ,1.0,0.0,5.0
9467,Tulot,2020-07-03 03:49:17.961783432,2020-07-03,2020-07-03,2020-07-03,9.0,348.71,299.41,701.0,506.0,           ,1.0,1.0,227.0
9468,Ravintolat_kahvilat,2020-07-03 08:51:58.471337574,2020-07-03,2020-07-03,2020-07-03,9.0,-63.93,235.48,0.0,162.0,           ,1.0,1.0,125.0
9469,Matkailu,2020-07-03 13:17:57.707006361,2020-07-03,2020-07-03,2020-07-03,9.0,-194.62,40.86,0.0,101.0,           ,1.0,1.0,1.0
9470,Ruoka_paivittaistavarakauppa,2020-07-03 18:20:38.216560503,2020-07-03,2020-07-03,2020-07-03,9.0,-7.08,33.78,0.0,162.0,           ,1.0,1.0,112.0
9471,Ruoka_paivittaistavarakauppa,2020-07-03 22:46:37.452229290,2020-07-03,2020-07-03,2020-07-03,9.0,-11.41,22.37,0.0,162.0,           ,1.0,1.0,172.0
9472,Luottojen_maksut,2020-07-06 03:12:36.687898077,2020-07-06,2020-07-06,2020-07-06,9.0,-8.56,13.81,0.0,106.0,NDEAFIHH   ,0.0,0.0,23.0
9473,Ruoka_paivittaistavarakauppa,2020-07-06 12:41:16.433121006,2020-07-06,2020-07-06,2020-07-06,9.0,-6.52,7.29,0.0,162.0,           ,1.0,1.0,118.0
9474,Ruoka_paivittaistavarakauppa,2020-07-06 17:43:56.942675148,2020-07-06,2020-07-06,2020-07-06,9.0,-2.41,4.88,0.0,162.0,           ,1.0,1.0,139.0
9475,Ruoka_paivittaistavarakauppa,2020-07-06 22:09:56.178343935,2020-07-06,2020-07-06,2020-07-06,9.0,-10.81,-5.93,0.0,162.0,           ,1.0,1.0,130.0
9476,Muut,2020-07-07 07:38:35.923566864,2020-07-07,2020-07-07,2020-07-07,9.0,-3.12,-9.05,0.0,105.0,OKOYFIHH   ,1.0,0.0,7.0
9477,Matkailu,2020-07-07 08:15:17.197452219,2020-07-07,2020-07-07,2020-07-07,9.0,-0.38,-9.43,0.0,105.0,OKOYFIHH   ,1.0,0.0,6.0
9478,Tulot,2020-07-07 12:04:35.159235651,2020-07-07,2020-07-07,2020-07-07,9.0,5.51,-3.92,0.0,505.0,           ,1.0,1.0,215.0
9479,Muut,2020-07-07 17:07:15.668789793,2020-07-07,2020-07-07,2020-07-07,9.0,-13.38,-17.3,0.0,105.0,OKOYFIHH   ,1.0,0.0,6.0
9480,Asuminen,2020-07-08 21:33:14.904458580,2020-07-08,2020-07-08,2020-07-08,9.0,-50.02,-67.32,706.0,129.0,NDEAFIHH   ,0.0,0.0,242.0
9481,Ruoka_paivittaistavarakauppa,2020-07-09 01:59:14.140127367,2020-07-09,2020-07-09,2020-07-09,9.0,-25.08,-92.4,0.0,162.0,           ,1.0,1.0,173.0
9482,Muut,2020-07-09 02:35:55.414012722,2020-07-09,2020-07-09,2020-07-09,9.0,-57.86,-150.26,0.0,105.0,OKOYFIHH   ,1.0,0.0,6.0
9483,Luokittelemattomat,2020-07-09 07:01:54.649681509,2020-07-09,2020-07-09,2020-07-09,9.0,-10.92,-161.18,0.0,162.0,           ,1.0,1.0,105.0
9484,Ravintolat_kahvilat,2020-07-09 11:27:53.885350296,2020-07-09,2020-07-09,2020-07-09,9.0,-5.32,-166.5,0.0,162.0,           ,1.0,1.0,111.0
9485,Kulttuuri_viihde,2020-07-09 16:30:34.394904438,2020-07-09,2020-07-09,2020-07-09,9.0,-10.07,-176.57,0.0,162.0,           ,1.0,1.0,59.0
9486,Muut,2020-07-10 06:25:13.375796154,2020-07-10,2020-07-10,2020-07-10,9.0,-3.37,-179.94,0.0,105.0,OKOYFIHH   ,1.0,0.0,5.0
9487,Lemmikit,2020-07-10 20:56:33.630573225,2020-07-10,2020-07-10,2020-07-10,9.0,-4.73,-184.67,0.0,162.0,           ,1.0,1.0,184.0
9488,Muut,2020-07-12 15:53:53.121019083,2020-07-12,2020-07-12,2020-07-12,9.0,-7.82,-192.49,0.0,105.0,OKOYFIHH   ,1.0,0.0,6.0
9489,Matkailu,2020-07-12 20:19:52.356687870,2020-07-12,2020-07-12,2020-07-12,9.0,-0.57,-193.06,0.0,105.0,OKOYFIHH   ,1.0,0.0,5.0
9490,Muut,2020-07-13 01:22:32.866242012,2020-07-13,2020-07-15,2020-07-13,9.0,-14.83,-207.89,0.0,105.0,OKOYFIHH   ,1.0,0.0,5.0
9491,Tulot,2020-07-13 05:48:32.101910799,2020-07-13,2020-07-13,2020-07-13,9.0,456.06,248.17,701.0,520.0,           ,1.0,1.0,232.0
9492,Saastot_sijoitukset,2020-07-13 10:51:12.611464941,2020-07-13,2020-07-13,2020-07-13,9.0,-3.88,244.29,0.0,162.0,           ,1.0,1.0,138.0
9493,Muut,2020-07-13 15:17:11.847133728,2020-07-13,2020-07-13,2020-07-13,9.0,-34.52,209.77,0.0,105.0,OKOYFIHH   ,1.0,0.0,5.0
9494,Muut,2020-07-14 00:45:51.592356657,2020-07-14,2020-07-14,2020-07-14,9.0,-25.61,184.16,0.0,105.0,OKOYFIHH   ,1.0,0.0,5.0
9495,Muut,2020-07-14 10:14:31.337579586,2020-07-14,2020-07-14,2020-07-13,9.0,-34.52,149.64,0.0,105.0,OKOYFIHH   ,1.0,0.0,5.0
9496,Tulot,2020-07-14 19:43:11.082802515,2020-07-14,2020-07-14,2020-07-14,9.0,5.16,154.8,0.0,500.0,OKOYFIHH   ,1.0,0.0,212.0
9497,Muut,2020-07-15 05:11:50.828025444,2020-07-15,2020-07-15,2020-07-15,9.0,-142.36,12.44,0.0,105.0,OKOYFIHH   ,1.0,0.0,5.0
9498,Luokittelemattomat,2020-07-15 14:40:30.573248373,2020-07-15,2020-07-16,2020-07-15,9.0,-1.57,10.87,0.0,106.0,OKOYFIHH   ,1.0,0.0,40.0
9499,Tulot,2020-07-16 00:09:10.318471302,2020-07-16,2020-07-16,2020-07-16,9.0,29.02,39.89,710.0,506.0,           ,1.0,1.0,255.0
9500,Lemmikit,2020-07-16 04:35:09.554140089,2020-07-16,2020-07-16,2020-07-16,9.0,-34.88,5.01,0.0,162.0,           ,1.0,1.0,161.0
9501,Muut,2020-07-16 09:37:50.063694231,2020-07-16,2020-07-16,2020-07-16,9.0,-44.27,-39.26,0.0,105.0,OKOYFIHH   ,1.0,0.0,5.0
9502,Ruoka_paivittaistavarakauppa,2020-07-16 14:03:49.299363018,2020-07-16,2020-07-16,2020-07-16,9.0,-1.38,-40.64,0.0,162.0,           ,1.0,1.0,184.0
9503,Muut,2020-07-16 19:06:29.808917160,2020-07-16,2020-07-17,2020-07-16,9.0,-70.37,-111.01,0.0,105.0,OKOYFIHH   ,1.0,0.0,5.0
9504,Ruoka_paivittaistavarakauppa,2020-07-16 23:32:29.044585947,2020-07-16,2020-07-16,2020-07-16,9.0,-4.63,-115.64,0.0,162.0,           ,1.0,1.0,150.0
9505,Liikkuminen,2020-07-17 09:01:08.789808876,2020-07-17,2020-07-17,2020-07-17,9.0,-1.51,-117.15,0.0,162.0,           ,1.0,1.0,128.0
9506,Kulttuuri_viihde,2020-07-17 18:29:48.535031805,2020-07-17,2020-07-17,2020-07-17,9.0,-2.62,-119.77,0.0,162.0,           ,1.0,1.0,100.0
9507,Lemmikit,2020-07-20 03:58:28.280254734,2020-07-20,2020-07-20,2020-07-20,9.0,-13.62,-133.39,0.0,106.0,OKOYFIHH   ,0.0,0.0,26.0
9508,Matkailu,2020-07-20 08:24:27.515923521,2020-07-20,2020-07-20,2020-07-20,9.0,-16.31,-149.7,0.0,162.0,           ,1.0,1.0,176.0
9509,Ravintolat_kahvilat,2020-07-20 12:50:26.751592308,2020-07-20,2020-07-20,2020-07-20,9.0,-0.38,-150.08,0.0,162.0,           ,1.0,1.0,144.0
9510,Ruoka_paivittaistavarakauppa,2020-07-20 13:27:08.025477663,2020-07-20,2020-07-20,2020-07-20,9.0,-4.58,-154.66,0.0,162.0,           ,1.0,1.0,90.0
9511,Lemmikit,2020-07-20 17:53:07.261146450,2020-07-20,2020-07-20,2020-07-20,9.0,-4.35,-159.01,0.0,162.0,           ,1.0,1.0,132.0
9512,Hyvinvointi,2020-07-20 22:55:47.770700592,2020-07-20,2020-07-20,2020-07-20,9.0,-1.54,-160.55,0.0,162.0,           ,1.0,1.0,142.0
9513,Matkailu,2020-07-21 17:16:25.987261095,2020-07-21,2020-07-21,2020-07-21,9.0,-4.65,-165.2,0.0,162.0,           ,1.0,1.0,145.0
9514,Ruoka_paivittaistavarakauppa,2020-07-21 22:19:06.496815237,2020-07-21,2020-07-21,2020-07-21,9.0,-0.51,-165.71,0.0,162.0,           ,1.0,1.0,177.0
9515,Ruoka_paivittaistavarakauppa,2020-07-22 02:45:05.732484024,2020-07-22,2020-07-22,2020-07-22,9.0,-3.91,-169.62,0.0,162.0,           ,1.0,1.0,123.0
9516,Muut,2020-07-22 03:21:47.006369379,2020-07-22,2020-07-22,2020-07-22,9.0,-4.42,-174.04,0.0,105.0,OKOYFIHH   ,1.0,0.0,5.0
9517,Ruoka_paivittaistavarakauppa,2020-07-22 07:47:46.242038166,2020-07-22,2020-07-24,2020-07-22,9.0,-11.92,-185.96,0.0,162.0,           ,1.0,1.0,90.0
9518,Lemmikit,2020-07-22 21:42:25.222929882,2020-07-22,2020-07-22,2020-07-22,9.0,-3.06,-189.02,0.0,162.0,           ,1.0,1.0,105.0
9519,Muut,2020-07-24 07:11:04.968152811,2020-07-24,2020-07-24,2020-07-24,9.0,-18.4,-207.42,0.0,163.0,           ,1.0,1.0,207.0
9520,Liikkuminen,2020-07-24 11:37:04.203821598,2020-07-24,2020-07-24,2020-07-24,9.0,-2.85,-210.27,0.0,162.0,           ,1.0,1.0,90.0
9521,Ravintolat_kahvilat,2020-07-24 12:13:45.477706953,2020-07-24,2020-07-24,2020-07-24,9.0,-1.75,-212.02,0.0,162.0,           ,1.0,1.0,123.0
9522,Ravintolat_kahvilat,2020-07-24 16:39:44.713375740,2020-07-24,2020-07-24,2020-07-24,9.0,-1.67,-213.69,0.0,162.0,           ,1.0,1.0,135.0
9523,Hyvinvointi,2020-07-24 21:05:43.949044527,2020-07-24,2020-07-24,2020-07-24,9.0,-21.37,-235.06,0.0,162.0,           ,1.0,1.0,163.0
9524,Ruoka_paivittaistavarakauppa,2020-07-27 01:31:43.184713314,2020-07-27,2020-07-27,2020-07-27,9.0,-0.72,-235.78,0.0,162.0,           ,1.0,1.0,192.0
9525,Hyvinvointi,2020-07-27 02:08:24.458598669,2020-07-27,2020-07-27,2020-07-27,9.0,-17.17,-252.95,0.0,162.0,           ,1.0,1.0,57.0
9526,Ruoka_paivittaistavarakauppa,2020-07-27 05:57:42.420382101,2020-07-27,2020-07-27,2020-07-27,9.0,-1.54,-254.49,0.0,162.0,           ,1.0,1.0,185.0
9527,Ravintolat_kahvilat,2020-07-27 06:34:23.694267456,2020-07-27,2020-07-28,2020-07-27,9.0,-5.62,-260.11,0.0,162.0,           ,1.0,1.0,59.0
9528,Ruoka_paivittaistavarakauppa,2020-07-27 11:00:22.929936243,2020-07-27,2020-07-27,2020-07-27,9.0,-1.68,-261.79,0.0,162.0,           ,1.0,1.0,140.0
9529,Ruoka_paivittaistavarakauppa,2020-07-27 15:26:22.165605030,2020-07-27,2020-07-27,2020-07-27,9.0,-1.45,-263.24,0.0,162.0,           ,1.0,1.0,162.0
9530,Ruoka_paivittaistavarakauppa,2020-07-27 16:03:03.439490385,2020-07-27,2020-07-27,2020-07-27,9.0,-7.03,-270.27,0.0,162.0,           ,1.0,1.0,113.0
9531,Ravintolat_kahvilat,2020-07-27 19:52:21.401273817,2020-07-27,2020-07-27,2020-07-27,9.0,-6.85,-277.12,0.0,162.0,           ,1.0,1.0,113.0
9532,Tulot,2020-07-27 20:29:02.675159172,2020-07-27,2020-07-29,2020-07-27,9.0,-28.86,-305.98,706.0,129.0,OKOYFIHH   ,0.0,0.0,240.0
9533,Ruoka_paivittaistavarakauppa,2020-07-30 00:18:20.636942604,2020-07-30,2020-07-30,2020-07-30,9.0,-7.44,-313.42,0.0,162.0,           ,1.0,1.0,199.0
9534,Ruoka_paivittaistavarakauppa,2020-07-30 10:23:41.656050888,2020-07-30,2020-07-30,2020-07-30,9.0,-3.07,-316.49,0.0,162.0,           ,1.0,1.0,88.0
9535,Ravintolat_kahvilat,2020-07-30 14:49:40.891719675,2020-07-30,2020-07-31,2020-07-30,9.0,-1.55,-318.04,0.0,162.0,           ,1.0,1.0,164.0
9536,Ruoka_paivittaistavarakauppa,2020-07-31 00:55:01.910827959,2020-07-31,2020-07-31,2020-07-31,9.0,-1.52,-319.56,0.0,162.0,           ,1.0,1.0,120.0
9537,Ruoka_paivittaistavarakauppa,2020-07-31 05:21:01.146496746,2020-07-31,2020-07-31,2020-07-31,9.0,-0.94,-320.5,0.0,162.0,           ,1.0,1.0,111.0
9538,Ruoka_paivittaistavarakauppa,2020-07-31 09:47:00.382165533,2020-07-31,2020-07-31,2020-07-31,9.0,-3.31,-323.81,0.0,162.0,           ,1.0,1.0,90.0
9539,Ruoka_paivittaistavarakauppa,2020-07-31 19:15:40.127388462,2020-07-31,2020-07-31,2020-07-31,9.0,-14.82,-338.63,0.0,162.0,           ,1.0,1.0,125.0
9540,Tulot,2020-08-03 04:04:31.698113207,2020-08-03,2020-08-03,2020-08-03,9.0,100.22,-238.41,701.0,520.0,           ,1.0,1.0,232.0
9541,Vakuutukset,2020-08-03 08:09:03.396226414,2020-08-03,2020-08-03,2020-08-03,9.0,-21.21,-259.62,0.0,106.0,SBANFIHH   ,0.0,0.0,42.0
9542,Muut,2020-08-04 12:13:35.094339621,2020-08-04,2020-08-04,2020-08-04,9.0,-0.66,-260.28,0.0,105.0,OKOYFIHH   ,1.0,0.0,5.0
9543,Tulot,2020-08-05 16:18:06.792452828,2020-08-05,2020-08-06,2020-08-05,9.0,196.94,-63.34,701.0,520.0,           ,1.0,1.0,233.0
9544,Ruoka_paivittaistavarakauppa,2020-08-07 00:27:10.188679242,2020-08-07,2020-08-07,2020-08-07,9.0,-13.96,-77.3,0.0,162.0,           ,1.0,1.0,138.0
9545,Ruoka_paivittaistavarakauppa,2020-08-07 20:22:38.490566035,2020-08-07,2020-08-07,2020-08-07,9.0,-0.73,-78.03,0.0,162.0,           ,1.0,1.0,192.0
9546,Ravintolat_kahvilat,2020-08-10 04:31:41.886792449,2020-08-10,2020-08-10,2020-08-10,9.0,-2.46,-80.49,0.0,162.0,           ,1.0,1.0,172.0
9547,Lapset,2020-08-10 08:36:13.584905656,2020-08-10,2020-08-10,2020-08-10,9.0,-8.65,-89.14,0.0,162.0,           ,1.0,1.0,177.0
9548,Ruoka_paivittaistavarakauppa,2020-08-11 12:40:45.283018863,2020-08-11,2020-08-11,2020-08-11,9.0,-4.28,-93.42,0.0,162.0,           ,1.0,1.0,169.0
9549,Ravintolat_kahvilat,2020-08-11 16:45:16.981132070,2020-08-11,2020-08-11,2020-08-11,9.0,-0.95,-94.37,0.0,162.0,           ,1.0,1.0,105.0
9550,Ruoka_paivittaistavarakauppa,2020-08-12 20:49:48.679245277,2020-08-12,2020-08-12,2020-08-12,9.0,-5.96,-100.33,0.0,162.0,           ,1.0,1.0,95.0
9551,Ruoka_paivittaistavarakauppa,2020-08-13 00:54:20.377358484,2020-08-13,2020-08-13,2020-08-13,9.0,-1.63,-101.96,0.0,162.0,           ,1.0,1.0,112.0
9552,Ravintolat_kahvilat,2020-08-17 04:58:52.075471691,2020-08-17,2020-08-17,2020-08-17,9.0,-1.95,-103.91,0.0,162.0,           ,1.0,1.0,162.0
9553,Ruoka_paivittaistavarakauppa,2020-08-17 09:03:23.773584898,2020-08-17,2020-08-17,2020-08-17,9.0,-1.88,-105.79,0.0,162.0,           ,1.0,1.0,105.0
9554,Ruoka_paivittaistavarakauppa,2020-08-18 13:07:55.471698105,2020-08-18,2020-08-18,2020-08-18,9.0,-5.91,-111.7,0.0,162.0,           ,1.0,1.0,69.0
9555,Ravintolat_kahvilat,2020-08-19 17:12:27.169811312,2020-08-19,2020-08-19,2020-08-19,9.0,-5.27,-116.97,0.0,162.0,           ,1.0,1.0,121.0
9556,Asuminen,2020-08-21 21:16:58.867924519,2020-08-21,2020-08-21,2020-08-17,9.0,-23.51,-140.48,706.0,129.0,OKOYFIHH   ,0.0,0.0,244.0
9557,Liikkuminen,2020-08-24 01:21:30.566037726,2020-08-24,2020-08-24,2020-08-24,9.0,-2.56,-143.04,0.0,162.0,           ,1.0,1.0,112.0
9558,Ruoka_paivittaistavarakauppa,2020-08-24 05:26:02.264150933,2020-08-24,2020-08-24,2020-08-24,9.0,-1.1,-144.14,0.0,162.0,           ,1.0,1.0,152.0
9559,Ruoka_paivittaistavarakauppa,2020-08-24 09:30:33.962264140,2020-08-24,2020-08-24,2020-08-24,9.0,-6.1,-150.24,0.0,162.0,           ,1.0,1.0,115.0
9560,Ruoka_paivittaistavarakauppa,2020-08-25 13:35:05.660377347,2020-08-25,2020-08-25,2020-08-25,9.0,-19.36,-169.6,0.0,162.0,           ,1.0,1.0,95.0
9561,Lemmikit,2020-08-27 17:39:37.358490554,2020-08-27,2020-08-28,2020-08-27,9.0,-0.7,-170.3,0.0,162.0,           ,1.0,1.0,136.0
9562,Ruoka_paivittaistavarakauppa,2020-08-27 21:44:09.056603761,2020-08-27,2020-08-27,2020-08-27,9.0,-6.42,-176.72,0.0,162.0,           ,1.0,1.0,100.0
9563,Ruoka_paivittaistavarakauppa,2020-08-31 01:48:40.754716968,2020-08-31,2020-08-31,2020-08-31,9.0,-5.74,-182.46,0.0,162.0,           ,1.0,1.0,116.0
9564,Ruoka_paivittaistavarakauppa,2020-08-31 05:53:12.452830175,2020-08-31,2020-08-31,2020-08-31,9.0,-1.52,-183.98,0.0,162.0,           ,1.0,1.0,151.0
9565,Asuminen,2020-08-31 09:57:44.150943382,2020-08-31,2020-08-31,2020-08-31,9.0,-8.97,-192.95,0.0,106.0,NDEAFIHH   ,0.0,0.0,13.0
9566,Tulot,2020-09-01 19:12:00.000000000,2020-09-01,2020-09-01,2020-09-01,9.0,326.45,133.5,701.0,520.0,           ,1.0,1.0,231.0
9567,Luottojen_maksut,2020-09-02 14:24:00.000000000,2020-09-02,2020-09-02,2020-09-02,9.0,-40.95,92.55,706.0,129.0,OKOYFIHH   ,0.0,0.0,240.0
9568,Ruoka_paivittaistavarakauppa,2020-09-03 09:36:00.000000000,2020-09-03,2020-09-03,2020-09-03,9.0,-11.13,81.42,0.0,162.0,           ,1.0,1.0,105.0
9569,Ruoka_paivittaistavarakauppa,2020-09-04 00:00:00.000000000,2020-09-04,2020-09-04,2020-09-04,9.0,-40.44,40.98,0.0,162.0,           ,1.0,1.0,115.0
9570,Ruoka_paivittaistavarakauppa,2020-09-04 04:48:00.000000000,2020-09-04,2020-09-04,2020-09-04,9.0,-11.47,29.51,0.0,162.0,           ,1.0,1.0,133.0
9571,Liikkuminen,2020-09-04 19:12:00.000000000,2020-09-04,2020-09-04,2020-09-04,9.0,-19.84,9.67,0.0,106.0,OKOYFIHH   ,1.0,0.0,24.0
9572,Saastot_sijoitukset,2020-09-07 00:00:00.000000000,2020-09-07,2020-09-07,2020-09-07,9.0,-4.14,5.53,0.0,162.0,           ,1.0,1.0,98.0
9573,Luokittelemattomat,2020-09-07 09:36:00.000000000,2020-09-07,2020-09-07,2020-09-07,9.0,-17.53,-12.0,0.0,106.0,OKOYFIHH   ,0.0,0.0,14.0
9574,Tulot,2020-09-07 14:24:00.000000000,2020-09-07,2020-09-07,2020-09-07,9.0,100.83,88.83,701.0,521.0,           ,1.0,1.0,234.0
9575,Muut,2020-09-08 04:48:00.000000000,2020-09-08,2020-09-08,2020-09-08,9.0,-124.84,-36.01,0.0,105.0,OKOYFIHH   ,1.0,0.0,5.0
9576,Asuminen,2020-09-08 19:12:00.000000000,2020-09-08,2020-09-08,2020-09-08,9.0,-22.41,-58.42,706.0,129.0,OKOYFIHH   ,0.0,0.0,247.0
9577,Muut,2020-09-10 14:24:00.000000000,2020-09-10,2020-09-10,2020-09-10,9.0,-9.85,-68.27,706.0,129.0,NDEAFIHH   ,0.0,0.0,245.0
9578,Ruoka_paivittaistavarakauppa,2020-09-11 00:00:00.000000000,2020-09-11,2020-09-11,2020-09-11,9.0,-1.49,-69.76,0.0,162.0,           ,1.0,1.0,129.0
9579,Ruoka_paivittaistavarakauppa,2020-09-11 04:48:00.000000000,2020-09-11,2020-09-11,2020-09-11,9.0,-1.61,-71.37,0.0,162.0,           ,1.0,1.0,128.0
9580,Tulot,2020-09-11 09:36:00.000000000,2020-09-11,2020-09-11,2020-09-11,9.0,-25.95,-97.32,0.0,162.0,           ,1.0,1.0,160.0
9581,Lapset,2020-09-14 14:24:00.000000000,2020-09-14,2020-09-14,2020-09-14,9.0,-7.16,-104.48,0.0,162.0,           ,1.0,1.0,113.0
9582,Muut,2020-09-15 09:36:00.000000000,2020-09-15,2020-09-15,2020-09-15,9.0,-17.78,-122.26,0.0,105.0,OKOYFIHH   ,1.0,0.0,8.0
9583,Ruoka_paivittaistavarakauppa,2020-09-15 19:12:00.000000000,2020-09-15,2020-09-15,2020-09-15,9.0,-4.24,-126.5,0.0,162.0,           ,1.0,1.0,69.0
9584,Ruoka_paivittaistavarakauppa,2020-09-16 04:48:00.000000000,2020-09-16,2020-09-16,2020-09-16,9.0,-2.24,-128.74,0.0,162.0,           ,1.0,1.0,196.0
9585,Liikkuminen,2020-09-17 19:12:00.000000000,2020-09-17,2020-09-17,2020-09-17,9.0,-2.91,-131.65,0.0,162.0,           ,1.0,1.0,177.0
9586,Harrastukset,2020-09-18 00:00:00.000000000,2020-09-18,2020-09-18,2020-09-18,9.0,-13.55,-145.2,706.0,129.0,OKOYFIHH   ,0.0,0.0,241.0
9587,Ruoka_paivittaistavarakauppa,2020-09-18 09:36:00.000000000,2020-09-18,2020-09-18,2020-09-18,9.0,-4.05,-149.25,0.0,162.0,           ,1.0,1.0,113.0
9588,Tulot,2020-09-18 14:24:00.000000000,2020-09-18,2020-09-18,2020-09-18,9.0,-3.22,-152.47,0.0,162.0,           ,1.0,1.0,127.0
9589,Hyvinvointijakauneus,2020-09-21 00:00:00.000000000,2020-09-21,2020-09-21,2020-09-21,9.0,-17.18,-169.65,0.0,162.0,           ,1.0,1.0,82.0
9590,Ruoka_paivittaistavarakauppa,2020-09-21 14:24:00.000000000,2020-09-21,2020-09-21,2020-09-21,9.0,-3.48,-173.13,0.0,162.0,           ,1.0,1.0,138.0
9591,Shoppailu,2020-09-21 19:12:00.000000000,2020-09-21,2020-09-21,2020-09-21,9.0,-67.61,-240.74,706.0,129.0,DABAFIHH   ,0.0,0.0,240.0
9592,Ruoka_paivittaistavarakauppa,2020-09-22 04:48:00.000000000,2020-09-22,2020-09-22,2020-09-22,9.0,-13.02,-253.76,0.0,162.0,           ,1.0,1.0,82.0
9593,Lemmikit,2020-09-23 00:00:00.000000000,2020-09-23,2020-09-23,2020-09-23,9.0,-9.7,-263.46,0.0,162.0,           ,1.0,1.0,141.0
9594,Tulot,2020-09-23 09:36:00.000000000,2020-09-23,2020-09-23,2020-09-23,9.0,344.93,81.47,0.0,505.0,           ,1.0,1.0,213.0
9595,Ruoka_paivittaistavarakauppa,2020-09-24 04:48:00.000000000,2020-09-24,2020-09-24,2020-09-24,9.0,-15.83,65.64,0.0,162.0,           ,1.0,1.0,90.0
9596,Liikkuminen,2020-09-24 19:12:00.000000000,2020-09-24,2020-09-24,2020-09-24,9.0,-6.57,59.07,706.0,129.0,OKOYFIHH   ,0.0,0.0,241.0
9597,Lemmikit,2020-09-28 04:48:00.000000000,2020-09-28,2020-09-28,2020-09-28,9.0,-11.97,47.1,0.0,162.0,           ,1.0,1.0,156.0
9598,Liikkuminen,2020-09-28 09:36:00.000000000,2020-09-28,2020-09-28,2020-09-28,9.0,-9.69,37.41,0.0,162.0,           ,1.0,1.0,136.0
9599,Vakuutukset,2020-09-28 14:24:00.000000000,2020-09-28,2020-09-28,2020-09-28,9.0,-208.36,-170.95,706.0,129.0,DABAFIHH   ,0.0,0.0,243.0
9600,Asuminen,2020-09-29 00:00:00.000000000,2020-09-29,2020-09-30,2020-09-29,9.0,-13.33,-184.28,706.0,129.0,DABAFIHH   ,0.0,0.0,243.0
9601,Terveys,2020-09-29 19:12:00.000000000,2020-09-29,2020-09-29,2020-09-29,9.0,-9.51,-193.79,706.0,129.0,OKOYFIHH   ,0.0,0.0,240.0
9602,Tulot,2020-09-30 14:24:00.000000000,2020-09-30,2020-09-30,2020-09-30,9.0,242.13,48.34,0.0,505.0,           ,1.0,1.0,216.0
9603,Tulot,2020-10-02 16:12:58.378378378,2020-10-02,2020-10-02,2020-10-02,9.0,216.78,265.12,701.0,520.0,           ,1.0,1.0,232.0
9604,Liikkuminen,2020-10-04 08:25:56.756756756,2020-10-04,2020-10-04,2020-10-04,9.0,-61.03,204.09,0.0,106.0,OKOYFIHH   ,0.0,0.0,35.0
9605,Asuminen,2020-10-06 00:38:55.135135134,2020-10-06,2020-10-06,2020-10-06,9.0,-11.34,192.75,706.0,129.0,OKOYFIHH   ,0.0,0.0,244.0
9606,Harrastukset,2020-10-07 16:51:53.513513512,2020-10-07,2020-10-07,2020-10-07,9.0,-9.36,183.39,706.0,129.0,NDEAFIHH   ,0.0,0.0,240.0
9607,Ruoka_paivittaistavarakauppa,2020-10-09 09:04:51.891891890,2020-10-09,2020-10-09,2020-10-09,9.0,-3.57,179.82,0.0,162.0,           ,1.0,1.0,121.0
9608,Saastot_sijoitukset,2020-10-12 01:17:50.270270268,2020-10-12,2020-10-12,2020-10-12,9.0,-0.65,179.17,0.0,162.0,           ,1.0,1.0,110.0
9609,Ruoka_paivittaistavarakauppa,2020-10-12 17:30:48.648648646,2020-10-12,2020-10-12,2020-10-12,9.0,-42.91,136.26,0.0,162.0,           ,1.0,1.0,165.0
9610,Ruoka_paivittaistavarakauppa,2020-10-15 09:43:47.027027024,2020-10-15,2020-10-15,2020-10-15,9.0,-7.27,128.99,0.0,162.0,           ,1.0,1.0,78.0
9611,Ruoka_paivittaistavarakauppa,2020-10-16 01:56:45.405405402,2020-10-16,2020-10-16,2020-10-16,9.0,-9.44,119.55,0.0,162.0,           ,1.0,1.0,121.0
9612,Luokittelemattomat,2020-10-16 18:09:43.783783780,2020-10-16,2020-10-16,2020-10-16,9.0,-20.96,98.59,0.0,162.0,           ,1.0,1.0,189.0
9613,Liikkuminen,2020-10-19 10:22:42.162162158,2020-10-19,2020-10-19,2020-10-19,9.0,-51.58,47.01,0.0,162.0,           ,1.0,1.0,171.0
9614,Muut,2020-10-21 18:48:38.918918914,2020-10-21,2020-10-21,2020-10-21,9.0,-26.53,20.48,0.0,163.0,           ,1.0,1.0,204.0
9615,Lapset,2020-10-22 02:35:40.540540536,2020-10-22,2020-10-22,2020-10-22,9.0,-4.67,15.81,0.0,162.0,           ,1.0,1.0,147.0
9616,Ruoka_paivittaistavarakauppa,2020-10-26 03:14:35.675675670,2020-10-26,2020-10-26,2020-10-26,9.0,-4.98,10.83,0.0,162.0,           ,1.0,1.0,184.0
9617,Ruoka_paivittaistavarakauppa,2020-10-26 11:01:37.297297292,2020-10-26,2020-10-26,2020-10-26,9.0,-5.51,5.32,0.0,162.0,           ,1.0,1.0,166.0
9618,Ravintolat_kahvilat,2020-10-27 19:27:34.054054048,2020-10-27,2020-10-27,2020-10-27,9.0,-32.13,-26.81,0.0,162.0,           ,1.0,1.0,143.0
9619,Asuminen,2020-10-29 11:40:32.432432426,2020-10-29,2020-10-29,2020-10-29,9.0,-23.09,-49.9,706.0,129.0,OKOYFIHH   ,0.0,0.0,243.0
9620,Liikkuminen,2020-10-30 03:53:30.810810804,2020-10-30,2020-10-30,2020-10-30,9.0,-42.69,-92.59,0.0,106.0,OKOYFIHH   ,0.0,0.0,15.0
9621,Ruoka_paivittaistavarakauppa,2020-11-02 09:06:12.413793102,2020-11-02,2020-11-02,2020-11-02,9.0,-16.37,-108.96,0.0,162.0,           ,1.0,1.0,108.0
9622,Asuminen,2020-11-03 01:39:18.620689653,2020-11-03,2020-11-03,2020-11-03,9.0,-12.28,-121.24,706.0,129.0,OKOYFIHH   ,0.0,0.0,243.0
9623,Tulot,2020-11-03 10:45:31.034482755,2020-11-03,2020-11-03,2020-11-03,9.0,336.28,215.04,0.0,505.0,           ,1.0,1.0,213.0
9624,Matkailu,2020-11-03 16:33:06.206896551,2020-11-03,2020-11-03,2020-11-03,9.0,-50.38,164.66,0.0,162.0,           ,1.0,1.0,116.0
9625,Tulot,2020-11-03 18:12:24.827586204,2020-11-03,2020-11-03,2020-11-03,9.0,92.77,257.43,0.0,505.0,           ,1.0,1.0,213.0
9626,Luottojen_maksut,2020-11-05 03:18:37.241379306,2020-11-05,2020-11-05,2020-11-05,9.0,-6.04,251.39,0.0,170.0,           ,1.0,1.0,209.0
9627,Luottojen_maksut,2020-11-05 19:51:43.448275857,2020-11-05,2020-11-05,2020-11-05,9.0,-69.95,181.44,0.0,170.0,           ,1.0,1.0,209.0
9628,Ruoka_paivittaistavarakauppa,2020-11-06 04:57:55.862068959,2020-11-06,2020-11-06,2020-11-06,9.0,-30.81,150.63,0.0,162.0,           ,1.0,1.0,197.0
9629,Shoppailu,2020-11-06 12:24:49.655172408,2020-11-06,2020-11-06,2020-11-06,9.0,-10.99,139.64,0.0,162.0,           ,1.0,1.0,111.0
9630,Ruoka_paivittaistavarakauppa,2020-11-06 21:31:02.068965510,2020-11-06,2020-11-06,2020-11-06,9.0,-5.7,133.94,0.0,162.0,           ,1.0,1.0,59.0
9631,Ravintolat_kahvilat,2020-11-09 06:37:14.482758612,2020-11-09,2020-11-09,2020-11-09,9.0,-9.43,124.51,0.0,162.0,           ,1.0,1.0,82.0
9632,Ruoka_paivittaistavarakauppa,2020-11-09 14:04:08.275862061,2020-11-09,2020-11-09,2020-11-09,9.0,-6.36,118.15,0.0,162.0,           ,1.0,1.0,133.0
9633,Asuminen,2020-11-09 23:10:20.689655163,2020-11-09,2020-11-09,2020-11-09,9.0,-4.92,113.23,0.0,162.0,           ,1.0,1.0,57.0
9634,Muut,2020-11-10 08:16:33.103448265,2020-11-10,2020-11-10,2020-11-10,9.0,-34.68,78.55,0.0,163.0,           ,1.0,1.0,204.0
9635,Ruoka_paivittaistavarakauppa,2020-11-10 15:43:26.896551714,2020-11-10,2020-11-10,2020-11-10,9.0,-14.76,63.79,0.0,162.0,           ,1.0,1.0,183.0
9636,Ruoka_paivittaistavarakauppa,2020-11-11 09:55:51.724137918,2020-11-11,2020-11-11,2020-11-11,9.0,-19.54,44.25,0.0,162.0,           ,1.0,1.0,133.0
9637,Ruoka_paivittaistavarakauppa,2020-11-12 00:49:39.310344816,2020-11-12,2020-11-12,2020-11-12,9.0,-3.83,40.42,0.0,162.0,           ,1.0,1.0,188.0
9638,Ravintolat_kahvilat,2020-11-12 17:22:45.517241367,2020-11-12,2020-11-12,2020-11-12,9.0,-0.55,39.87,0.0,162.0,           ,1.0,1.0,167.0
9639,Matkailu,2020-11-13 02:28:57.931034469,2020-11-13,2020-11-13,2020-11-13,9.0,-3.31,36.56,706.0,129.0,OKOYFIHH   ,1.0,0.0,240.0
9640,Luokittelemattomat,2020-11-13 19:02:04.137931020,2020-11-13,2020-11-13,2020-11-13,9.0,-5.64,30.92,0.0,106.0,OKOYFIHH   ,0.0,0.0,42.0
9641,Ruoka_paivittaistavarakauppa,2020-11-16 04:08:16.551724122,2020-11-16,2020-11-16,2020-11-16,9.0,-3.64,27.28,0.0,162.0,           ,1.0,1.0,145.0
9642,Luottojen_maksut,2020-11-16 11:35:10.344827571,2020-11-16,2020-11-16,2020-11-16,9.0,-5.84,21.44,0.0,162.0,           ,1.0,1.0,145.0
9643,Ruoka_paivittaistavarakauppa,2020-11-16 20:41:22.758620673,2020-11-16,2020-11-16,2020-11-16,9.0,-15.21,6.23,0.0,162.0,           ,1.0,1.0,154.0
9644,Hyvinvointijakauneus,2020-11-16 22:20:41.379310326,2020-11-16,2020-11-16,2020-11-16,9.0,-5.77,0.46,0.0,106.0,OKOYFIHH   ,0.0,0.0,23.0
9645,Muut,2020-11-17 13:14:28.965517224,2020-11-17,2020-11-19,2020-11-17,9.0,-0.29,0.17,0.0,103.0,           ,0.0,1.0,2.0
9646,Tulot,2020-11-18 05:47:35.172413775,2020-11-18,2020-11-18,2020-11-18,9.0,4.01,4.18,0.0,506.0,           ,1.0,1.0,220.0
9647,Liikkuminen,2020-11-19 14:53:47.586206877,2020-11-19,2020-11-19,2020-11-19,9.0,-2.54,1.64,0.0,162.0,           ,1.0,1.0,58.0
9648,Tulot,2020-11-20 07:26:53.793103428,2020-11-20,2020-11-20,2020-11-20,9.0,51.97,53.61,0.0,505.0,           ,1.0,1.0,214.0
9649,Liikkuminen,2020-11-20 16:33:06.206896530,2020-11-20,2020-11-20,2020-11-20,9.0,-3.47,50.14,0.0,162.0,           ,1.0,1.0,112.0
9650,Ruoka_paivittaistavarakauppa,2020-11-20 23:59:59.999999979,2020-11-20,2020-11-20,2020-11-20,9.0,-4.19,45.95,0.0,162.0,           ,1.0,1.0,141.0
9651,Asuminen,2020-11-23 01:39:18.620689632,2020-11-23,2020-11-23,2020-11-23,9.0,-36.53,9.42,706.0,129.0,OKOYFIHH   ,0.0,0.0,246.0
9652,Terveys,2020-11-23 09:06:12.413793081,2020-11-23,2020-11-23,2020-11-23,9.0,-7.66,1.76,0.0,162.0,           ,1.0,1.0,125.0
9653,Terveys,2020-11-23 18:12:24.827586183,2020-11-23,2020-11-23,2020-11-23,9.0,73.38,75.14,0.0,505.0,           ,1.0,1.0,213.0
9654,Lapset,2020-11-24 10:45:31.034482734,2020-11-24,2020-11-24,2020-11-24,9.0,-27.93,47.21,0.0,106.0,OKOYFIHH   ,0.0,0.0,17.0
9655,Luokittelemattomat,2020-11-25 03:18:37.241379285,2020-11-25,2020-11-25,2020-11-25,9.0,-17.76,29.45,0.0,106.0,NDEAFIHH   ,1.0,0.0,15.0
9656,Luokittelemattomat,2020-11-25 12:24:49.655172387,2020-11-25,2020-11-25,2020-11-25,9.0,-6.16,23.29,0.0,106.0,NDEAFIHH   ,1.0,0.0,45.0
9657,Tulot,2020-11-26 19:51:43.448275836,2020-11-26,2020-11-26,2020-11-26,9.0,65.2,88.49,0.0,505.0,           ,1.0,1.0,213.0
9658,Kulttuuri_viihde,2020-11-27 04:57:55.862068938,2020-11-27,2020-11-27,2020-11-27,9.0,-40.88,47.61,0.0,162.0,           ,1.0,1.0,72.0
9659,Tulot,2020-11-27 14:04:08.275862040,2020-11-27,2020-11-27,2020-11-27,9.0,39.75,87.36,0.0,505.0,           ,1.0,1.0,215.0
9660,Ruoka_paivittaistavarakauppa,2020-11-27 21:31:02.068965489,2020-11-27,2020-11-27,2020-11-27,9.0,-16.14,71.22,0.0,162.0,           ,1.0,1.0,173.0
9661,Ruoka_paivittaistavarakauppa,2020-11-30 06:37:14.482758591,2020-11-30,2020-11-30,2020-11-30,9.0,-41.68,29.54,0.0,162.0,           ,1.0,1.0,173.0
9662,Ruoka_paivittaistavarakauppa,2020-11-30 15:43:26.896551693,2020-11-30,2020-11-30,2020-11-30,9.0,-8.79,20.75,0.0,162.0,           ,1.0,1.0,125.0
9663,Ravintolat_kahvilat,2020-11-30 23:10:20.689655142,2020-11-30,2020-11-30,2020-11-30,9.0,-0.82,19.93,0.0,162.0,           ,1.0,1.0,147.0
9664,Lapset,2020-12-01 14:26:47.766990291,2020-12-01,2020-12-01,2020-12-01,9.0,-15.22,4.71,0.0,106.0,OKOYFIHH   ,0.0,0.0,14.0
9665,Ruoka_paivittaistavarakauppa,2020-12-02 04:53:35.533980582,2020-12-02,2020-12-02,2020-12-02,9.0,-4.71,0.0,0.0,162.0,           ,1.0,1.0,95.0
9666,Ruoka_paivittaistavarakauppa,2020-12-02 19:20:23.300970873,2020-12-02,2020-12-02,2020-12-02,9.0,-3.69,-3.69,0.0,162.0,           ,1.0,1.0,77.0
9667,Tulot,2020-12-03 09:47:11.067961164,2020-12-03,2020-12-03,2020-12-03,9.0,2.09,-1.6,0.0,505.0,           ,1.0,1.0,214.0
9668,Luokittelemattomat,2020-12-04 00:13:58.834951455,2020-12-04,2020-12-04,2020-12-04,9.0,-107.84,-109.44,0.0,129.0,OKOYFIHH   ,0.0,0.0,47.0
9669,Tulot,2020-12-04 14:40:46.601941746,2020-12-04,2020-12-04,2020-12-04,9.0,-18.15,-127.59,0.0,129.0,OKOYFIHH   ,0.0,0.0,49.0
9670,Luottojen_maksut,2020-12-04 19:34:22.135922328,2020-12-04,2020-12-04,2020-12-04,9.0,-18.37,-145.96,0.0,106.0,OKOYFIHH   ,0.0,0.0,42.0
9671,Tulot,2020-12-05 05:07:34.368932037,2020-12-05,2020-12-05,2020-12-05,9.0,215.58,69.62,0.0,505.0,           ,1.0,1.0,215.0
9672,Lapset,2020-12-06 10:01:09.902912619,2020-12-06,2020-12-06,2020-12-06,9.0,-22.9,46.72,0.0,106.0,OKOYFIHH   ,0.0,0.0,27.0
9673,Liikkuminen,2020-12-07 00:27:57.669902910,2020-12-07,2020-12-07,2020-12-07,9.0,-38.46,8.26,0.0,106.0,OKOYFIHH   ,1.0,0.0,39.0
9674,Lapset,2020-12-07 05:21:33.203883492,2020-12-07,2020-12-07,2020-12-07,9.0,-9.36,-1.1,0.0,106.0,OKOYFIHH   ,1.0,0.0,16.0
9675,Ruoka_paivittaistavarakauppa,2020-12-07 10:15:08.737864074,2020-12-07,2020-12-07,2020-12-07,9.0,-12.64,-13.74,0.0,162.0,           ,1.0,1.0,117.0
9676,Luokittelemattomat,2020-12-07 14:54:45.436893201,2020-12-07,2020-12-08,2020-12-07,9.0,-4.44,-18.18,0.0,106.0,SBANFIHH   ,1.0,0.0,16.0
9677,Muut,2020-12-08 19:48:20.970873783,2020-12-08,2020-12-08,2020-12-08,9.0,-109.22,-127.4,0.0,100.0,           ,1.0,1.0,0.0
9678,Ruoka_paivittaistavarakauppa,2020-12-09 00:41:56.504854365,2020-12-09,2020-12-09,2020-12-09,9.0,-7.61,-135.01,0.0,162.0,           ,1.0,1.0,61.0
9679,Matkailu,2020-12-10 20:02:19.805825238,2020-12-10,2020-12-10,2020-12-10,9.0,-21.24,-156.25,0.0,106.0,NDEAFIHH   ,0.0,0.0,42.0
9680,Asuminen,2020-12-11 05:35:32.038834947,2020-12-11,2020-12-11,2020-12-11,9.0,-6.85,-163.1,0.0,106.0,OKOYFIHH   ,0.0,0.0,35.0
9681,Ruoka_paivittaistavarakauppa,2020-12-11 15:08:44.271844656,2020-12-11,2020-12-11,2020-12-11,9.0,-68.34,-231.44,0.0,162.0,           ,1.0,1.0,141.0
9682,Luottojen_maksut,2020-12-12 10:29:07.572815529,2020-12-12,2020-12-12,2020-12-12,9.0,-4.0,-235.44,0.0,106.0,NDEAFIHH   ,1.0,0.0,35.0
9683,Muut,2020-12-13 15:22:43.106796111,2020-12-13,2020-12-13,2020-12-13,9.0,-5.84,-241.28,0.0,163.0,           ,1.0,1.0,204.0
9684,Shoppailu,2020-12-14 05:49:30.873786402,2020-12-14,2020-12-14,2020-12-14,9.0,-6.66,-247.94,0.0,106.0,OKOYFIHH   ,0.0,0.0,46.0
9685,Luokittelemattomat,2020-12-14 20:16:18.640776693,2020-12-14,2020-12-14,2020-12-14,9.0,-36.9,-284.84,0.0,106.0,NDEAFIHH   ,0.0,0.0,42.0
9686,Ruoka_paivittaistavarakauppa,2020-12-15 00:55:55.339805820,2020-12-15,2020-12-15,2020-12-15,9.0,-4.81,-289.65,0.0,162.0,           ,1.0,1.0,142.0
9687,Lapset,2020-12-15 10:43:06.407766984,2020-12-15,2020-12-15,2020-12-15,9.0,-5.14,-294.79,0.0,106.0,OKOYFIHH   ,0.0,0.0,44.0
9688,Tulot,2020-12-15 15:36:41.941747566,2020-12-15,2020-12-15,2020-12-15,9.0,684.87,390.08,0.0,505.0,           ,1.0,1.0,213.0
9689,Matkailu,2020-12-16 01:09:54.174757275,2020-12-16,2020-12-18,2020-12-16,9.0,-72.51,317.57,0.0,106.0,OKOYFIHH   ,0.0,0.0,13.0
9690,Muut,2020-12-16 20:30:17.475728148,2020-12-16,2020-12-16,2020-12-16,9.0,-25.48,292.09,0.0,163.0,           ,1.0,1.0,205.0
9691,Luokittelemattomat,2020-12-17 06:03:29.708737857,2020-12-17,2020-12-17,2020-12-17,9.0,-105.14,186.95,0.0,106.0,NDEAFIHH   ,1.0,0.0,29.0
9692,Ravintolat_kahvilat,2020-12-18 01:23:53.009708730,2020-12-18,2020-12-18,2020-12-18,9.0,-6.18,180.77,0.0,162.0,           ,1.0,1.0,128.0
9693,Liikkuminen,2020-12-18 10:57:05.242718439,2020-12-18,2020-12-18,2020-12-18,9.0,-24.07,156.7,0.0,162.0,           ,1.0,1.0,147.0
9694,Ravintolat_kahvilat,2020-12-18 15:50:40.776699021,2020-12-18,2020-12-18,2020-12-18,9.0,-3.13,153.57,0.0,162.0,           ,1.0,1.0,138.0
9695,Muut,2020-12-19 20:44:16.310679603,2020-12-19,2020-12-19,2020-12-19,9.0,-50.27,103.3,0.0,163.0,           ,1.0,1.0,205.0
9696,Ruoka_paivittaistavarakauppa,2020-12-21 06:17:28.543689312,2020-12-21,2020-12-21,2020-12-22,9.0,-1.42,101.88,0.0,162.0,           ,1.0,1.0,158.0
9697,Luokittelemattomat,2020-12-21 06:31:27.378640767,2020-12-21,2020-12-21,2020-12-21,9.0,-49.7,52.18,0.0,106.0,OKOYFIHH   ,1.0,0.0,23.0
9698,Liikkuminen,2020-12-21 11:11:04.077669894,2020-12-21,2020-12-21,2020-12-21,9.0,-54.77,-2.59,0.0,106.0,OKOYFIHH   ,1.0,0.0,16.0
9699,Harrastukset,2020-12-23 11:25:02.912621349,2020-12-23,2020-12-23,2020-12-23,9.0,-41.86,-44.45,0.0,106.0,NDEAFIHH   ,0.0,0.0,46.0
9700,Ruoka_paivittaistavarakauppa,2020-12-23 16:04:39.611650476,2020-12-23,2020-12-23,2020-12-23,9.0,-2.54,-46.99,0.0,162.0,           ,1.0,1.0,197.0
9701,Ruoka_paivittaistavarakauppa,2020-12-24 01:37:51.844660185,2020-12-24,2020-12-24,2020-12-24,9.0,-7.92,-54.91,0.0,162.0,           ,1.0,1.0,57.0
9702,Lapset,2020-12-24 20:58:15.145631058,2020-12-24,2020-12-24,2020-12-24,9.0,-10.36,-65.27,0.0,106.0,OKOYFIHH   ,0.0,0.0,35.0
9703,Lapset,2020-12-25 16:18:38.446601931,2020-12-25,2020-12-25,2020-12-25,9.0,-6.45,-71.72,0.0,106.0,OKOYFIHH   ,1.0,0.0,27.0
9704,Lapset,2020-12-25 21:12:13.980582513,2020-12-25,2020-12-25,2020-12-25,9.0,-14.22,-85.94,0.0,106.0,OKOYFIHH   ,0.0,0.0,22.0
9705,Vakuutukset,2020-12-26 06:45:26.213592222,2020-12-26,2020-12-26,2020-12-26,9.0,-7.8,-93.74,0.0,106.0,OKOYFIHH   ,0.0,0.0,13.0
9706,Asuminen,2020-12-28 01:51:50.679611640,2020-12-28,2020-12-28,2020-12-28,9.0,-150.22,-243.96,0.0,106.0,DABAFIHH   ,0.0,0.0,44.0
9707,Kulttuuri_viihde,2020-12-28 02:05:49.514563095,2020-12-28,2020-12-28,2020-12-28,9.0,-3.67,-247.63,0.0,162.0,           ,1.0,1.0,160.0
9708,Tulot,2020-12-28 11:39:01.747572804,2020-12-28,2020-12-29,2020-12-28,9.0,635.18,387.55,701.0,510.0,           ,1.0,1.0,230.0
9709,Harrastukset,2020-12-28 16:32:37.281553386,2020-12-28,2020-12-28,2020-12-28,9.0,-75.67,311.88,0.0,106.0,DABAFIHH   ,0.0,0.0,22.0
9710,Muut,2020-12-29 02:19:48.349514550,2020-12-29,2020-12-29,2020-12-29,9.0,-18.35,293.53,0.0,105.0,OKOYFIHH   ,1.0,0.0,5.0
9711,Liikkuminen,2020-12-29 06:59:25.048543677,2020-12-29,2020-12-29,2020-12-29,9.0,-143.57,149.96,0.0,106.0,OKOYFIHH   ,1.0,0.0,23.0
9712,Luokittelemattomat,2020-12-30 11:53:00.582524259,2020-12-30,2020-12-30,2020-12-30,9.0,-4.25,145.71,0.0,106.0,NDEAFIHH   ,0.0,0.0,24.0
9713,Luottojen_maksut,2020-12-30 16:46:36.116504841,2020-12-30,2020-12-30,2020-12-30,9.0,-11.7,134.01,0.0,162.0,           ,1.0,1.0,165.0
9714,Lapset,2020-12-31 21:26:12.815533968,2020-12-31,2020-12-31,2020-12-31,9.0,-23.72,110.29,0.0,106.0,OKOYFIHH   ,0.0,0.0,44.0
9715,Ruoka_paivittaistavarakauppa,2019-01-01 00:00:00.000000000,2019-01-01,2019-01-01,2019-01-01,10.0,-1.7,1.94,0.0,162.0,           ,1.0,1.0,107.0
9716,Hyvinvointi,2019-01-01 22:22:33.383458646,2019-01-01,2019-01-01,2019-01-01,10.0,-205.51,-203.57,0.0,162.0,           ,1.0,1.0,97.0
9717,Liikkuminen,2019-01-02 09:33:50.075187969,2019-01-02,2019-01-03,2019-01-02,10.0,-79.53,-283.1,0.0,162.0,           ,1.0,1.0,161.0
9718,Luokittelemattomat,2019-01-02 20:45:06.766917292,2019-01-02,2019-01-02,2019-01-02,10.0,-253.84,-536.94,0.0,162.0,           ,1.0,1.0,125.0
9719,Liikkuminen,2019-01-03 03:04:03.609022553,2019-01-03,2019-01-03,2019-01-03,10.0,-994.2,-1531.14,0.0,106.0,NDEAFIHH   ,1.0,0.0,42.0
9720,Saastot_sijoitukset,2019-01-03 07:56:23.458646615,2019-01-03,2019-01-03,2019-01-03,10.0,-365.24,-1896.38,0.0,162.0,           ,1.0,1.0,119.0
9721,Liikkuminen,2019-01-03 11:11:16.691729323,2019-01-03,2019-01-03,2019-01-03,10.0,-182.94,-2079.32,0.0,162.0,           ,1.0,1.0,68.0
9722,Luokittelemattomat,2019-01-03 19:07:40.150375938,2019-01-03,2019-01-03,2019-01-03,10.0,-2164.17,-4243.49,0.0,106.0,NDEAFIHH   ,0.0,0.0,16.0
9723,Muut,2019-01-04 06:18:56.842105261,2019-01-04,2019-01-04,2019-01-04,10.0,-1370.36,-5613.85,0.0,106.0,OKOYFIHH   ,0.0,0.0,27.0
9724,Asuminen,2019-01-04 15:52:46.917293230,2019-01-04,2019-01-04,2019-01-04,10.0,-63.68,-5677.53,0.0,106.0,OKOYFIHH   ,0.0,0.0,6.0
9725,Tulot,2019-01-04 17:30:13.533834584,2019-01-04,2019-01-04,2019-01-04,10.0,15.38,-5662.15,701.0,520.0,           ,1.0,1.0,201.0
9726,Lemmikit,2019-01-07 01:26:36.992481199,2019-01-07,2019-01-07,2019-01-07,10.0,-35.14,-5697.29,0.0,162.0,           ,1.0,1.0,181.0
9727,Ruoka_paivittaistavarakauppa,2019-01-07 04:41:30.225563907,2019-01-07,2019-01-07,2019-01-07,10.0,-30.87,-5728.16,0.0,162.0,           ,1.0,1.0,121.0
9728,Tulot,2019-01-07 12:37:53.684210522,2019-01-07,2019-01-07,2019-01-07,10.0,37.84,-5690.32,701.0,520.0,           ,1.0,1.0,202.0
9729,Ruoka_paivittaistavarakauppa,2019-01-07 14:15:20.300751876,2019-01-07,2019-01-07,2019-01-07,10.0,-6.55,-5696.87,0.0,162.0,           ,1.0,1.0,162.0
9730,Ruoka_paivittaistavarakauppa,2019-01-07 23:49:10.375939845,2019-01-07,2019-01-07,2019-01-07,10.0,-8.27,-5705.14,0.0,162.0,           ,1.0,1.0,48.0
9731,Ruoka_paivittaistavarakauppa,2019-01-08 11:00:27.067669168,2019-01-08,2019-01-08,2019-01-08,10.0,-58.11,-5763.25,0.0,162.0,           ,1.0,1.0,103.0
9732,Ravintolat_kahvilat,2019-01-08 20:34:17.142857137,2019-01-08,2019-01-08,2019-01-08,10.0,-1.56,-5764.81,0.0,162.0,           ,1.0,1.0,150.0
9733,Ruoka_paivittaistavarakauppa,2019-01-08 22:11:43.759398491,2019-01-08,2019-01-08,2019-01-08,10.0,-17.18,-5781.99,0.0,162.0,           ,1.0,1.0,132.0
9734,Ruoka_paivittaistavarakauppa,2019-01-10 04:30:40.601503752,2019-01-10,2019-01-10,2019-01-10,10.0,-3.7,-5785.69,0.0,162.0,           ,1.0,1.0,100.0
9735,Hyvinvointi,2019-01-10 06:08:07.218045106,2019-01-10,2019-01-10,2019-01-10,10.0,-51.26,-5836.95,0.0,106.0,OKOYFIHH   ,0.0,0.0,42.0
9736,Matkailu,2019-01-10 17:19:23.909774429,2019-01-10,2019-01-10,2019-01-10,10.0,-1291.15,-7128.1,0.0,106.0,OKOYFIHH   ,0.0,0.0,36.0
9737,Saastot_sijoitukset,2019-01-10 18:56:50.526315783,2019-01-10,2019-01-10,2019-01-10,10.0,-36.41,-7164.51,0.0,162.0,           ,1.0,1.0,156.0
9738,Ravintolat_kahvilat,2019-01-11 07:45:33.834586460,2019-01-11,2019-01-11,2019-01-11,10.0,-27.13,-7191.64,0.0,162.0,           ,1.0,1.0,178.0
9739,Ravintolat_kahvilat,2019-01-11 09:23:00.451127814,2019-01-11,2019-01-11,2019-01-11,10.0,-109.49,-7301.13,0.0,162.0,           ,1.0,1.0,169.0
9740,Liikkuminen,2019-01-11 15:41:57.293233075,2019-01-11,2019-01-11,2019-01-11,10.0,-42.99,-7344.12,0.0,162.0,           ,1.0,1.0,145.0
9741,Ruoka_paivittaistavarakauppa,2019-01-14 01:15:47.368421044,2019-01-14,2019-01-16,2019-01-11,10.0,-3.87,-7347.99,0.0,162.0,           ,1.0,1.0,125.0
9742,Ruoka_paivittaistavarakauppa,2019-01-14 02:53:13.984962398,2019-01-14,2019-01-14,2019-01-14,10.0,-4.46,-7352.45,0.0,162.0,           ,1.0,1.0,180.0
9743,Ruoka_paivittaistavarakauppa,2019-01-14 12:27:04.060150367,2019-01-14,2019-01-14,2019-01-14,10.0,-17.96,-7370.41,0.0,162.0,           ,1.0,1.0,158.0
9744,Matkailu,2019-01-14 14:04:30.676691721,2019-01-14,2019-01-14,2019-01-14,10.0,-42.96,-7413.37,0.0,162.0,           ,1.0,1.0,107.0
9745,Muut,2019-01-14 22:00:54.135338336,2019-01-14,2019-01-14,2019-01-14,10.0,-48.37,-7461.74,0.0,162.0,           ,1.0,1.0,102.0
9746,Ruoka_paivittaistavarakauppa,2019-01-14 23:38:20.751879690,2019-01-14,2019-01-14,2019-01-14,10.0,-15.59,-7477.33,0.0,162.0,           ,1.0,1.0,112.0
9747,Kulttuuri_viihde,2019-01-15 07:34:44.210526305,2019-01-15,2019-01-15,2019-01-15,10.0,-9.59,-7486.92,0.0,162.0,           ,1.0,1.0,156.0
9748,Tulot,2019-01-15 10:49:37.443609013,2019-01-15,2019-01-15,2019-01-15,10.0,2.9,-7484.02,0.0,506.0,           ,1.0,1.0,198.0
9749,Ruoka_paivittaistavarakauppa,2019-01-16 09:12:10.827067659,2019-01-16,2019-01-16,2019-01-16,10.0,-8.55,-7492.57,0.0,162.0,           ,1.0,1.0,92.0
9750,Tulot,2019-01-16 20:23:27.518796982,2019-01-16,2019-01-16,2019-01-16,10.0,9.1,-7483.47,0.0,506.0,           ,1.0,1.0,196.0
9751,Matkailu,2019-01-17 04:19:50.977443597,2019-01-17,2019-01-17,2019-01-17,10.0,-8.06,-7491.53,0.0,103.0,           ,0.0,1.0,1.0
9752,Shoppailu,2019-01-18 05:57:17.593984951,2019-01-18,2019-01-18,2019-01-18,10.0,-6.63,-7498.16,0.0,162.0,           ,1.0,1.0,132.0
9753,Ruoka_paivittaistavarakauppa,2019-01-18 15:31:07.669172920,2019-01-18,2019-01-18,2019-01-18,10.0,-3.89,-7502.05,0.0,162.0,           ,1.0,1.0,67.0
9754,Ruoka_paivittaistavarakauppa,2019-01-18 17:08:34.285714274,2019-01-18,2019-01-18,2019-01-18,10.0,-33.34,-7535.39,0.0,162.0,           ,1.0,1.0,104.0
9755,Ruoka_paivittaistavarakauppa,2019-01-18 18:46:00.902255628,2019-01-18,2019-01-18,2019-01-18,10.0,-2.21,-7537.6,0.0,162.0,           ,1.0,1.0,123.0
9756,Liikkuminen,2019-01-21 01:04:57.744360889,2019-01-21,2019-01-21,2019-01-21,10.0,-36.49,-7574.09,0.0,162.0,           ,1.0,1.0,165.0
9757,Kulttuuri_viihde,2019-01-21 02:42:24.360902243,2019-01-21,2019-01-21,2019-01-21,10.0,-3.15,-7577.24,0.0,162.0,           ,1.0,1.0,116.0
9758,Lemmikit,2019-01-21 10:38:47.819548858,2019-01-21,2019-01-21,2019-01-21,10.0,-5.31,-7582.55,0.0,162.0,           ,1.0,1.0,139.0
9759,Muut,2019-01-21 12:16:14.436090212,2019-01-21,2019-01-21,2019-01-21,10.0,-1.72,-7584.27,0.0,162.0,           ,1.0,1.0,121.0
9760,Ruoka_paivittaistavarakauppa,2019-01-21 13:53:41.052631566,2019-01-21,2019-01-21,2019-01-21,10.0,-3.55,-7587.82,706.0,147.0,OKOYFIHH   ,0.0,0.0,224.0
9761,Ruoka_paivittaistavarakauppa,2019-01-21 21:50:04.511278181,2019-01-21,2019-01-21,2019-01-21,10.0,-22.99,-7610.81,0.0,162.0,           ,1.0,1.0,57.0
9762,Ruoka_paivittaistavarakauppa,2019-01-21 23:27:31.127819535,2019-01-21,2019-01-21,2019-01-21,10.0,-3.24,-7614.05,0.0,162.0,           ,1.0,1.0,110.0
9763,Hyvinvointijakauneus,2019-01-22 20:12:37.894736827,2019-01-22,2019-01-22,2019-01-22,10.0,-3.34,-7617.39,0.0,106.0,OKOYFIHH   ,0.0,0.0,28.0
9764,Ruoka_paivittaistavarakauppa,2019-01-23 09:01:21.203007504,2019-01-23,2019-01-23,2019-01-23,10.0,-34.93,-7652.32,0.0,162.0,           ,1.0,1.0,62.0
9765,Asuminen,2019-01-23 18:35:11.278195473,2019-01-23,2019-01-23,2019-01-23,10.0,-165.28,-7817.6,0.0,106.0,OKOYFIHH   ,0.0,0.0,33.0
9766,Asuminen,2019-01-24 07:23:54.586466150,2019-01-24,2019-01-24,2019-01-24,10.0,-130.17,-7947.77,0.0,106.0,OKOYFIHH   ,0.0,0.0,28.0
9767,Ravintolat_kahvilat,2019-01-24 15:20:18.045112765,2019-01-24,2019-01-24,2019-01-24,10.0,-3.95,-7951.72,0.0,162.0,           ,1.0,1.0,109.0
9768,Asuminen,2019-01-25 05:46:27.969924796,2019-01-25,2019-01-25,2019-01-25,10.0,-46.2,-7997.92,0.0,106.0,DABAFIHH   ,0.0,0.0,15.0
9769,Muut,2019-01-25 16:57:44.661654119,2019-01-25,2019-01-25,2019-01-25,10.0,-6.96,-8004.88,0.0,163.0,           ,1.0,1.0,183.0
9770,Ravintolat_kahvilat,2019-01-28 00:54:08.120300734,2019-01-28,2019-01-28,2019-01-28,10.0,-16.02,-8020.9,0.0,162.0,           ,1.0,1.0,49.0
9771,Ruoka_paivittaistavarakauppa,2019-01-28 02:31:34.736842088,2019-01-28,2019-01-28,2019-01-28,10.0,-14.42,-8035.32,0.0,162.0,           ,1.0,1.0,157.0
9772,Ruoka_paivittaistavarakauppa,2019-01-28 04:09:01.353383442,2019-01-28,2019-01-28,2019-01-28,10.0,-1.74,-8037.06,0.0,162.0,           ,1.0,1.0,115.0
9773,Harrastukset,2019-01-28 12:05:24.812030057,2019-01-28,2019-01-28,2019-01-28,10.0,-15.46,-8052.52,0.0,162.0,           ,1.0,1.0,126.0
9774,Ruoka_paivittaistavarakauppa,2019-01-28 13:42:51.428571411,2019-01-28,2019-01-28,2019-01-28,10.0,-22.0,-8074.52,0.0,162.0,           ,1.0,1.0,179.0
9775,Luokittelemattomat,2019-01-28 20:01:48.270676672,2019-01-28,2019-01-28,2019-01-28,10.0,-3.65,-8078.17,0.0,162.0,           ,1.0,1.0,62.0
9776,Ravintolat_kahvilat,2019-01-28 21:39:14.887218026,2019-01-28,2019-01-28,2019-01-28,10.0,-1.72,-8079.89,0.0,162.0,           ,1.0,1.0,139.0
9777,Liikkuminen,2019-01-28 23:16:41.503759380,2019-01-28,2019-01-28,2019-01-28,10.0,-5.52,-8085.41,0.0,162.0,           ,1.0,1.0,113.0
9778,Ruoka_paivittaistavarakauppa,2019-01-30 07:13:04.962405995,2019-01-30,2019-01-30,2019-01-30,10.0,-24.15,-8109.56,0.0,162.0,           ,1.0,1.0,84.0
9779,Ruoka_paivittaistavarakauppa,2019-01-30 18:24:21.654135318,2019-01-30,2019-01-30,2019-01-30,10.0,-2.78,-8112.34,0.0,162.0,           ,1.0,1.0,156.0
9780,Ruoka_paivittaistavarakauppa,2019-01-31 08:50:31.578947349,2019-01-31,2019-01-31,2019-01-31,10.0,-9.83,-8122.17,0.0,162.0,           ,1.0,1.0,87.0
9781,Tulot,2019-01-31 10:27:58.195488703,2019-01-31,2019-01-31,2019-01-31,10.0,42.91,-8079.26,0.0,506.0,           ,1.0,1.0,199.0
9782,Tulot,2019-02-01 18:24:39.452054794,2019-02-01,2019-02-01,2019-02-01,10.0,118.9,-7960.36,701.0,520.0,           ,1.0,1.0,201.0
9783,Ruoka_paivittaistavarakauppa,2019-02-04 01:38:37.808219176,2019-02-04,2019-02-04,2019-02-04,10.0,-47.32,-8007.68,0.0,162.0,           ,1.0,1.0,163.0
9784,Harrastukset,2019-02-04 07:13:58.356164382,2019-02-04,2019-02-04,2019-02-04,10.0,-64.19,-8071.87,0.0,162.0,           ,1.0,1.0,134.0
9785,Kulttuuri_viihde,2019-02-04 12:49:18.904109588,2019-02-04,2019-02-04,2019-02-04,10.0,-53.67,-8125.54,0.0,162.0,           ,1.0,1.0,90.0
9786,Ravintolat_kahvilat,2019-02-04 20:03:17.260273970,2019-02-04,2019-02-04,2019-02-04,10.0,-3.39,-8128.93,0.0,162.0,           ,1.0,1.0,67.0
9787,Lemmikit,2019-02-05 14:27:56.712328764,2019-02-05,2019-02-05,2019-02-05,10.0,-8.65,-8137.58,0.0,162.0,           ,1.0,1.0,116.0
9788,Tulot,2019-02-06 08:52:36.164383558,2019-02-06,2019-02-06,2019-02-06,10.0,-32.22,-8169.8,0.0,162.0,           ,1.0,1.0,47.0
9789,Liikkuminen,2019-02-07 03:17:15.616438352,2019-02-07,2019-02-07,2019-02-07,10.0,-21.04,-8190.84,0.0,106.0,OKOYFIHH   ,1.0,0.0,10.0
9790,Ruoka_paivittaistavarakauppa,2019-02-07 21:41:55.068493146,2019-02-07,2019-02-07,2019-02-07,10.0,-6.67,-8197.51,0.0,162.0,           ,1.0,1.0,109.0
9791,Ruoka_paivittaistavarakauppa,2019-02-08 10:31:13.972602734,2019-02-08,2019-02-08,2019-02-08,10.0,-4.11,-8201.62,0.0,162.0,           ,1.0,1.0,120.0
9792,Matkailu,2019-02-08 16:06:34.520547940,2019-02-08,2019-02-08,2019-02-08,10.0,-117.63,-8319.25,706.0,129.0,OKOYFIHH   ,0.0,0.0,221.0
9793,Ruoka_paivittaistavarakauppa,2019-02-11 04:55:53.424657528,2019-02-11,2019-02-11,2019-02-08,10.0,-43.15,-8362.4,0.0,162.0,           ,1.0,1.0,134.0
9794,Muut,2019-02-11 17:45:12.328767116,2019-02-11,2019-02-11,2019-02-11,10.0,-2.88,-8365.28,0.0,162.0,           ,1.0,1.0,145.0
9795,Liikkuminen,2019-02-11 23:20:32.876712322,2019-02-11,2019-02-11,2019-02-11,10.0,-269.33,-8634.61,0.0,162.0,           ,1.0,1.0,142.0
9796,Ruoka_paivittaistavarakauppa,2019-02-12 06:34:31.232876704,2019-02-12,2019-02-13,2019-02-12,10.0,-9.92,-8644.53,0.0,162.0,           ,1.0,1.0,176.0
9797,Liikkuminen,2019-02-14 00:59:10.684931498,2019-02-14,2019-02-14,2019-02-14,10.0,-96.13,-8740.66,0.0,162.0,           ,1.0,1.0,120.0
9798,Muut,2019-02-14 19:23:50.136986292,2019-02-14,2019-02-14,2019-02-14,10.0,-30.3,-8770.96,0.0,162.0,           ,1.0,1.0,148.0
9799,Ruoka_paivittaistavarakauppa,2019-02-15 02:37:48.493150674,2019-02-15,2019-02-15,2019-02-15,10.0,-7.14,-8778.1,0.0,162.0,           ,1.0,1.0,165.0
9800,Muut,2019-02-15 12:09:51.780821910,2019-02-15,2019-02-15,2019-02-15,10.0,-30.37,-8808.47,0.0,103.0,           ,0.0,1.0,1.0
9801,Luokittelemattomat,2019-02-15 13:48:29.589041086,2019-02-15,2019-02-15,2019-02-15,10.0,-85.49,-8893.96,706.0,129.0,NDEAFIHH   ,0.0,0.0,221.0
9802,Muut,2019-02-18 08:13:09.041095880,2019-02-18,2019-02-18,2019-02-18,10.0,-46.41,-8940.37,0.0,162.0,           ,1.0,1.0,146.0
9803,Ruoka_paivittaistavarakauppa,2019-02-18 15:27:07.397260262,2019-02-18,2019-02-18,2019-02-18,10.0,-2.79,-8943.16,0.0,162.0,           ,1.0,1.0,115.0
9804,Ruoka_paivittaistavarakauppa,2019-02-18 21:02:27.945205468,2019-02-18,2019-02-18,2019-02-18,10.0,-3.46,-8946.62,0.0,162.0,           ,1.0,1.0,166.0
9805,Ruoka_paivittaistavarakauppa,2019-02-19 04:16:26.301369850,2019-02-19,2019-02-19,2019-02-19,10.0,-11.05,-8957.67,0.0,162.0,           ,1.0,1.0,128.0
9806,Lemmikit,2019-02-19 09:51:46.849315056,2019-02-19,2019-02-19,2019-02-19,10.0,-48.71,-9006.38,0.0,162.0,           ,1.0,1.0,112.0
9807,Ruoka_paivittaistavarakauppa,2019-02-19 17:05:45.205479438,2019-02-19,2019-02-20,2019-02-19,10.0,-3.77,-9010.15,0.0,162.0,           ,1.0,1.0,124.0
9808,Matkailu,2019-02-21 22:41:05.753424644,2019-02-21,2019-02-21,2019-02-21,10.0,-17.3,-9027.45,0.0,162.0,           ,1.0,1.0,47.0
9809,Matkailu,2019-02-22 11:30:24.657534232,2019-02-22,2019-02-22,2019-02-22,10.0,-21.41,-9048.86,0.0,106.0,NDEAFIHH   ,0.0,0.0,11.0
9810,Luokittelemattomat,2019-02-23 05:55:04.109589026,2019-02-23,2019-02-23,2019-02-23,10.0,-105.92,-9154.78,0.0,106.0,OKOYFIHH   ,1.0,0.0,29.0
9811,Luottojen_maksut,2019-02-24 18:44:23.013698614,2019-02-24,2019-02-24,2019-02-24,10.0,-16.43,-9171.21,0.0,106.0,OKOYFIHH   ,1.0,0.0,34.0
9812,Harrastukset,2019-02-25 00:19:43.561643820,2019-02-25,2019-02-25,2019-02-25,10.0,-25.31,-9196.52,0.0,106.0,OKOYFIHH   ,0.0,0.0,37.0
9813,Ruoka_paivittaistavarakauppa,2019-02-25 13:09:02.465753408,2019-02-25,2019-02-25,2019-02-25,10.0,-4.94,-9201.46,0.0,162.0,           ,1.0,1.0,126.0
9814,Ravintolat_kahvilat,2019-02-26 07:33:41.917808202,2019-02-26,2019-02-26,2019-02-26,10.0,-75.44,-9276.9,0.0,162.0,           ,1.0,1.0,67.0
9815,Ruoka_paivittaistavarakauppa,2019-02-27 01:58:21.369862996,2019-02-27,2019-02-27,2019-02-27,10.0,-2.08,-9278.98,0.0,162.0,           ,1.0,1.0,96.0
9816,Ruoka_paivittaistavarakauppa,2019-02-27 20:23:00.821917790,2019-02-27,2019-02-27,2019-02-27,10.0,-20.28,-9299.26,0.0,162.0,           ,1.0,1.0,142.0
9817,Ravintolat_kahvilat,2019-02-28 14:47:40.273972584,2019-02-28,2019-02-28,2019-02-28,10.0,-2.44,-9301.7,0.0,162.0,           ,1.0,1.0,90.0
9818,Ruoka_paivittaistavarakauppa,2019-03-01 11:51:19.518072288,2019-03-01,2019-03-01,2019-03-01,10.0,-8.98,-9310.68,0.0,162.0,           ,1.0,1.0,75.0
9819,Liikkuminen,2019-03-01 17:55:39.759036144,2019-03-01,2019-03-01,2019-03-01,10.0,-6.09,-9316.77,0.0,162.0,           ,1.0,1.0,84.0
9820,Asuminen,2019-03-04 05:46:59.277108432,2019-03-04,2019-03-04,2019-03-04,10.0,-135.44,-9452.21,706.0,129.0,OKOYFIHH   ,0.0,0.0,216.0
9821,Muut,2019-03-04 17:38:18.795180720,2019-03-04,2019-03-04,2019-03-04,10.0,-0.29,-9452.5,0.0,162.0,           ,1.0,1.0,112.0
9822,Ruoka_paivittaistavarakauppa,2019-03-04 23:42:39.036144576,2019-03-04,2019-03-04,2019-03-04,10.0,-3.07,-9455.57,0.0,162.0,           ,1.0,1.0,107.0
9823,Ruoka_paivittaistavarakauppa,2019-03-05 05:29:38.313253008,2019-03-05,2019-03-05,2019-03-05,10.0,-5.9,-9461.47,0.0,162.0,           ,1.0,1.0,100.0
9824,Tulot,2019-03-05 11:33:58.554216864,2019-03-05,2019-03-05,2019-03-05,10.0,6.32,-9455.15,710.0,506.0,           ,1.0,1.0,226.0
9825,Hyvinvointi,2019-03-06 23:25:18.072289152,2019-03-06,2019-03-06,2019-03-06,10.0,-1.85,-9457.0,0.0,162.0,           ,1.0,1.0,121.0
9826,Luottojen_maksut,2019-03-07 17:20:57.831325296,2019-03-07,2019-03-07,2019-03-07,10.0,-5.08,-9462.08,0.0,162.0,           ,1.0,1.0,54.0
9827,Luokittelemattomat,2019-03-08 05:12:17.349397584,2019-03-08,2019-03-08,2019-03-08,10.0,-23.35,-9485.43,0.0,162.0,           ,1.0,1.0,46.0
9828,Lemmikit,2019-03-08 11:16:37.590361440,2019-03-08,2019-03-08,2019-03-08,10.0,-8.67,-9494.1,0.0,162.0,           ,1.0,1.0,81.0
9829,Ruoka_paivittaistavarakauppa,2019-03-08 23:07:57.108433728,2019-03-08,2019-03-08,2019-03-08,10.0,-1.18,-9495.28,0.0,162.0,           ,1.0,1.0,134.0
9830,Asuminen,2019-03-11 10:59:16.626506016,2019-03-11,2019-03-11,2019-03-11,10.0,-59.46,-9554.74,706.0,129.0,OKOYFIHH   ,0.0,0.0,216.0
9831,Ruoka_paivittaistavarakauppa,2019-03-11 17:03:36.867469872,2019-03-11,2019-03-11,2019-03-11,10.0,-53.35,-9608.09,0.0,162.0,           ,1.0,1.0,152.0
9832,Ruoka_paivittaistavarakauppa,2019-03-14 22:33:15.180722880,2019-03-14,2019-03-14,2019-03-14,10.0,-3.95,-9612.04,0.0,162.0,           ,1.0,1.0,97.0
9833,Matkailu,2019-03-15 04:37:35.421686736,2019-03-15,2019-03-15,2019-03-15,10.0,-40.89,-9652.93,0.0,106.0,OKOYFIHH   ,0.0,0.0,17.0
9834,Luokittelemattomat,2019-03-15 04:54:56.385542160,2019-03-15,2019-03-15,2019-03-15,10.0,-92.52,-9745.45,706.0,129.0,OKOYFIHH   ,0.0,0.0,217.0
9835,Liikkuminen,2019-03-15 10:41:55.662650592,2019-03-15,2019-03-15,2019-03-15,10.0,-114.16,-9859.61,0.0,106.0,DABAFIHH   ,1.0,0.0,33.0
9836,Ruoka_paivittaistavarakauppa,2019-03-15 16:28:54.939759024,2019-03-15,2019-03-15,2019-03-15,10.0,-14.85,-9874.46,0.0,162.0,           ,1.0,1.0,104.0
9837,Asuminen,2019-03-15 16:46:15.903614448,2019-03-15,2019-03-15,2019-03-15,10.0,-24.79,-9899.25,0.0,106.0,OKOYFIHH   ,0.0,0.0,40.0
9838,Matkailu,2019-03-15 22:50:36.144578304,2019-03-15,2019-03-15,2019-03-15,10.0,-25.71,-9924.96,0.0,103.0,           ,0.0,1.0,1.0
9839,Ruoka_paivittaistavarakauppa,2019-03-18 04:20:14.457831312,2019-03-18,2019-03-18,2019-03-18,10.0,-7.42,-9932.38,0.0,162.0,           ,1.0,1.0,88.0
9840,Ruoka_paivittaistavarakauppa,2019-03-18 10:24:34.698795168,2019-03-18,2019-03-18,2019-03-18,10.0,-53.82,-9986.2,0.0,192.0,           ,0.0,1.0,190.0
9841,Luokittelemattomat,2019-03-18 22:15:54.216867456,2019-03-18,2019-03-18,2019-03-18,10.0,-21.87,-10008.07,0.0,106.0,OKOYFIHH   ,1.0,0.0,38.0
9842,Hyvinvointijakauneus,2019-03-19 16:11:33.975903600,2019-03-19,2019-03-19,2019-03-19,10.0,-18.84,-10026.91,0.0,162.0,           ,1.0,1.0,176.0
9843,Ruoka_paivittaistavarakauppa,2019-03-20 04:02:53.493975888,2019-03-20,2019-03-20,2019-03-20,10.0,-9.29,-10036.2,0.0,162.0,           ,1.0,1.0,141.0
9844,Hyvinvointijakauneus,2019-03-21 10:07:13.734939744,2019-03-21,2019-03-21,2019-03-21,10.0,-3.75,-10039.95,0.0,162.0,           ,1.0,1.0,81.0
9845,Liikkuminen,2019-03-22 15:54:13.012048176,2019-03-22,2019-03-22,2019-03-22,10.0,-13.27,-10053.22,0.0,162.0,           ,1.0,1.0,122.0
9846,Ruoka_paivittaistavarakauppa,2019-03-22 21:58:33.253012032,2019-03-22,2019-03-22,2019-03-22,10.0,-27.26,-10080.48,0.0,162.0,           ,1.0,1.0,46.0
9847,Ruoka_paivittaistavarakauppa,2019-03-25 09:49:52.771084320,2019-03-25,2019-03-25,2019-03-25,10.0,-0.61,-10081.09,0.0,162.0,           ,1.0,1.0,96.0
9848,Ruoka_paivittaistavarakauppa,2019-03-25 15:36:52.048192752,2019-03-25,2019-03-25,2019-03-25,10.0,-16.69,-10097.78,0.0,162.0,           ,1.0,1.0,120.0
9849,Ruoka_paivittaistavarakauppa,2019-03-25 21:41:12.289156608,2019-03-25,2019-03-25,2019-03-25,10.0,-0.74,-10098.52,0.0,162.0,           ,1.0,1.0,54.0
9850,Asuminen,2019-03-26 03:28:11.566265040,2019-03-26,2019-03-26,2019-03-25,10.0,-101.56,-10200.08,0.0,106.0,OKOYFIHH   ,0.0,0.0,37.0
9851,Luottojen_maksut,2019-03-26 03:45:32.530120464,2019-03-26,2019-03-26,2019-03-26,10.0,-1039.97,-11240.05,0.0,129.0,OKOYFIHH   ,0.0,0.0,45.0
9852,Tulot,2019-03-26 09:32:31.807228896,2019-03-26,2019-03-26,2019-03-26,10.0,-8.99,-11249.04,0.0,162.0,           ,1.0,1.0,108.0
9853,Ruoka_paivittaistavarakauppa,2019-03-27 21:23:51.325301184,2019-03-27,2019-03-27,2019-03-27,10.0,-29.64,-11278.68,0.0,162.0,           ,1.0,1.0,109.0
9854,Muut,2019-03-28 03:10:50.602409616,2019-03-28,2019-03-28,2019-03-28,10.0,-3.09,-11281.77,0.0,162.0,           ,1.0,1.0,67.0
9855,Asuminen,2019-03-28 09:15:10.843373472,2019-03-28,2019-03-28,2019-03-28,10.0,-6.96,-11288.73,0.0,162.0,           ,1.0,1.0,132.0
9856,Ruoka_paivittaistavarakauppa,2019-03-28 15:02:10.120481904,2019-03-28,2019-03-28,2019-03-28,10.0,-4.16,-11292.89,0.0,162.0,           ,1.0,1.0,108.0
9857,Ruoka_paivittaistavarakauppa,2019-03-29 15:19:31.084337328,2019-03-29,2019-03-29,2019-03-29,10.0,-2.37,-11295.26,0.0,162.0,           ,1.0,1.0,145.0
9858,Ravintolat_kahvilat,2019-03-29 21:06:30.361445760,2019-03-29,2019-03-29,2019-03-29,10.0,-13.79,-11309.05,0.0,162.0,           ,1.0,1.0,62.0
9859,Tulot,2019-04-01 21:29:33.134328358,2019-04-01,2019-04-01,2019-04-01,10.0,255.34,-11053.71,701.0,520.0,           ,1.0,1.0,202.0
9860,Ruoka_paivittaistavarakauppa,2019-04-02 18:59:06.268656716,2019-04-02,2019-04-02,2019-04-02,10.0,-3.18,-11056.89,0.0,162.0,           ,1.0,1.0,138.0
9861,Lapset,2019-04-03 16:28:39.402985074,2019-04-03,2019-04-03,2019-04-03,10.0,-26.89,-11083.78,0.0,162.0,           ,1.0,1.0,95.0
9862,Luokittelemattomat,2019-04-04 13:58:12.537313432,2019-04-04,2019-04-04,2019-04-04,10.0,-2.45,-11086.23,0.0,162.0,           ,1.0,1.0,124.0
9863,Hyvinvointi,2019-04-05 11:27:45.671641790,2019-04-05,2019-04-05,2019-04-05,10.0,-106.33,-11192.56,0.0,106.0,OKOYFIHH   ,0.0,0.0,12.0
9864,Lapset,2019-04-08 01:25:58.208955222,2019-04-08,2019-04-08,2019-04-08,10.0,-7.3,-11199.86,0.0,106.0,OKOYFIHH   ,0.0,0.0,20.0
9865,Liikkuminen,2019-04-08 03:56:25.074626864,2019-04-08,2019-04-08,2019-04-08,10.0,-45.51,-11245.37,0.0,106.0,DABAFIHH   ,0.0,0.0,24.0
9866,Ruoka_paivittaistavarakauppa,2019-04-08 06:26:51.940298506,2019-04-08,2019-04-08,2019-04-08,10.0,-38.89,-11284.26,0.0,162.0,           ,1.0,1.0,67.0
9867,Ruoka_paivittaistavarakauppa,2019-04-08 08:57:18.805970148,2019-04-08,2019-04-08,2019-04-08,10.0,-2.37,-11286.63,0.0,162.0,           ,1.0,1.0,142.0
9868,Ruoka_paivittaistavarakauppa,2019-04-09 20:25:04.477611938,2019-04-09,2019-04-09,2019-04-09,10.0,-7.88,-11294.51,0.0,162.0,           ,1.0,1.0,96.0
9869,Ravintolat_kahvilat,2019-04-09 22:55:31.343283580,2019-04-09,2019-04-09,2019-04-09,10.0,-1.53,-11296.04,0.0,162.0,           ,1.0,1.0,156.0
9870,Ruoka_paivittaistavarakauppa,2019-04-11 17:54:37.611940296,2019-04-11,2019-04-11,2019-04-11,10.0,-38.7,-11334.74,0.0,162.0,           ,1.0,1.0,112.0
9871,Liikkuminen,2019-04-12 15:24:10.746268654,2019-04-12,2019-04-12,2019-04-12,10.0,-9.35,-11344.09,0.0,162.0,           ,1.0,1.0,114.0
9872,Ruoka_paivittaistavarakauppa,2019-04-15 07:52:50.149253728,2019-04-15,2019-04-15,2019-04-15,10.0,-6.42,-11350.51,0.0,162.0,           ,1.0,1.0,139.0
9873,Muut,2019-04-15 10:23:17.014925370,2019-04-15,2019-04-15,2019-04-15,10.0,-0.22,-11350.73,0.0,103.0,           ,0.0,1.0,2.0
9874,Ruoka_paivittaistavarakauppa,2019-04-16 05:22:23.283582086,2019-04-16,2019-04-16,2019-04-16,10.0,-9.57,-11360.3,0.0,162.0,           ,1.0,1.0,106.0
9875,Ravintolat_kahvilat,2019-04-16 12:53:43.880597012,2019-04-16,2019-04-16,2019-04-16,10.0,-246.68,-11606.98,0.0,103.0,           ,0.0,1.0,3.0
9876,Ruoka_paivittaistavarakauppa,2019-04-18 00:21:29.552238802,2019-04-18,2019-04-18,2019-04-18,10.0,-6.35,-11613.33,0.0,162.0,           ,1.0,1.0,157.0
9877,Muut,2019-04-18 02:51:56.417910444,2019-04-18,2019-04-18,2019-04-18,10.0,-9.17,-11622.5,0.0,162.0,           ,1.0,1.0,157.0
9878,Hyvinvointi,2019-04-18 16:50:08.955223876,2019-04-18,2019-04-18,2019-04-18,10.0,-1.68,-11624.18,0.0,162.0,           ,1.0,1.0,138.0
9879,Ruoka_paivittaistavarakauppa,2019-04-18 21:51:02.686567160,2019-04-18,2019-04-18,2019-04-18,10.0,-22.31,-11646.49,0.0,162.0,           ,1.0,1.0,109.0
9880,Ruoka_paivittaistavarakauppa,2019-04-19 19:20:35.820895518,2019-04-19,2019-04-19,2019-04-19,10.0,-1.0,-11647.49,0.0,162.0,           ,1.0,1.0,128.0
9881,Lapset,2019-04-22 11:49:15.223880592,2019-04-22,2019-04-22,2019-04-22,10.0,-4.21,-11651.7,0.0,162.0,           ,1.0,1.0,156.0
9882,Ruoka_paivittaistavarakauppa,2019-04-22 14:19:42.089552234,2019-04-22,2019-04-22,2019-04-22,10.0,-8.98,-11660.68,0.0,162.0,           ,1.0,1.0,67.0
9883,Luokittelemattomat,2019-04-23 09:18:48.358208950,2019-04-23,2019-04-23,2019-04-23,10.0,-4.82,-11665.5,0.0,162.0,           ,1.0,1.0,146.0
9884,Ruoka_paivittaistavarakauppa,2019-04-24 06:48:21.492537308,2019-04-24,2019-04-24,2019-04-24,10.0,-16.04,-11681.54,0.0,162.0,           ,1.0,1.0,112.0
9885,Ruoka_paivittaistavarakauppa,2019-04-26 01:47:27.761194024,2019-04-26,2019-04-26,2019-04-26,10.0,-59.91,-11741.45,0.0,162.0,           ,1.0,1.0,177.0
9886,Hyvinvointijakauneus,2019-04-26 04:17:54.626865666,2019-04-26,2019-04-26,2019-04-23,10.0,-3.5,-11744.95,0.0,162.0,           ,1.0,1.0,164.0
9887,Asuminen,2019-04-26 23:17:00.895522382,2019-04-26,2019-04-26,2019-04-26,10.0,-11.7,-11756.65,0.0,106.0,OKOYFIHH   ,0.0,0.0,23.0
9888,Lemmikit,2019-04-29 13:15:13.432835814,2019-04-29,2019-04-29,2019-04-29,10.0,-10.5,-11767.15,0.0,162.0,           ,1.0,1.0,46.0
9889,Ruoka_paivittaistavarakauppa,2019-04-29 15:45:40.298507456,2019-04-29,2019-04-29,2019-04-29,10.0,-18.5,-11785.65,0.0,162.0,           ,1.0,1.0,117.0
9890,Ravintolat_kahvilat,2019-04-29 18:16:07.164179098,2019-04-29,2019-04-29,2019-04-29,10.0,-3.49,-11789.14,0.0,162.0,           ,1.0,1.0,117.0
9891,Ruoka_paivittaistavarakauppa,2019-04-29 20:46:34.029850740,2019-04-29,2019-04-29,2019-04-29,10.0,-3.08,-11792.22,0.0,162.0,           ,1.0,1.0,64.0
9892,Tulot,2019-05-01 05:06:48.247422680,2019-05-01,2019-05-01,2019-05-01,10.0,799.04,-10993.18,701.0,520.0,           ,1.0,1.0,202.0
9893,Ruoka_paivittaistavarakauppa,2019-05-01 10:13:36.494845360,2019-05-01,2019-05-01,2019-04-30,10.0,-5.94,-10999.12,0.0,162.0,           ,1.0,1.0,126.0
9894,Hyvinvointi,2019-05-02 01:34:01.237113400,2019-05-02,2019-05-02,2019-05-02,10.0,-8.4,-11007.52,0.0,162.0,           ,1.0,1.0,96.0
9895,Matkailu,2019-05-02 06:40:49.484536080,2019-05-02,2019-05-02,2019-05-02,10.0,-3.32,-11010.84,0.0,106.0,NDEAFIHH   ,0.0,0.0,7.0
9896,Ruoka_paivittaistavarakauppa,2019-05-02 11:47:37.731958760,2019-05-02,2019-05-02,2019-05-02,10.0,-56.54,-11067.38,0.0,162.0,           ,1.0,1.0,76.0
9897,Ruoka_paivittaistavarakauppa,2019-05-02 15:20:24.742268040,2019-05-02,2019-05-02,2019-05-02,10.0,-21.27,-11088.65,0.0,162.0,           ,1.0,1.0,128.0
9898,Ruoka_paivittaistavarakauppa,2019-05-02 16:54:25.979381440,2019-05-02,2019-05-02,2019-05-02,10.0,-5.45,-11094.1,0.0,162.0,           ,1.0,1.0,95.0
9899,Liikkuminen,2019-05-02 20:27:12.989690720,2019-05-02,2019-05-02,2019-05-02,10.0,-8.12,-11102.22,0.0,162.0,           ,1.0,1.0,100.0
9900,Luokittelemattomat,2019-05-02 22:01:14.226804120,2019-05-02,2019-05-02,2019-05-02,10.0,-0.83,-11103.05,0.0,162.0,           ,1.0,1.0,60.0
9901,Liikkuminen,2019-05-03 03:08:02.474226800,2019-05-03,2019-05-03,2019-05-03,10.0,-47.35,-11150.4,0.0,162.0,           ,1.0,1.0,51.0
9902,Lemmikit,2019-05-03 04:42:03.711340200,2019-05-03,2019-05-03,2019-05-03,10.0,-61.33,-11211.73,0.0,106.0,OKOYFIHH   ,0.0,0.0,19.0
9903,Muut,2019-05-03 08:14:50.721649480,2019-05-03,2019-05-03,2019-05-03,10.0,-15.8,-11227.53,0.0,163.0,           ,1.0,1.0,186.0
9904,Hyvinvointi,2019-05-03 09:48:51.958762880,2019-05-03,2019-05-03,2019-05-03,10.0,-41.2,-11268.73,0.0,106.0,DABAFIHH   ,0.0,0.0,42.0
9905,Ravintolat_kahvilat,2019-05-03 13:21:38.969072160,2019-05-03,2019-05-03,2019-05-03,10.0,-8.57,-11277.3,0.0,162.0,           ,1.0,1.0,135.0
9906,Liikkuminen,2019-05-03 18:28:27.216494840,2019-05-03,2019-05-03,2019-05-03,10.0,-9.59,-11286.89,0.0,162.0,           ,1.0,1.0,131.0
9907,Luokittelemattomat,2019-05-03 20:02:28.453608240,2019-05-03,2019-05-03,2019-05-03,10.0,-49.19,-11336.08,0.0,106.0,OKOYFIHH   ,1.0,0.0,41.0
9908,Luottojen_maksut,2019-05-03 23:35:15.463917520,2019-05-03,2019-05-03,2019-05-03,10.0,-32.18,-11368.26,0.0,106.0,NDEAFIHH   ,0.0,0.0,27.0
9909,Liikkuminen,2019-05-04 01:09:16.701030920,2019-05-04,2019-05-04,2019-05-04,10.0,-9.24,-11377.5,0.0,106.0,OKOYFIHH   ,1.0,0.0,15.0
9910,Asuminen,2019-05-05 06:16:04.948453600,2019-05-05,2019-05-05,2019-05-05,10.0,-321.91,-11699.41,0.0,106.0,OKOYFIHH   ,0.0,0.0,17.0
9911,Muut,2019-05-06 02:43:17.938144320,2019-05-06,2019-05-07,2019-05-06,10.0,-6.27,-11705.68,0.0,163.0,           ,1.0,1.0,184.0
9912,Tulot,2019-05-06 07:50:06.185567000,2019-05-06,2019-05-06,2019-05-06,10.0,362.01,-11343.67,701.0,520.0,           ,1.0,1.0,202.0
9913,Liikkuminen,2019-05-06 11:22:53.195876280,2019-05-06,2019-05-06,2019-05-06,10.0,-13.73,-11357.4,0.0,106.0,OKOYFIHH   ,0.0,0.0,21.0
9914,Luokittelemattomat,2019-05-06 12:56:54.432989680,2019-05-06,2019-05-06,2019-05-06,10.0,-68.23,-11425.63,0.0,106.0,DABAFIHH   ,0.0,0.0,37.0
9915,Luottojen_maksut,2019-05-06 14:55:40.206185560,2019-05-06,2019-05-06,2019-05-06,10.0,-179.79,-11605.42,0.0,106.0,OKOYFIHH   ,1.0,0.0,13.0
9916,Harrastukset,2019-05-06 16:29:41.443298960,2019-05-06,2019-05-06,2019-05-06,10.0,-24.07,-11629.49,0.0,106.0,OKOYFIHH   ,0.0,0.0,6.0
9917,Liikkuminen,2019-05-06 18:03:42.680412360,2019-05-02,2019-05-06,2019-05-06,10.0,-29.08,-11658.57,0.0,106.0,OKOYFIHH   ,1.0,0.0,32.0
9918,Asuminen,2019-05-06 21:11:45.154639160,2019-05-06,2019-05-06,2019-05-06,10.0,-2.68,-11661.25,0.0,162.0,           ,1.0,1.0,156.0
9919,Luottojen_maksut,2019-05-06 21:36:29.690721640,2019-05-06,2019-05-06,2019-05-06,10.0,-11.05,-11672.3,0.0,106.0,NDEAFIHH   ,0.0,0.0,6.0
9920,Luokittelemattomat,2019-05-06 23:10:30.927835040,2019-05-06,2019-05-06,2019-05-06,10.0,-84.41,-11756.71,0.0,106.0,OKOYFIHH   ,1.0,0.0,23.0
9921,Ruoka_paivittaistavarakauppa,2019-05-07 00:44:32.164948440,2019-05-07,2019-05-07,2019-05-07,10.0,-43.18,-11799.89,0.0,162.0,           ,1.0,1.0,140.0
9922,Lapset,2019-05-07 04:17:19.175257720,2019-05-07,2019-05-07,2019-05-07,10.0,-30.66,-11830.55,0.0,106.0,NDEAFIHH   ,0.0,0.0,10.0
9923,Ruoka_paivittaistavarakauppa,2019-05-07 05:51:20.412371120,2019-05-07,2019-05-07,2019-05-07,10.0,-2.11,-11832.66,0.0,162.0,           ,1.0,1.0,92.0
9924,Luokittelemattomat,2019-05-07 09:24:07.422680400,2019-05-07,2019-05-07,2019-05-07,10.0,-37.71,-11870.37,0.0,106.0,OKOYFIHH   ,1.0,0.0,7.0
9925,Ruoka_paivittaistavarakauppa,2019-05-07 10:58:08.659793800,2019-05-07,2019-05-07,2019-05-07,10.0,-7.68,-11878.05,0.0,162.0,           ,1.0,1.0,149.0
9926,Lemmikit,2019-05-07 14:30:55.670103080,2019-05-07,2019-05-07,2019-05-07,10.0,-9.49,-11887.54,0.0,106.0,OKOYFIHH   ,0.0,0.0,11.0
9927,Kulttuuri_viihde,2019-05-07 16:04:56.907216480,2019-05-07,2019-05-07,2019-05-07,10.0,-12.65,-11900.19,0.0,162.0,           ,1.0,1.0,172.0
9928,Lemmikit,2019-05-07 19:37:43.917525760,2019-05-07,2019-05-07,2019-05-07,10.0,-20.97,-11921.16,0.0,162.0,           ,1.0,1.0,97.0
9929,Asuminen,2019-05-09 02:18:33.402061840,2019-05-09,2019-05-09,2019-05-09,10.0,-3.01,-11924.17,0.0,162.0,           ,1.0,1.0,81.0
9930,Liikkuminen,2019-05-09 03:52:34.639175240,2019-05-09,2019-05-10,2019-05-09,10.0,-1.55,-11925.72,0.0,162.0,           ,1.0,1.0,116.0
9931,Ruoka_paivittaistavarakauppa,2019-05-09 07:25:21.649484520,2019-05-09,2019-05-09,2019-05-09,10.0,-18.59,-11944.31,0.0,162.0,           ,1.0,1.0,167.0
9932,Ravintolat_kahvilat,2019-05-09 08:59:22.886597920,2019-05-09,2019-05-09,2019-05-09,10.0,-3.82,-11948.13,0.0,162.0,           ,1.0,1.0,133.0
9933,Liikkuminen,2019-05-09 10:33:24.123711320,2019-05-09,2019-05-09,2019-05-09,10.0,-6.13,-11954.26,0.0,162.0,           ,1.0,1.0,134.0
9934,Ruoka_paivittaistavarakauppa,2019-05-09 12:32:09.896907200,2019-05-09,2019-05-09,2019-05-09,10.0,-4.73,-11958.99,0.0,162.0,           ,1.0,1.0,181.0
9935,Ruoka_paivittaistavarakauppa,2019-05-09 17:38:58.144329880,2019-05-09,2019-05-09,2019-05-09,10.0,-10.09,-11969.08,0.0,162.0,           ,1.0,1.0,61.0
9936,Ruoka_paivittaistavarakauppa,2019-05-09 22:45:46.391752560,2019-05-09,2019-05-09,2019-05-09,10.0,-3.53,-11972.61,0.0,162.0,           ,1.0,1.0,95.0
9937,Ruoka_paivittaistavarakauppa,2019-05-10 00:19:47.628865960,2019-05-10,2019-05-10,2019-05-10,10.0,-1.71,-11974.32,0.0,162.0,           ,1.0,1.0,69.0
9938,Lemmikit,2019-05-10 14:06:11.134020600,2019-05-10,2019-05-10,2019-05-10,10.0,-5.15,-11979.47,0.0,162.0,           ,1.0,1.0,102.0
9939,Hyvinvointi,2019-05-10 15:40:12.371134000,2019-05-10,2019-05-10,2019-05-10,10.0,-2.31,-11981.78,0.0,162.0,           ,1.0,1.0,50.0
9940,Muut,2019-05-10 18:48:14.845360800,2019-05-10,2019-05-10,2019-05-10,10.0,-8.34,-11990.12,0.0,163.0,           ,1.0,1.0,187.0
9941,Hyvinvointi,2019-05-11 19:12:59.381443280,2019-05-11,2019-05-11,2019-05-11,10.0,-3564.83,-15554.95,0.0,106.0,NDEAFIHH   ,0.0,0.0,16.0
9942,Ravintolat_kahvilat,2019-05-13 01:53:48.865979360,2019-05-13,2019-05-13,2019-05-13,10.0,-2.94,-15557.89,0.0,162.0,           ,1.0,1.0,84.0
9943,Ruoka_paivittaistavarakauppa,2019-05-13 03:27:50.103092760,2019-05-13,2019-05-13,2019-05-13,10.0,-2.53,-15560.42,0.0,162.0,           ,1.0,1.0,74.0
9944,Ruoka_paivittaistavarakauppa,2019-05-13 05:01:51.340206160,2019-05-13,2019-05-13,2019-05-13,10.0,-2.57,-15562.99,0.0,162.0,           ,1.0,1.0,96.0
9945,Luokittelemattomat,2019-05-13 05:26:35.876288640,2019-05-13,2019-05-13,2019-05-13,10.0,-2.26,-15565.25,0.0,162.0,           ,1.0,1.0,72.0
9946,Liikkuminen,2019-05-13 08:34:38.350515440,2019-05-13,2019-05-13,2019-05-13,10.0,-54.96,-15620.21,0.0,162.0,           ,1.0,1.0,108.0
9947,Ruoka_paivittaistavarakauppa,2019-05-13 12:07:25.360824720,2019-05-13,2019-05-13,2019-05-13,10.0,-2.12,-15622.33,0.0,162.0,           ,1.0,1.0,160.0
9948,Lemmikit,2019-05-13 13:41:26.597938120,2019-05-13,2019-05-13,2019-05-13,10.0,-6.54,-15628.87,0.0,162.0,           ,1.0,1.0,100.0
9949,Luokittelemattomat,2019-05-13 16:49:29.072164920,2019-05-13,2019-05-13,2019-05-13,10.0,-2.81,-15631.68,0.0,162.0,           ,1.0,1.0,100.0
9950,Matkailu,2019-05-13 17:14:13.608247400,2019-05-13,2019-05-13,2019-05-13,10.0,-15.15,-15646.83,0.0,162.0,           ,1.0,1.0,108.0
9951,Ruoka_paivittaistavarakauppa,2019-05-13 20:47:00.618556680,2019-05-13,2019-05-13,2019-05-13,10.0,-2.88,-15649.71,0.0,162.0,           ,1.0,1.0,168.0
9952,Ruoka_paivittaistavarakauppa,2019-05-13 22:21:01.855670080,2019-05-13,2019-05-13,2019-05-13,10.0,-1.49,-15651.2,0.0,162.0,           ,1.0,1.0,48.0
9953,Liikkuminen,2019-05-13 23:55:03.092783480,2019-05-13,2019-05-13,2019-05-13,10.0,-4.74,-15655.94,0.0,162.0,           ,1.0,1.0,174.0
9954,Ruoka_paivittaistavarakauppa,2019-05-14 07:00:37.113402040,2019-05-14,2019-05-14,2019-05-13,10.0,-5.97,-15661.91,0.0,162.0,           ,1.0,1.0,77.0
9955,Luottojen_maksut,2019-05-14 10:08:39.587628840,2019-05-14,2019-05-14,2019-05-14,10.0,-31.8,-15693.71,0.0,106.0,DABAFIHH   ,1.0,0.0,11.0
9956,Luokittelemattomat,2019-05-14 15:15:27.835051520,2019-05-14,2019-05-17,2019-05-14,10.0,-84.14,-15777.85,0.0,106.0,OKOYFIHH   ,0.0,0.0,26.0
9957,Lapset,2019-05-14 20:22:16.082474200,2019-05-14,2019-05-14,2019-05-14,10.0,-351.7,-16129.55,0.0,106.0,OKOYFIHH   ,0.0,0.0,15.0
9958,Luokittelemattomat,2019-05-14 21:56:17.319587600,2019-05-14,2019-05-14,2019-05-14,10.0,-10.83,-16140.38,0.0,162.0,           ,1.0,1.0,167.0
9959,Lapset,2019-05-15 01:29:04.329896880,2019-05-15,2019-05-15,2019-05-15,10.0,-158.24,-16298.62,0.0,106.0,OKOYFIHH   ,0.0,0.0,6.0
9960,Liikkuminen,2019-05-15 03:03:05.567010280,2019-05-15,2019-05-15,2019-05-15,10.0,-10.52,-16309.14,0.0,162.0,           ,1.0,1.0,91.0
9961,Ruoka_paivittaistavarakauppa,2019-05-15 06:35:52.577319560,2019-05-15,2019-05-15,2019-05-15,10.0,-12.41,-16321.55,0.0,162.0,           ,1.0,1.0,140.0
9962,Liikkuminen,2019-05-15 11:42:40.824742240,2019-05-15,2019-05-15,2019-05-15,10.0,-10.82,-16332.37,0.0,162.0,           ,1.0,1.0,176.0
9963,Lapset,2019-05-16 04:37:06.804123680,2019-05-16,2019-05-16,2019-05-16,10.0,-4.43,-16336.8,0.0,162.0,           ,1.0,1.0,156.0
9964,Ruoka_paivittaistavarakauppa,2019-05-16 18:23:30.309278320,2019-05-16,2019-05-16,2019-05-16,10.0,-9.84,-16346.64,0.0,162.0,           ,1.0,1.0,100.0
9965,Liikkuminen,2019-05-16 23:30:18.556701000,2019-05-16,2019-05-16,2019-05-16,10.0,-26.42,-16373.06,0.0,162.0,           ,1.0,1.0,48.0
9966,Ruoka_paivittaistavarakauppa,2019-05-17 08:09:53.814432960,2019-05-17,2019-05-17,2019-05-17,10.0,-2.78,-16375.84,0.0,162.0,           ,1.0,1.0,67.0
9967,Kulttuuri_viihde,2019-05-17 09:43:55.051546360,2019-05-17,2019-05-17,2019-05-17,10.0,-0.56,-16376.4,0.0,162.0,           ,1.0,1.0,123.0
9968,Muut,2019-05-17 11:17:56.288659760,2019-05-17,2019-05-17,2019-05-17,10.0,-31.51,-16407.91,0.0,163.0,           ,1.0,1.0,184.0
9969,Liikkuminen,2019-05-17 12:51:57.525773160,2019-05-17,2019-05-17,2019-05-17,10.0,-101.82,-16509.73,0.0,162.0,           ,1.0,1.0,157.0
9970,Liikkuminen,2019-05-17 13:16:42.061855640,2019-05-17,2019-05-17,2019-05-17,10.0,-9.85,-16519.58,0.0,162.0,           ,1.0,1.0,73.0
9971,Ruoka_paivittaistavarakauppa,2019-05-17 14:50:43.298969040,2019-05-17,2019-05-17,2019-05-17,10.0,-5.3,-16524.88,0.0,162.0,           ,1.0,1.0,133.0
9972,Ruoka_paivittaistavarakauppa,2019-05-17 16:24:44.536082440,2019-05-17,2019-05-17,2019-05-17,10.0,-4.34,-16529.22,0.0,162.0,           ,1.0,1.0,119.0
9973,Kulttuuri_viihde,2019-05-17 19:57:31.546391720,2019-05-17,2019-05-17,2019-05-17,10.0,-8.15,-16537.37,0.0,106.0,OKOYFIHH   ,0.0,0.0,22.0
9974,Luottojen_maksut,2019-05-18 17:58:45.773195840,2019-05-18,2019-05-18,2019-05-18,10.0,-86.53,-16623.9,0.0,106.0,OKOYFIHH   ,1.0,0.0,18.0
9975,Ravintolat_kahvilat,2019-05-20 01:04:19.793814400,2019-05-20,2019-05-20,2019-05-20,10.0,-5.54,-16629.44,0.0,162.0,           ,1.0,1.0,48.0
9976,Ruoka_paivittaistavarakauppa,2019-05-20 02:13:36.494845320,2019-05-16,2019-05-20,2019-05-20,10.0,-1.88,-16631.32,0.0,162.0,           ,1.0,1.0,170.0
9977,Ravintolat_kahvilat,2019-05-20 04:12:22.268041200,2019-05-20,2019-05-20,2019-05-20,10.0,-20.29,-16651.61,0.0,162.0,           ,1.0,1.0,145.0
9978,Ruoka_paivittaistavarakauppa,2019-05-20 06:11:08.041237080,2019-05-20,2019-05-20,2019-05-20,10.0,-3.57,-16655.18,0.0,162.0,           ,1.0,1.0,134.0
9979,Ruoka_paivittaistavarakauppa,2019-05-20 07:45:09.278350480,2019-05-20,2019-05-20,2019-05-20,10.0,-4.64,-16659.82,0.0,162.0,           ,1.0,1.0,176.0
9980,Muut,2019-05-20 09:19:10.515463880,2019-05-20,2019-05-20,2019-05-20,10.0,-35.82,-16695.64,0.0,162.0,           ,1.0,1.0,134.0
9981,Ruoka_paivittaistavarakauppa,2019-05-20 10:53:11.752577280,2019-05-20,2019-05-20,2019-05-20,10.0,-6.02,-16701.66,0.0,162.0,           ,1.0,1.0,47.0
9982,Terveys,2019-05-20 14:25:58.762886560,2019-05-20,2019-05-20,2019-05-20,10.0,-3.33,-16704.99,0.0,162.0,           ,1.0,1.0,139.0
9983,Ruoka_paivittaistavarakauppa,2019-05-20 15:59:59.999999960,2019-05-20,2019-05-20,2019-05-20,10.0,-4.92,-16709.91,0.0,162.0,           ,1.0,1.0,128.0
9984,Ravintolat_kahvilat,2019-05-20 19:32:47.010309240,2019-05-20,2019-05-20,2019-05-20,10.0,-7.1,-16717.01,0.0,162.0,           ,1.0,1.0,120.0
9985,Ruoka_paivittaistavarakauppa,2019-05-20 21:06:48.247422640,2019-05-20,2019-05-20,2019-05-20,10.0,-7.19,-16724.2,0.0,162.0,           ,1.0,1.0,47.0
9986,Ruoka_paivittaistavarakauppa,2019-05-20 21:31:32.783505120,2019-05-20,2019-05-20,2019-05-20,10.0,-9.65,-16733.85,0.0,162.0,           ,1.0,1.0,89.0
9987,Muut,2019-05-20 23:05:34.020618520,2019-05-20,2019-05-20,2019-05-20,10.0,-8.83,-16742.68,0.0,162.0,           ,1.0,1.0,145.0
9988,Asuminen,2019-05-21 02:38:21.030927800,2019-05-21,2019-05-21,2019-05-21,10.0,-3.0,-16745.68,0.0,162.0,           ,1.0,1.0,117.0
9989,Ravintolat_kahvilat,2019-05-21 05:46:23.505154600,2019-05-21,2019-05-21,2019-05-21,10.0,-6.28,-16751.96,0.0,162.0,           ,1.0,1.0,119.0
9990,Ruoka_paivittaistavarakauppa,2019-05-21 14:01:14.226804080,2019-05-21,2019-05-21,2019-05-21,10.0,-2.53,-16754.49,0.0,162.0,           ,1.0,1.0,151.0
9991,Ruoka_paivittaistavarakauppa,2019-05-21 22:40:49.484536040,2019-05-21,2019-05-21,2019-05-21,10.0,-2.12,-16756.61,0.0,162.0,           ,1.0,1.0,99.0
9992,Ruoka_paivittaistavarakauppa,2019-05-22 00:39:35.257731920,2019-05-22,2019-05-22,2019-05-21,10.0,-2.39,-16759.0,0.0,162.0,           ,1.0,1.0,100.0
9993,Ruoka_paivittaistavarakauppa,2019-05-22 08:54:25.979381400,2019-05-22,2019-05-22,2019-05-22,10.0,-6.48,-16765.48,0.0,162.0,           ,1.0,1.0,123.0
9994,Ruoka_paivittaistavarakauppa,2019-05-22 12:27:12.989690680,2019-05-22,2019-05-22,2019-05-22,10.0,-6.52,-16772.0,0.0,162.0,           ,1.0,1.0,63.0
9995,Matkailu,2019-05-22 17:34:01.237113360,2019-05-22,2019-05-22,2019-05-22,10.0,-46.93,-16818.93,0.0,162.0,           ,1.0,1.0,75.0
9996,Ravintolat_kahvilat,2019-05-23 03:47:37.731958720,2019-05-23,2019-05-23,2019-05-23,10.0,-9.1,-16828.03,0.0,162.0,           ,1.0,1.0,181.0
9997,Ruoka_paivittaistavarakauppa,2019-05-23 07:20:24.742268000,2019-05-23,2019-05-23,2019-05-23,10.0,-18.03,-16846.06,0.0,162.0,           ,1.0,1.0,85.0
9998,Luottojen_maksut,2019-05-23 12:02:28.453608200,2019-05-23,2019-05-23,2019-05-23,10.0,-17.76,-16863.82,0.0,162.0,           ,1.0,1.0,166.0
9999,Liikkuminen,2019-05-23 15:35:15.463917480,2019-05-23,2019-05-23,2019-05-23,10.0,-18.31,-16882.13,0.0,162.0,           ,1.0,1.0,46.0
10000,Liikkuminen,2019-05-23 22:16:04.948453560,2019-05-23,2019-05-23,2019-05-23,10.0,-18.19,-16900.32,0.0,162.0,           ,1.0,1.0,84.0
10001,Asuminen,2019-05-24 00:14:50.721649440,2019-05-24,2019-05-24,2019-05-24,10.0,-36.16,-16936.48,0.0,162.0,           ,1.0,1.0,111.0
10002,Ruoka_paivittaistavarakauppa,2019-05-24 01:48:51.958762840,2019-05-24,2019-05-24,2019-05-24,10.0,-4.42,-16940.9,0.0,162.0,           ,1.0,1.0,75.0
10003,Ravintolat_kahvilat,2019-05-24 05:21:38.969072120,2019-05-24,2019-05-24,2019-05-24,10.0,-67.83,-17008.73,0.0,162.0,           ,1.0,1.0,142.0
10004,Liikkuminen,2019-05-24 10:28:27.216494800,2019-05-24,2019-05-24,2019-05-24,10.0,-2.35,-17011.08,0.0,162.0,           ,1.0,1.0,97.0
10005,Ruoka_paivittaistavarakauppa,2019-05-24 17:09:16.701030880,2019-05-24,2019-05-24,2019-05-24,10.0,-12.08,-17023.16,0.0,162.0,           ,1.0,1.0,67.0
10006,Ravintolat_kahvilat,2019-05-24 19:08:02.474226760,2019-05-24,2019-05-24,2019-05-24,10.0,-0.16,-17023.32,0.0,162.0,           ,1.0,1.0,67.0
10007,Ruoka_paivittaistavarakauppa,2019-05-24 20:42:03.711340160,2019-05-24,2019-05-24,2019-05-24,10.0,-1.13,-17024.45,0.0,162.0,           ,1.0,1.0,127.0
10008,Liikkuminen,2019-05-27 04:56:54.432989640,2019-05-27,2019-05-29,2019-05-27,10.0,-3.13,-17027.58,0.0,162.0,           ,1.0,1.0,164.0
10009,Ruoka_paivittaistavarakauppa,2019-05-27 06:55:40.206185520,2019-05-27,2019-05-27,2019-05-27,10.0,-2.94,-17030.52,0.0,162.0,           ,1.0,1.0,165.0
10010,Lapset,2019-05-27 08:29:41.443298920,2019-05-27,2019-05-27,2019-05-27,10.0,-3.24,-17033.76,0.0,162.0,           ,1.0,1.0,155.0
10011,Ruoka_paivittaistavarakauppa,2019-05-27 10:03:42.680412320,2019-05-27,2019-05-27,2019-05-27,10.0,-8.71,-17042.47,0.0,162.0,           ,1.0,1.0,165.0
10012,Ruoka_paivittaistavarakauppa,2019-05-27 13:36:29.690721600,2019-05-27,2019-05-27,2019-05-27,10.0,-2.63,-17045.1,0.0,162.0,           ,1.0,1.0,107.0
10013,Ruoka_paivittaistavarakauppa,2019-05-27 15:10:30.927835000,2019-05-27,2019-05-27,2019-05-27,10.0,-10.52,-17055.62,0.0,162.0,           ,1.0,1.0,136.0
10014,Ruoka_paivittaistavarakauppa,2019-05-27 18:43:17.938144280,2019-05-27,2019-05-27,2019-05-27,10.0,-35.73,-17091.35,0.0,162.0,           ,1.0,1.0,112.0
10015,Hyvinvointijakauneus,2019-05-27 20:17:19.175257680,2019-05-27,2019-05-27,2019-05-27,10.0,-9.66,-17101.01,0.0,162.0,           ,1.0,1.0,125.0
10016,Ruoka_paivittaistavarakauppa,2019-05-27 23:25:21.649484480,2019-05-27,2019-05-29,2019-05-27,10.0,-5.24,-17106.25,0.0,162.0,           ,1.0,1.0,102.0
10017,Ruoka_paivittaistavarakauppa,2019-05-28 01:24:07.422680360,2019-05-28,2019-05-28,2019-05-28,10.0,-4.14,-17110.39,0.0,162.0,           ,1.0,1.0,62.0
10018,Liikkuminen,2019-05-28 02:58:08.659793760,2019-05-28,2019-05-28,2019-05-28,10.0,-3.27,-17113.66,0.0,162.0,           ,1.0,1.0,175.0
10019,Ravintolat_kahvilat,2019-05-28 03:22:53.195876240,2019-05-28,2019-05-28,2019-05-28,10.0,-3.68,-17117.34,0.0,162.0,           ,1.0,1.0,126.0
10020,Luokittelemattomat,2019-05-28 06:30:55.670103040,2019-05-24,2019-05-28,2019-05-28,10.0,-38.68,-17156.02,0.0,162.0,           ,1.0,1.0,112.0
10021,Muut,2019-05-28 16:44:32.164948400,2019-05-28,2019-05-28,2019-05-28,10.0,-53.8,-17209.82,0.0,105.0,OKOYFIHH   ,1.0,0.0,5.0
10022,Tulot,2019-05-28 21:51:20.412371080,2019-05-28,2019-05-28,2019-05-28,10.0,442.64,-16767.18,0.0,505.0,           ,1.0,1.0,195.0
10023,Luokittelemattomat,2019-05-28 23:50:06.185566960,2019-05-28,2019-05-28,2019-05-28,10.0,-5.98,-16773.16,0.0,162.0,           ,1.0,1.0,97.0
10024,Tulot,2019-05-29 04:32:09.896907160,2019-05-29,2019-05-29,2019-05-29,10.0,1256.7,-15516.46,0.0,505.0,           ,1.0,1.0,191.0
10025,Ruoka_paivittaistavarakauppa,2019-05-29 09:38:58.144329840,2019-05-29,2019-05-31,2019-05-29,10.0,-12.82,-15529.28,0.0,162.0,           ,1.0,1.0,114.0
10026,Ruoka_paivittaistavarakauppa,2019-05-29 11:12:59.381443240,2019-05-29,2019-05-29,2019-05-29,10.0,-20.17,-15549.45,0.0,162.0,           ,1.0,1.0,62.0
10027,Kulttuuri_viihde,2019-05-29 11:37:43.917525720,2019-05-29,2019-05-29,2019-05-29,10.0,-7.31,-15556.76,0.0,162.0,           ,1.0,1.0,110.0
10028,Ruoka_paivittaistavarakauppa,2019-05-29 13:11:45.154639120,2019-05-29,2019-05-29,2019-05-29,10.0,-3.94,-15560.7,0.0,162.0,           ,1.0,1.0,109.0
10029,Tulot,2019-05-29 14:45:46.391752520,2019-05-29,2019-05-29,2019-05-29,10.0,147.77,-15412.93,0.0,505.0,           ,1.0,1.0,191.0
10030,Matkailu,2019-05-30 00:59:22.886597880,2019-05-30,2019-05-30,2019-05-30,10.0,-20.34,-15433.27,0.0,100.0,           ,1.0,1.0,0.0
10031,Shoppailu,2019-05-30 08:04:56.907216440,2019-05-30,2019-05-30,2019-05-30,10.0,-12.1,-15445.37,0.0,162.0,           ,1.0,1.0,177.0
10032,Kulttuuri_viihde,2019-05-30 18:18:33.402061800,2019-05-30,2019-05-30,2019-05-30,10.0,-10.87,-15456.24,0.0,162.0,           ,1.0,1.0,66.0
10033,Ruoka_paivittaistavarakauppa,2019-05-30 19:52:34.639175200,2019-05-30,2019-05-30,2019-05-30,10.0,-55.68,-15511.92,0.0,162.0,           ,1.0,1.0,121.0
10034,Ruoka_paivittaistavarakauppa,2019-05-31 06:06:11.134020560,2019-05-31,2019-05-31,2019-05-31,10.0,-2.78,-15514.7,0.0,162.0,           ,1.0,1.0,93.0
10035,Ruoka_paivittaistavarakauppa,2019-05-31 16:19:47.628865920,2019-05-31,2019-05-31,2019-05-31,10.0,-22.14,-15536.84,0.0,162.0,           ,1.0,1.0,123.0
10036,Ruoka_paivittaistavarakauppa,2019-05-31 21:26:35.876288600,2019-05-31,2019-05-31,2019-05-31,10.0,-6.56,-15543.4,0.0,162.0,           ,1.0,1.0,150.0
10037,Saastot_sijoitukset,2019-06-03 00:24:24.406779661,2019-06-03,2019-06-03,2019-06-03,10.0,-3.96,-15547.36,0.0,162.0,           ,1.0,1.0,48.0
10038,Ruoka_paivittaistavarakauppa,2019-06-03 00:48:48.813559322,2019-06-03,2019-06-03,2019-06-03,10.0,-4.51,-15551.87,0.0,162.0,           ,1.0,1.0,133.0
10039,Ravintolat_kahvilat,2019-06-04 01:13:13.220338983,2019-06-04,2019-06-04,2019-06-04,10.0,-1.24,-15553.11,0.0,162.0,           ,1.0,1.0,95.0
10040,Tulot,2019-06-06 01:37:37.627118644,2019-06-06,2019-06-06,2019-06-06,10.0,1135.1,-14418.01,0.0,505.0,           ,1.0,1.0,194.0
10041,Saastot_sijoitukset,2019-06-07 02:02:02.033898305,2019-06-07,2019-06-07,2019-06-07,10.0,-13.59,-14431.6,0.0,162.0,           ,1.0,1.0,75.0
10042,Tulot,2019-06-07 02:26:26.440677966,2019-06-07,2019-06-07,2019-06-07,10.0,414.67,-14016.93,0.0,505.0,           ,1.0,1.0,191.0
10043,Tulot,2019-06-07 02:50:50.847457627,2019-06-07,2019-06-07,2019-06-07,10.0,60.26,-13956.67,0.0,505.0,           ,1.0,1.0,194.0
10044,Kulttuuri_viihde,2019-06-10 03:15:15.254237288,2019-06-10,2019-06-10,2019-06-10,10.0,-9.2,-13965.87,0.0,106.0,OKOYFIHH   ,0.0,0.0,39.0
10045,Lapset,2019-06-10 03:39:39.661016949,2019-06-10,2019-06-10,2019-06-10,10.0,-19.88,-13985.75,0.0,106.0,OKOYFIHH   ,0.0,0.0,18.0
10046,Liikkuminen,2019-06-11 04:04:04.067796610,2019-06-11,2019-06-11,2019-06-11,10.0,-3.0,-13988.75,0.0,162.0,           ,1.0,1.0,118.0
10047,Tulot,2019-06-13 04:28:28.474576271,2019-06-13,2019-06-13,2019-06-13,10.0,153.72,-13835.03,0.0,505.0,           ,1.0,1.0,193.0
10048,Ruoka_paivittaistavarakauppa,2019-06-13 05:41:41.694915254,2019-06-13,2019-06-13,2019-06-13,10.0,-3.01,-13838.04,0.0,162.0,           ,1.0,1.0,104.0
10049,Ravintolat_kahvilat,2019-06-14 04:52:52.881355932,2019-06-14,2019-06-14,2019-06-14,10.0,-0.6,-13838.64,0.0,162.0,           ,1.0,1.0,144.0
10050,Ruoka_paivittaistavarakauppa,2019-06-14 05:17:17.288135593,2019-06-14,2019-06-14,2019-06-14,10.0,-20.18,-13858.82,0.0,162.0,           ,1.0,1.0,130.0
10051,Ravintolat_kahvilat,2019-06-17 06:06:06.101694915,2019-06-17,2019-06-17,2019-06-17,10.0,-8.25,-13867.07,0.0,162.0,           ,1.0,1.0,118.0
10052,Ruoka_paivittaistavarakauppa,2019-06-17 06:30:30.508474576,2019-06-17,2019-06-17,2019-06-17,10.0,-3.64,-13870.71,0.0,162.0,           ,1.0,1.0,120.0
10053,Lemmikit,2019-06-18 06:54:54.915254237,2019-06-18,2019-06-18,2019-06-18,10.0,-80.78,-13951.49,0.0,162.0,           ,1.0,1.0,75.0
10054,Ruoka_paivittaistavarakauppa,2019-06-19 07:19:19.322033898,2019-06-19,2019-06-19,2019-06-19,10.0,-12.55,-13964.04,0.0,162.0,           ,1.0,1.0,165.0
10055,Kulttuuri_viihde,2019-06-19 08:08:08.135593220,2019-06-19,2019-06-19,2019-06-19,10.0,-43.57,-14007.61,0.0,162.0,           ,1.0,1.0,109.0
10056,Ruoka_paivittaistavarakauppa,2019-06-20 07:43:43.728813559,2019-06-20,2019-06-20,2019-06-20,10.0,-17.1,-14024.71,0.0,162.0,           ,1.0,1.0,146.0
10057,Luokittelemattomat,2019-06-21 08:32:32.542372881,2019-06-21,2019-06-21,2019-06-21,10.0,-4.28,-14028.99,0.0,162.0,           ,1.0,1.0,104.0
10058,Ruoka_paivittaistavarakauppa,2019-06-24 08:56:56.949152542,2019-06-24,2019-06-25,2019-06-24,10.0,-19.06,-14048.05,0.0,162.0,           ,1.0,1.0,123.0
10059,Liikkuminen,2019-06-24 09:21:21.355932203,2019-06-24,2019-06-24,2019-06-24,10.0,-1.76,-14049.81,0.0,162.0,           ,1.0,1.0,170.0
10060,Tulot,2019-06-25 09:45:45.762711864,2019-06-25,2019-06-25,2019-06-25,10.0,646.74,-13403.07,0.0,505.0,           ,1.0,1.0,192.0
10061,Ruoka_paivittaistavarakauppa,2019-06-27 10:10:10.169491525,2019-06-27,2019-06-27,2019-06-27,10.0,-2.28,-13405.35,0.0,162.0,           ,1.0,1.0,86.0
10062,Ruoka_paivittaistavarakauppa,2019-06-27 10:34:34.576271186,2019-06-27,2019-06-27,2019-06-27,10.0,-2.71,-13408.06,0.0,162.0,           ,1.0,1.0,134.0
10063,Liikkuminen,2019-06-27 10:58:58.983050847,2019-06-27,2019-06-27,2019-06-27,10.0,-6.15,-13414.21,0.0,162.0,           ,1.0,1.0,153.0
10064,Ruoka_paivittaistavarakauppa,2019-06-28 11:23:23.389830508,2019-06-28,2019-06-28,2019-06-28,10.0,-15.37,-13429.58,0.0,162.0,           ,1.0,1.0,164.0
10065,Ruoka_paivittaistavarakauppa,2019-06-28 11:47:47.796610169,2019-06-28,2019-06-28,2019-06-28,10.0,-1.69,-13431.27,0.0,162.0,           ,1.0,1.0,134.0
10066,Liikkuminen,2019-07-01 20:57:27.887323943,2019-07-01,2019-07-01,2019-07-01,10.0,-13.88,-13445.15,0.0,162.0,           ,1.0,1.0,156.0
10067,Ruoka_paivittaistavarakauppa,2019-07-02 17:54:55.774647886,2019-07-02,2019-07-02,2019-07-02,10.0,-15.82,-13460.97,0.0,162.0,           ,1.0,1.0,96.0
10068,Muut,2019-07-03 14:52:23.661971829,2019-07-03,2019-07-03,2019-07-03,10.0,-3.07,-13464.04,0.0,162.0,           ,1.0,1.0,182.0
10069,Luokittelemattomat,2019-07-04 05:44:47.323943658,2019-07-04,2019-07-04,2019-07-04,10.0,-4.15,-13468.19,0.0,162.0,           ,1.0,1.0,142.0
10070,Ravintolat_kahvilat,2019-07-04 11:49:51.549295772,2019-07-04,2019-07-04,2019-07-04,10.0,-6.2,-13474.39,0.0,162.0,           ,1.0,1.0,169.0
10071,Muut,2019-07-05 08:47:19.436619715,2019-07-05,2019-07-05,2019-07-05,10.0,-28.31,-13502.7,0.0,162.0,           ,1.0,1.0,162.0
10072,Ruoka_paivittaistavarakauppa,2019-07-08 02:42:15.211267601,2019-07-08,2019-07-08,2019-07-08,10.0,-10.64,-13513.34,0.0,162.0,           ,1.0,1.0,58.0
10073,Ravintolat_kahvilat,2019-07-08 20:37:10.985915487,2019-07-08,2019-07-08,2019-07-08,10.0,-10.31,-13523.65,0.0,162.0,           ,1.0,1.0,151.0
10074,Ruoka_paivittaistavarakauppa,2019-07-08 23:39:43.098591544,2019-07-08,2019-07-08,2019-07-08,10.0,-30.12,-13553.77,0.0,162.0,           ,1.0,1.0,96.0
10075,Liikkuminen,2019-07-09 14:32:06.760563373,2019-07-09,2019-07-09,2019-07-09,10.0,-95.97,-13649.74,0.0,162.0,           ,1.0,1.0,71.0
10076,Ruoka_paivittaistavarakauppa,2019-07-09 17:34:38.873239430,2019-07-09,2019-07-09,2019-07-09,10.0,-21.46,-13671.2,0.0,162.0,           ,1.0,1.0,128.0
10077,Ruoka_paivittaistavarakauppa,2019-07-11 11:29:34.647887316,2019-07-11,2019-07-11,2019-07-11,10.0,-3.77,-13674.97,0.0,162.0,           ,1.0,1.0,53.0
10078,Ravintolat_kahvilat,2019-07-12 05:24:30.422535202,2019-07-12,2019-07-12,2019-07-12,10.0,-15.43,-13690.4,0.0,162.0,           ,1.0,1.0,116.0
10079,Ruoka_paivittaistavarakauppa,2019-07-12 08:27:02.535211259,2019-07-12,2019-07-12,2019-07-12,10.0,-3.9,-13694.3,0.0,162.0,           ,1.0,1.0,118.0
10080,Luottojen_maksut,2019-07-15 02:21:58.309859145,2019-07-15,2019-07-15,2019-07-15,10.0,-11.33,-13705.63,0.0,162.0,           ,1.0,1.0,165.0
10081,Matkailu,2019-07-15 20:16:54.084507031,2019-07-15,2019-07-15,2019-07-15,10.0,-2.34,-13707.97,0.0,162.0,           ,1.0,1.0,129.0
10082,Ruoka_paivittaistavarakauppa,2019-07-15 23:19:26.197183088,2019-07-15,2019-07-15,2019-07-15,10.0,-9.27,-13717.24,0.0,162.0,           ,1.0,1.0,102.0
10083,Ruoka_paivittaistavarakauppa,2019-07-16 17:14:21.971830974,2019-07-16,2019-07-16,2019-07-16,10.0,-48.97,-13766.21,0.0,162.0,           ,1.0,1.0,94.0
10084,Ruoka_paivittaistavarakauppa,2019-07-17 14:11:49.859154917,2019-07-17,2019-07-17,2019-07-16,10.0,-40.06,-13806.27,0.0,162.0,           ,1.0,1.0,110.0
10085,Ruoka_paivittaistavarakauppa,2019-07-18 11:09:17.746478860,2019-07-18,2019-07-18,2019-07-18,10.0,-14.96,-13821.23,0.0,162.0,           ,1.0,1.0,57.0
10086,Liikkuminen,2019-07-19 05:04:13.521126746,2019-07-19,2019-07-19,2019-07-19,10.0,-35.22,-13856.45,0.0,162.0,           ,1.0,1.0,60.0
10087,Tulot,2019-07-19 08:06:45.633802803,2019-07-19,2019-07-19,2019-07-19,10.0,620.19,-13236.26,0.0,505.0,           ,1.0,1.0,193.0
10088,Ruoka_paivittaistavarakauppa,2019-07-22 02:01:41.408450689,2019-07-22,2019-07-22,2019-07-22,10.0,-2.01,-13238.27,0.0,162.0,           ,1.0,1.0,139.0
10089,Lemmikit,2019-07-22 19:56:37.183098575,2019-07-22,2019-07-22,2019-07-22,10.0,-1187.96,-14426.23,0.0,106.0,OKOYFIHH   ,0.0,0.0,37.0
10090,Ravintolat_kahvilat,2019-07-22 22:59:09.295774632,2019-07-22,2019-07-22,2019-07-22,10.0,-1.55,-14427.78,0.0,162.0,           ,1.0,1.0,108.0
10091,Luottojen_maksut,2019-07-23 16:54:05.070422518,2019-07-23,2019-07-24,2019-07-23,10.0,-91.2,-14518.98,0.0,106.0,OKOYFIHH   ,1.0,0.0,11.0
10092,Ravintolat_kahvilat,2019-07-24 13:51:32.957746461,2019-07-24,2019-07-24,2019-07-24,10.0,-4.22,-14523.2,0.0,162.0,           ,1.0,1.0,115.0
10093,Ruoka_paivittaistavarakauppa,2019-07-25 07:46:28.732394347,2019-07-25,2019-07-25,2019-07-25,10.0,-13.74,-14536.94,0.0,162.0,           ,1.0,1.0,64.0
10094,Asuminen,2019-07-25 10:49:00.845070404,2019-07-25,2019-07-25,2019-07-25,10.0,-31.9,-14568.84,0.0,106.0,DABAFIHH   ,0.0,0.0,33.0
10095,Muut,2019-07-29 01:41:24.507042233,2019-07-29,2019-07-29,2019-07-29,10.0,-23.87,-14592.71,0.0,162.0,           ,1.0,1.0,102.0
10096,Ruoka_paivittaistavarakauppa,2019-07-29 04:43:56.619718290,2019-07-29,2019-07-30,2019-07-29,10.0,-0.79,-14593.5,0.0,162.0,           ,1.0,1.0,95.0
10097,Muut,2019-07-29 16:33:48.169014062,2019-07-29,2019-07-29,2019-07-29,10.0,-17.14,-14610.64,0.0,106.0,OKOYFIHH   ,0.0,0.0,15.0
10098,Ruoka_paivittaistavarakauppa,2019-07-29 19:36:20.281690119,2019-07-29,2019-07-29,2019-07-29,10.0,-2.05,-14612.69,0.0,162.0,           ,1.0,1.0,163.0
10099,Ruoka_paivittaistavarakauppa,2019-07-29 22:38:52.394366176,2019-07-29,2019-07-29,2019-07-29,10.0,-2.89,-14615.58,0.0,162.0,           ,1.0,1.0,113.0
10100,Tulot,2019-07-31 13:31:16.056338005,2019-07-31,2019-07-31,2019-07-31,10.0,478.59,-14136.99,701.0,521.0,           ,1.0,1.0,206.0
10101,Muut,2019-08-01 12:17:51.074380165,2019-08-01,2019-08-01,2019-07-31,10.0,-270.49,-14407.48,706.0,105.0,OKOYFIHH   ,1.0,0.0,208.0
10102,Tulot,2019-08-02 00:35:42.148760330,2019-08-02,2019-08-02,2019-08-02,10.0,375.47,-14032.01,710.0,505.0,           ,1.0,1.0,225.0
10103,Muut,2019-08-02 12:53:33.223140495,2019-08-02,2019-08-02,2019-08-02,10.0,-8.41,-14040.42,0.0,162.0,           ,1.0,1.0,136.0
10104,Ruoka_paivittaistavarakauppa,2019-08-02 13:29:15.371900825,2019-08-02,2019-08-02,2019-08-02,10.0,-0.76,-14041.18,0.0,162.0,           ,1.0,1.0,46.0
10105,Liikkuminen,2019-08-02 14:04:57.520661155,2019-08-02,2019-08-02,2019-08-02,10.0,-153.36,-14194.54,0.0,106.0,NDEAFIHH   ,0.0,0.0,33.0
10106,Liikkuminen,2019-08-05 01:11:24.297520660,2019-08-05,2019-08-05,2019-08-05,10.0,-2.04,-14196.58,0.0,162.0,           ,1.0,1.0,78.0
10107,Lemmikit,2019-08-05 01:47:06.446280990,2019-08-05,2019-08-05,2019-08-05,10.0,-2.87,-14199.45,0.0,162.0,           ,1.0,1.0,112.0
10108,Luottojen_maksut,2019-08-05 02:22:48.595041320,2019-08-05,2019-08-05,2019-08-05,10.0,-10.73,-14210.18,0.0,106.0,OKOYFIHH   ,0.0,0.0,15.0
10109,Luottojen_maksut,2019-08-05 14:40:39.669421485,2019-08-05,2019-08-05,2019-08-05,10.0,-17.47,-14227.65,0.0,106.0,OKOYFIHH   ,0.0,0.0,43.0
10110,Ruoka_paivittaistavarakauppa,2019-08-05 15:16:21.818181815,2019-08-05,2019-08-05,2019-08-05,10.0,-1.68,-14229.33,0.0,162.0,           ,1.0,1.0,134.0
10111,Ruoka_paivittaistavarakauppa,2019-08-06 02:58:30.743801650,2019-08-06,2019-08-06,2019-08-06,10.0,-0.73,-14230.06,0.0,162.0,           ,1.0,1.0,56.0
10112,Ruoka_paivittaistavarakauppa,2019-08-06 15:52:03.966942145,2019-08-06,2019-08-06,2019-08-06,10.0,-3.13,-14233.19,0.0,162.0,           ,1.0,1.0,153.0
10113,Kulttuuri_viihde,2019-08-07 03:34:12.892561980,2019-08-07,2019-08-07,2019-08-07,10.0,-5.62,-14238.81,0.0,106.0,OKOYFIHH   ,0.0,0.0,13.0
10114,Ruoka_paivittaistavarakauppa,2019-08-08 04:09:55.041322310,2019-08-08,2019-08-08,2019-08-08,10.0,-47.1,-14285.91,0.0,162.0,           ,1.0,1.0,158.0
10115,Ravintolat_kahvilat,2019-08-08 05:21:19.338842970,2019-08-08,2019-08-08,2019-08-08,10.0,-0.34,-14286.25,0.0,162.0,           ,1.0,1.0,81.0
10116,Ruoka_paivittaistavarakauppa,2019-08-09 04:45:37.190082640,2019-08-09,2019-08-09,2019-08-09,10.0,-1.66,-14287.91,0.0,162.0,           ,1.0,1.0,110.0
10117,Ruoka_paivittaistavarakauppa,2019-08-09 16:27:46.115702475,2019-08-09,2019-08-09,2019-08-09,10.0,-7.84,-14295.75,0.0,162.0,           ,1.0,1.0,116.0
10118,Ruoka_paivittaistavarakauppa,2019-08-09 17:03:28.264462805,2019-08-09,2019-08-09,2019-08-09,10.0,-2.33,-14298.08,0.0,162.0,           ,1.0,1.0,127.0
10119,Lemmikit,2019-08-09 17:39:10.413223135,2019-08-09,2019-08-09,2019-08-09,10.0,-8.52,-14306.6,0.0,162.0,           ,1.0,1.0,176.0
10120,Ruoka_paivittaistavarakauppa,2019-08-12 05:57:01.487603300,2019-08-12,2019-08-14,2019-08-12,10.0,-2.01,-14308.61,0.0,162.0,           ,1.0,1.0,98.0
10121,Muut,2019-08-12 06:32:43.636363630,2019-08-08,2019-08-12,2019-08-12,10.0,-10.8,-14319.41,0.0,106.0,OKOYFIHH   ,0.0,0.0,43.0
10122,Ruoka_paivittaistavarakauppa,2019-08-12 07:08:25.785123960,2019-08-12,2019-08-12,2019-08-12,10.0,-11.9,-14331.31,0.0,162.0,           ,1.0,1.0,84.0
10123,Muut,2019-08-12 18:14:52.561983465,2019-08-12,2019-08-12,2019-08-12,10.0,-12.81,-14344.12,0.0,106.0,OKOYFIHH   ,0.0,0.0,21.0
10124,Muut,2019-08-12 18:50:34.710743795,2019-08-12,2019-08-12,2019-08-12,10.0,-4.56,-14348.68,0.0,106.0,NDEAFIHH   ,0.0,0.0,10.0
10125,Liikkuminen,2019-08-13 08:19:50.082644620,2019-08-13,2019-08-13,2019-08-13,10.0,-0.9,-14349.58,0.0,162.0,           ,1.0,1.0,150.0
10126,Ruoka_paivittaistavarakauppa,2019-08-13 19:26:16.859504125,2019-08-13,2019-08-13,2019-08-13,10.0,-9.74,-14359.32,0.0,162.0,           ,1.0,1.0,146.0
10127,Saastot_sijoitukset,2019-08-14 20:01:59.008264455,2019-08-14,2019-08-14,2019-08-14,10.0,-6.84,-14366.16,0.0,162.0,           ,1.0,1.0,179.0
10128,Liikkuminen,2019-08-15 07:44:07.933884290,2019-08-15,2019-08-16,2019-08-15,10.0,-18.79,-14384.95,0.0,162.0,           ,1.0,1.0,54.0
10129,Kulttuuri_viihde,2019-08-15 09:31:14.380165280,2019-08-15,2019-08-15,2019-08-15,10.0,-8.59,-14393.54,0.0,106.0,OKOYFIHH   ,0.0,0.0,43.0
10130,Lemmikit,2019-08-15 20:37:41.157024785,2019-08-15,2019-08-15,2019-08-15,10.0,-30.81,-14424.35,0.0,106.0,OKOYFIHH   ,0.0,0.0,26.0
10131,Lapset,2019-08-16 08:55:32.231404950,2019-08-16,2019-08-16,2019-08-16,10.0,-25.34,-14449.69,0.0,106.0,OKOYFIHH   ,0.0,0.0,44.0
10132,Lapset,2019-08-16 21:13:23.305785115,2019-08-16,2019-08-16,2019-08-16,10.0,-6.66,-14456.35,0.0,106.0,OKOYFIHH   ,0.0,0.0,22.0
10133,Ruoka_paivittaistavarakauppa,2019-08-16 21:49:05.454545445,2019-08-16,2019-08-16,2019-08-16,10.0,-1.03,-14457.38,0.0,162.0,           ,1.0,1.0,110.0
10134,Ruoka_paivittaistavarakauppa,2019-08-19 10:06:56.528925610,2019-08-19,2019-08-19,2019-08-19,10.0,-13.21,-14470.59,0.0,162.0,           ,1.0,1.0,96.0
10135,Ruoka_paivittaistavarakauppa,2019-08-19 10:42:38.677685940,2019-08-19,2019-08-19,2019-08-19,10.0,-2.95,-14473.54,0.0,162.0,           ,1.0,1.0,110.0
10136,Ruoka_paivittaistavarakauppa,2019-08-19 22:24:47.603305775,2019-08-19,2019-08-19,2019-08-19,10.0,-5.47,-14479.01,0.0,162.0,           ,1.0,1.0,100.0
10137,Ruoka_paivittaistavarakauppa,2019-08-19 23:00:29.752066105,2019-08-19,2019-08-19,2019-08-19,10.0,-9.7,-14488.71,0.0,162.0,           ,1.0,1.0,136.0
10138,Asuminen,2019-08-19 23:36:11.900826435,2019-08-19,2019-08-19,2019-08-19,10.0,-66.07,-14554.78,0.0,106.0,OKOYFIHH   ,0.0,0.0,16.0
10139,Luokittelemattomat,2019-08-20 11:18:20.826446270,2019-08-20,2019-08-20,2019-08-20,10.0,-4.27,-14559.05,0.0,106.0,NDEAFIHH   ,1.0,0.0,27.0
10140,Luokittelemattomat,2019-08-22 11:54:02.975206600,2019-08-23,2019-08-22,2019-08-22,10.0,-98.46,-14657.51,0.0,106.0,OKOYFIHH   ,0.0,0.0,32.0
10141,Tulot,2019-08-23 00:11:54.049586765,2019-08-23,2019-08-23,2019-08-23,10.0,204.82,-14452.69,0.0,505.0,           ,1.0,1.0,191.0
10142,Muut,2019-08-23 00:47:36.198347095,2019-08-23,2019-08-23,2019-08-22,10.0,-67.45,-14520.14,0.0,106.0,DABAFIHH   ,0.0,0.0,6.0
10143,Luokittelemattomat,2019-08-23 01:23:18.347107425,2019-08-23,2019-08-23,2019-08-23,10.0,-22.38,-14542.52,0.0,162.0,           ,1.0,1.0,96.0
10144,Liikkuminen,2019-08-23 12:29:45.123966930,2019-08-23,2019-08-23,2019-08-23,10.0,-9.97,-14552.49,0.0,106.0,ITELFIHH   ,1.0,0.0,27.0
10145,Harrastukset,2019-08-23 13:41:09.421487590,2019-08-23,2019-08-23,2019-08-23,10.0,-8.4,-14560.89,0.0,106.0,OKOYFIHH   ,0.0,0.0,42.0
10146,Luokittelemattomat,2019-08-24 13:05:27.272727260,2019-08-24,2019-08-24,2019-08-24,10.0,-102.33,-14663.22,0.0,106.0,OKOYFIHH   ,0.0,0.0,22.0
10147,Ruoka_paivittaistavarakauppa,2019-08-26 01:59:00.495867755,2019-08-26,2019-08-26,2019-08-26,10.0,-19.17,-14682.39,0.0,162.0,           ,1.0,1.0,124.0
10148,Ruoka_paivittaistavarakauppa,2019-08-26 02:34:42.644628085,2019-08-26,2019-08-26,2019-08-26,10.0,-9.8,-14692.19,0.0,162.0,           ,1.0,1.0,108.0
10149,Muut,2019-08-26 14:16:51.570247920,2019-08-26,2019-08-26,2019-08-26,10.0,-20.62,-14712.81,0.0,162.0,           ,1.0,1.0,55.0
10150,Ruoka_paivittaistavarakauppa,2019-08-26 14:52:33.719008250,2019-08-26,2019-08-26,2019-08-26,10.0,-2.63,-14715.44,0.0,162.0,           ,1.0,1.0,67.0
10151,Luokittelemattomat,2019-08-27 03:10:24.793388415,2019-08-27,2019-08-27,2019-08-27,10.0,-96.71,-14812.15,0.0,106.0,OKOYFIHH   ,1.0,0.0,19.0
10152,Ruoka_paivittaistavarakauppa,2019-08-28 03:46:06.942148745,2019-08-28,2019-08-28,2019-08-28,10.0,-2.11,-14814.26,0.0,162.0,           ,1.0,1.0,84.0
10153,Ruoka_paivittaistavarakauppa,2019-08-29 04:21:49.090909075,2019-08-29,2019-08-29,2019-08-29,10.0,-2.98,-14817.24,0.0,162.0,           ,1.0,1.0,165.0
10154,Muut,2019-08-29 15:28:15.867768580,2019-08-29,2019-08-29,2019-08-29,10.0,-2.3,-14819.54,0.0,163.0,           ,1.0,1.0,183.0
10155,Lemmikit,2019-08-29 16:39:40.165289240,2019-08-29,2019-08-29,2019-08-29,10.0,-13.72,-14833.26,0.0,162.0,           ,1.0,1.0,138.0
10156,Ruoka_paivittaistavarakauppa,2019-08-30 04:57:31.239669405,2019-08-30,2019-08-30,2019-08-30,10.0,-15.4,-14848.66,0.0,162.0,           ,1.0,1.0,62.0
10157,Matkailu,2019-08-30 05:33:13.388429735,2019-08-30,2019-08-30,2019-08-30,10.0,-36.45,-14885.11,0.0,106.0,NDEAFIHH   ,0.0,0.0,10.0
10158,Luottojen_maksut,2019-08-30 16:03:58.016528910,2019-08-30,2019-08-30,2019-08-30,10.0,-101.0,-14986.11,0.0,106.0,OKOYFIHH   ,1.0,0.0,8.0
10159,Ravintolat_kahvilat,2019-08-30 17:15:22.314049570,2019-08-30,2019-08-30,2019-08-30,10.0,-4.33,-14990.44,0.0,162.0,           ,1.0,1.0,132.0
10160,Hyvinvointi,2019-08-30 17:51:04.462809900,2019-08-30,2019-08-30,2019-08-30,10.0,-34.67,-15025.11,0.0,106.0,OKOYFIHH   ,0.0,0.0,14.0
10161,Ruoka_paivittaistavarakauppa,2019-09-02 15:27:07.397260272,2019-09-02,2019-09-03,2019-09-02,10.0,-2.43,-15027.54,0.0,162.0,           ,1.0,1.0,114.0
10162,Tulot,2019-09-02 19:43:33.698630136,2019-09-02,2019-09-02,2019-09-02,10.0,354.66,-14672.88,710.0,506.0,           ,1.0,1.0,230.0
10163,Tulot,2019-09-03 11:10:41.095890408,2019-09-03,2019-09-03,2019-09-03,10.0,1078.39,-13594.49,701.0,524.0,           ,1.0,1.0,207.0
10164,Tulot,2019-09-04 06:54:14.794520544,2019-09-04,2019-09-04,2019-09-04,10.0,-22.13,-13616.62,0.0,106.0,DABAFIHH   ,0.0,0.0,32.0
10165,Shoppailu,2019-09-05 02:37:48.493150680,2019-09-05,2019-09-05,2019-09-05,10.0,-40.36,-13656.98,0.0,106.0,OKOYFIHH   ,0.0,0.0,11.0
10166,Liikkuminen,2019-09-05 22:21:22.191780816,2019-09-05,2019-09-05,2019-09-05,10.0,-33.59,-13690.57,0.0,106.0,OKOYFIHH   ,0.0,0.0,14.0
10167,Kulttuuri_viihde,2019-09-06 13:48:29.589041088,2019-09-06,2019-09-06,2019-09-06,10.0,-9.16,-13699.73,0.0,106.0,OKOYFIHH   ,1.0,0.0,31.0
10168,Lemmikit,2019-09-06 18:04:55.890410952,2019-09-06,2019-09-06,2019-09-06,10.0,-57.53,-13757.26,0.0,106.0,OKOYFIHH   ,1.0,0.0,7.0
10169,Muut,2019-09-08 09:32:03.287671224,2019-09-08,2019-09-08,2019-09-08,10.0,-25.24,-13782.5,0.0,106.0,OKOYFIHH   ,0.0,0.0,7.0
10170,Hyvinvointijakauneus,2019-09-09 05:15:36.986301360,2019-09-09,2019-09-09,2019-09-09,10.0,-21.47,-13803.97,0.0,106.0,OKOYFIHH   ,0.0,0.0,33.0
10171,Luokittelemattomat,2019-09-11 16:26:18.082191768,2019-09-11,2019-09-11,2019-09-11,10.0,-47.06,-13851.03,0.0,106.0,OKOYFIHH   ,1.0,0.0,30.0
10172,Asuminen,2019-09-11 20:42:44.383561632,2019-09-11,2019-09-11,2019-09-11,10.0,-40.84,-13891.87,0.0,106.0,DABAFIHH   ,0.0,0.0,33.0
10173,Kulttuuri_viihde,2019-09-12 00:59:10.684931496,2019-09-12,2019-09-12,2019-09-12,10.0,-27.71,-13919.58,0.0,106.0,OKOYFIHH   ,0.0,0.0,40.0
10174,Ruoka_paivittaistavarakauppa,2019-09-12 12:09:51.780821904,2019-09-12,2019-09-12,2019-09-12,10.0,-2.21,-13921.79,0.0,162.0,           ,1.0,1.0,150.0
10175,Lemmikit,2019-09-13 03:36:59.178082176,2019-09-13,2019-09-13,2019-09-13,10.0,-28.73,-13950.52,0.0,162.0,           ,1.0,1.0,61.0
10176,Muut,2019-09-13 07:53:25.479452040,2019-09-13,2019-09-13,2019-09-13,10.0,-12.17,-13962.69,0.0,162.0,           ,1.0,1.0,130.0
10177,Muut,2019-09-16 10:31:13.972602720,2019-09-16,2019-09-16,2019-09-16,10.0,-2.22,-13964.91,0.0,162.0,           ,1.0,1.0,52.0
10178,Ruoka_paivittaistavarakauppa,2019-09-16 14:47:40.273972584,2019-09-16,2019-09-16,2019-09-16,10.0,-4.45,-13969.36,0.0,162.0,           ,1.0,1.0,177.0
10179,Ruoka_paivittaistavarakauppa,2019-09-16 19:04:06.575342448,2019-09-16,2019-09-16,2019-09-16,10.0,-7.94,-13977.3,0.0,162.0,           ,1.0,1.0,114.0
10180,Shoppailu,2019-09-16 23:20:32.876712312,2019-09-16,2019-09-16,2019-09-16,10.0,-4.73,-13982.03,0.0,162.0,           ,1.0,1.0,111.0
10181,Liikkuminen,2019-09-18 06:14:47.671232856,2019-09-18,2019-09-18,2019-09-18,10.0,-3.63,-13985.66,0.0,162.0,           ,1.0,1.0,133.0
10182,Ravintolat_kahvilat,2019-09-19 01:58:21.369862992,2019-09-19,2019-09-19,2019-09-19,10.0,-4.94,-13990.6,0.0,162.0,           ,1.0,1.0,108.0
10183,Ruoka_paivittaistavarakauppa,2019-09-19 21:41:55.068493128,2019-09-19,2019-09-19,2019-09-19,10.0,-4.12,-13994.72,0.0,162.0,           ,1.0,1.0,90.0
10184,Ruoka_paivittaistavarakauppa,2019-09-20 13:09:02.465753400,2019-09-20,2019-09-20,2019-09-20,10.0,-1.7,-13996.42,0.0,162.0,           ,1.0,1.0,46.0
10185,Ruoka_paivittaistavarakauppa,2019-09-20 17:25:28.767123264,2019-09-20,2019-09-20,2019-09-20,10.0,-8.2,-14004.62,0.0,162.0,           ,1.0,1.0,112.0
10186,Liikkuminen,2019-09-23 04:36:09.863013672,2019-09-23,2019-09-23,2019-09-23,10.0,-3.49,-14008.11,0.0,162.0,           ,1.0,1.0,153.0
10187,Ravintolat_kahvilat,2019-09-23 08:52:36.164383536,2019-09-23,2019-09-23,2019-09-23,10.0,-0.38,-14008.49,0.0,162.0,           ,1.0,1.0,140.0
10188,Muut,2019-09-24 00:19:43.561643808,2019-09-24,2019-09-24,2019-09-24,10.0,-18.9,-14027.39,0.0,163.0,           ,1.0,1.0,183.0
10189,Tulot,2019-09-24 20:03:17.260273944,2019-09-24,2019-09-24,2019-09-24,10.0,319.41,-13707.98,710.0,588.0,           ,0.0,1.0,233.0
10190,Hyvinvointijakauneus,2019-09-26 11:30:24.657534216,2019-09-26,2019-09-26,2019-09-26,10.0,-16.42,-13724.4,0.0,162.0,           ,1.0,1.0,115.0
10191,Tulot,2019-09-26 15:46:50.958904080,2019-09-26,2019-09-26,2019-09-26,10.0,1171.55,-12552.85,710.0,506.0,           ,1.0,1.0,227.0
10192,Muut,2019-09-26 22:41:05.753424624,2019-09-26,2019-09-26,2019-09-26,10.0,-19.22,-12572.07,0.0,106.0,NDEAFIHH   ,0.0,0.0,7.0
10193,Muut,2019-09-27 07:13:58.356164352,2019-09-27,2019-09-30,2019-09-27,10.0,-28.45,-12600.52,0.0,163.0,           ,1.0,1.0,183.0
10194,Muut,2019-09-28 02:57:32.054794488,2019-09-28,2019-09-28,2019-09-28,10.0,-5.26,-12605.78,0.0,163.0,           ,1.0,1.0,183.0
10195,Matkailu,2019-09-28 18:24:39.452054760,2019-09-28,2019-09-28,2019-09-28,10.0,-26.34,-12632.12,0.0,106.0,SBANFIHH   ,1.0,0.0,18.0
10196,Luottojen_maksut,2019-09-30 14:08:13.150684896,2019-09-30,2019-09-30,2019-09-30,10.0,-20.79,-12652.91,0.0,106.0,NDEAFIHH   ,0.0,0.0,42.0
10197,Muut,2019-10-01 21:33:54.782608695,2019-10-01,2019-10-01,2019-10-01,10.0,-6.41,-12659.32,0.0,163.0,           ,1.0,1.0,183.0
10198,Matkailu,2019-10-02 11:49:33.913043475,2019-10-02,2019-10-02,2019-10-02,10.0,-282.75,-12942.07,0.0,106.0,OKOYFIHH   ,0.0,0.0,40.0
10199,Ruoka_paivittaistavarakauppa,2019-10-02 19:07:49.565217390,2019-10-02,2019-10-02,2019-10-02,10.0,-3.76,-12945.83,0.0,162.0,           ,1.0,1.0,75.0
10200,Tulot,2019-10-03 16:41:44.347826085,2019-10-03,2019-10-03,2019-10-03,10.0,8.86,-12936.97,710.0,506.0,           ,1.0,1.0,229.0
10201,Tulot,2019-10-04 14:15:39.130434780,2019-10-04,2019-10-04,2019-10-04,10.0,329.39,-12607.58,701.0,520.0,           ,1.0,1.0,203.0
10202,Luokittelemattomat,2019-10-06 09:23:28.695652170,2019-10-06,2019-10-06,2019-10-06,10.0,-80.47,-12688.05,0.0,106.0,OKOYFIHH   ,0.0,0.0,10.0
10203,Kulttuuri_viihde,2019-10-07 04:31:18.260869560,2019-10-07,2019-10-09,2019-10-07,10.0,-5.54,-12693.59,0.0,106.0,OKOYFIHH   ,0.0,0.0,11.0
10204,Asuminen,2019-10-07 06:57:23.478260865,2019-10-07,2019-10-07,2019-10-07,10.0,-38.06,-12731.65,0.0,106.0,OKOYFIHH   ,0.0,0.0,37.0
10205,Luottojen_maksut,2019-10-09 02:05:13.043478255,2019-10-09,2019-10-09,2019-10-09,10.0,-2060.05,-14791.7,0.0,106.0,DABAFIHH   ,0.0,0.0,42.0
10206,Ravintolat_kahvilat,2019-10-09 23:39:07.826086950,2019-10-09,2019-10-09,2019-10-09,10.0,-17.02,-14808.72,0.0,106.0,OKOYFIHH   ,0.0,0.0,24.0
10207,Asuminen,2019-10-10 21:13:02.608695645,2019-10-10,2019-10-10,2019-10-10,10.0,-664.79,-15473.51,0.0,106.0,OKOYFIHH   ,0.0,0.0,6.0
10208,Ravintolat_kahvilat,2019-10-11 16:20:52.173913035,2019-10-11,2019-10-11,2019-10-11,10.0,-38.19,-15511.7,0.0,162.0,           ,1.0,1.0,84.0
10209,Muut,2019-10-11 18:46:57.391304340,2019-10-11,2019-10-11,2019-10-11,10.0,-3.42,-15515.12,0.0,105.0,OKOYFIHH   ,1.0,0.0,4.0
10210,Muut,2019-10-12 13:54:46.956521730,2019-10-12,2019-10-12,2019-10-12,10.0,-12.33,-15527.45,0.0,163.0,           ,1.0,1.0,183.0
10211,Ruoka_paivittaistavarakauppa,2019-10-14 11:28:41.739130425,2019-10-14,2019-10-14,2019-10-14,10.0,-5.64,-15533.09,0.0,162.0,           ,1.0,1.0,46.0
10212,Tulot,2019-10-15 06:36:31.304347815,2019-10-15,2019-10-15,2019-10-15,10.0,1164.57,-14368.52,701.0,521.0,           ,1.0,1.0,206.0
10213,Ruoka_paivittaistavarakauppa,2019-10-16 04:10:26.086956510,2019-10-16,2019-10-16,2019-10-16,10.0,-4.26,-14372.78,0.0,162.0,           ,1.0,1.0,155.0
10214,Lapset,2019-10-16 09:02:36.521739120,2019-10-16,2019-10-16,2019-10-16,10.0,-0.54,-14373.32,0.0,162.0,           ,1.0,1.0,156.0
10215,Tulot,2019-10-17 20:52:10.434782595,2019-10-17,2019-10-17,2019-10-17,10.0,309.11,-14064.21,710.0,506.0,           ,1.0,1.0,231.0
10216,Ruoka_paivittaistavarakauppa,2019-10-18 01:44:20.869565205,2019-10-18,2019-10-18,2019-10-18,10.0,-2.45,-14066.66,0.0,162.0,           ,1.0,1.0,75.0
10217,Ruoka_paivittaistavarakauppa,2019-10-18 23:18:15.652173900,2019-10-18,2019-10-18,2019-10-18,10.0,-3.16,-14069.82,0.0,162.0,           ,1.0,1.0,81.0
10218,Ruoka_paivittaistavarakauppa,2019-10-21 13:33:54.782608680,2019-10-21,2019-10-21,2019-10-21,10.0,-2.66,-14072.48,0.0,162.0,           ,1.0,1.0,110.0
10219,Muut,2019-10-21 15:59:59.999999985,2019-10-21,2019-10-21,2019-10-21,10.0,-8.48,-14080.96,0.0,163.0,           ,1.0,1.0,185.0
10220,Ravintolat_kahvilat,2019-10-21 18:26:05.217391290,2019-10-21,2019-10-21,2019-10-21,10.0,-2.83,-14083.79,0.0,106.0,OKOYFIHH   ,0.0,0.0,6.0
10221,Luottojen_maksut,2019-10-23 08:41:44.347826070,2019-10-23,2019-10-23,2019-10-23,10.0,-83.24,-14167.03,0.0,106.0,OKOYFIHH   ,1.0,0.0,40.0
10222,Harrastukset,2019-10-24 06:15:39.130434765,2019-10-24,2019-10-24,2019-10-24,10.0,-2.65,-14169.68,0.0,162.0,           ,1.0,1.0,176.0
10223,Shoppailu,2019-10-25 03:49:33.913043460,2019-10-25,2019-10-25,2019-10-25,10.0,-5.56,-14175.24,0.0,162.0,           ,1.0,1.0,109.0
10224,Liikkuminen,2019-10-25 11:07:49.565217375,2019-10-25,2019-10-25,2019-10-25,10.0,-204.83,-14380.07,0.0,106.0,OKOYFIHH   ,0.0,0.0,11.0
10225,Matkailu,2019-10-25 22:57:23.478260850,2019-10-25,2019-10-25,2019-10-25,10.0,-8.05,-14388.12,0.0,103.0,           ,0.0,1.0,1.0
10226,Muut,2019-10-28 01:23:28.695652155,2019-10-28,2019-10-28,2019-10-28,10.0,-17.09,-14405.21,0.0,163.0,           ,1.0,1.0,185.0
10227,Ravintolat_kahvilat,2019-10-28 18:05:13.043478240,2019-10-28,2019-10-28,2019-10-28,10.0,-5.26,-14410.47,0.0,162.0,           ,1.0,1.0,104.0
10228,Liikkuminen,2019-10-28 20:31:18.260869545,2019-10-28,2019-10-28,2019-10-28,10.0,-21.89,-14432.36,0.0,162.0,           ,1.0,1.0,73.0
10229,Muut,2019-10-30 13:13:02.608695630,2019-10-30,2019-10-30,2019-10-30,10.0,-19.72,-14452.08,0.0,106.0,NDEAFIHH   ,0.0,0.0,13.0
10230,Liikkuminen,2019-10-30 15:39:07.826086935,2019-10-30,2019-10-30,2019-10-30,10.0,-94.92,-14547.0,0.0,106.0,OKOYFIHH   ,1.0,0.0,33.0
10231,Tulot,2019-11-04 05:20:00.000000000,2019-11-04,2019-11-04,2019-11-04,10.0,5660.23,-8886.77,701.0,521.0,           ,1.0,1.0,206.0
10232,Tulot,2019-11-05 10:40:00.000000000,2019-11-05,2019-11-05,2019-11-05,10.0,1552.5,-7334.27,701.0,521.0,           ,1.0,1.0,206.0
10233,Ruoka_paivittaistavarakauppa,2019-11-07 16:00:00.000000000,2019-11-07,2019-11-07,2019-11-07,10.0,-0.11,-7334.38,0.0,162.0,           ,1.0,1.0,96.0
10234,Muut,2019-11-08 21:20:00.000000000,2019-11-08,2019-11-08,2019-11-08,10.0,-31.37,-7365.75,0.0,163.0,           ,1.0,1.0,184.0
10235,Muut,2019-11-12 02:40:00.000000000,2019-11-12,2019-11-12,2019-11-12,10.0,-116.84,-7482.59,0.0,163.0,           ,1.0,1.0,183.0
10236,Asuminen,2019-11-12 08:00:00.000000000,2019-11-12,2019-11-12,2019-11-12,10.0,-204.54,-7687.13,0.0,106.0,OKOYFIHH   ,0.0,0.0,42.0
10237,Asuminen,2019-11-17 13:20:00.000000000,2019-11-17,2019-11-17,2019-11-17,10.0,-448.27,-8135.4,0.0,106.0,OKOYFIHH   ,0.0,0.0,44.0
10238,Luokittelemattomat,2019-11-18 18:40:00.000000000,2019-11-18,2019-11-18,2019-11-18,10.0,-17.45,-8152.85,0.0,106.0,OKOYFIHH   ,1.0,0.0,17.0
10239,Luokittelemattomat,2019-11-21 00:00:00.000000000,2019-11-21,2019-11-21,2019-11-21,10.0,-280.86,-8433.71,0.0,106.0,SBANFIHH   ,1.0,0.0,17.0
10240,Tulot,2019-11-22 05:20:00.000000000,2019-11-22,2019-11-22,2019-11-22,10.0,7.45,-8426.26,710.0,506.0,           ,1.0,1.0,226.0
10241,Ruoka_paivittaistavarakauppa,2019-11-25 10:40:00.000000000,2019-11-25,2019-11-25,2019-11-25,10.0,-7.63,-8433.89,0.0,162.0,           ,1.0,1.0,141.0
10242,Tulot,2019-11-28 16:00:00.000000000,2019-11-28,2019-11-28,2019-11-28,10.0,31.92,-8401.97,701.0,521.0,           ,1.0,1.0,206.0
10243,Lemmikit,2019-11-29 21:20:00.000000000,2019-11-29,2019-11-29,2019-11-29,10.0,-1.72,-8403.69,0.0,162.0,           ,1.0,1.0,109.0
10244,Muut,2019-12-02 07:19:34.736842104,2019-12-02,2019-12-02,2019-12-02,10.0,-22.94,-8426.63,0.0,163.0,           ,1.0,1.0,185.0
10245,Tulot,2019-12-02 15:39:47.368421052,2019-12-02,2019-12-02,2019-12-02,10.0,148.3,-8278.33,701.0,521.0,           ,1.0,1.0,206.0
10246,Hyvinvointijakauneus,2019-12-02 22:59:22.105263156,2019-12-02,2019-12-02,2019-12-02,10.0,-6.33,-8284.66,0.0,162.0,           ,1.0,1.0,46.0
10247,Ruoka_paivittaistavarakauppa,2019-12-03 14:39:09.473684208,2019-12-03,2019-12-03,2019-12-03,10.0,-12.3,-8296.96,0.0,162.0,           ,1.0,1.0,134.0
10248,Muut,2019-12-04 06:18:56.842105260,2019-12-04,2019-12-04,2019-12-04,10.0,-43.81,-8340.77,0.0,162.0,           ,1.0,1.0,60.0
10249,Luokittelemattomat,2019-12-04 21:58:44.210526312,2019-12-04,2019-12-04,2019-12-04,10.0,-7.14,-8347.91,0.0,162.0,           ,1.0,1.0,111.0
10250,Ruoka_paivittaistavarakauppa,2019-12-05 13:38:31.578947364,2019-12-05,2019-12-05,2019-12-05,10.0,-7.39,-8355.3,0.0,162.0,           ,1.0,1.0,79.0
10251,Luottojen_maksut,2019-12-06 05:18:18.947368416,2019-12-06,2019-12-06,2019-12-06,10.0,-37.85,-8393.15,0.0,106.0,OKOYFIHH   ,1.0,0.0,40.0
10252,Matkailu,2019-12-06 12:37:53.684210520,2019-12-06,2019-12-06,2019-12-06,10.0,-510.05,-8903.2,0.0,106.0,DABAFIHH   ,1.0,0.0,13.0
10253,Liikkuminen,2019-12-06 20:58:06.315789468,2019-12-06,2019-12-06,2019-12-06,10.0,-17.89,-8921.09,0.0,106.0,DABAFIHH   ,1.0,0.0,40.0
10254,Harrastukset,2019-12-08 04:17:41.052631572,2019-12-08,2019-12-08,2019-12-08,10.0,-168.57,-9089.66,0.0,106.0,OKOYFIHH   ,0.0,0.0,25.0
10255,Muut,2019-12-09 11:37:15.789473676,2019-12-09,2019-12-12,2019-12-09,10.0,-21.71,-9111.37,0.0,163.0,           ,1.0,1.0,183.0
10256,Muut,2019-12-09 18:56:50.526315780,2019-12-09,2019-12-09,2019-12-09,10.0,-57.28,-9168.65,0.0,163.0,           ,1.0,1.0,185.0
10257,Tulot,2019-12-09 19:57:28.421052624,2019-12-09,2019-12-09,2019-12-09,10.0,31.63,-9137.02,710.0,506.0,           ,1.0,1.0,232.0
10258,Luokittelemattomat,2019-12-10 03:17:03.157894728,2019-12-10,2019-12-10,2019-12-10,10.0,-86.76,-9223.78,0.0,106.0,DABAFIHH   ,0.0,0.0,7.0
10259,Ravintolat_kahvilat,2019-12-10 10:36:37.894736832,2019-12-10,2019-12-10,2019-12-10,10.0,-16.14,-9239.92,0.0,162.0,           ,1.0,1.0,114.0
10260,Lemmikit,2019-12-12 02:16:25.263157884,2019-12-12,2019-12-12,2019-12-12,10.0,-1.81,-9241.73,0.0,162.0,           ,1.0,1.0,102.0
10261,Muut,2019-12-12 09:35:59.999999988,2019-12-12,2019-12-12,2019-12-12,10.0,-3.81,-9245.54,0.0,162.0,           ,1.0,1.0,154.0
10262,Hyvinvointijakauneus,2019-12-12 17:56:12.631578936,2019-12-12,2019-12-12,2019-12-12,10.0,-8.63,-9254.17,0.0,162.0,           ,1.0,1.0,139.0
10263,Muut,2019-12-13 01:15:47.368421040,2019-12-13,2019-12-13,2019-12-13,10.0,-9.46,-9263.63,0.0,162.0,           ,1.0,1.0,133.0
10264,Ravintolat_kahvilat,2019-12-13 16:55:34.736842092,2019-12-13,2019-12-13,2019-12-13,10.0,-9.15,-9272.78,0.0,162.0,           ,1.0,1.0,96.0
10265,Asuminen,2019-12-16 07:34:44.210526300,2019-12-16,2019-12-16,2019-12-16,10.0,-8.16,-9280.94,0.0,162.0,           ,1.0,1.0,75.0
10266,Ravintolat_kahvilat,2019-12-16 08:35:22.105263144,2019-12-16,2019-12-16,2019-12-16,10.0,-11.46,-9292.4,0.0,162.0,           ,1.0,1.0,100.0
10267,Liikkuminen,2019-12-16 15:54:56.842105248,2019-12-16,2019-12-16,2019-12-16,10.0,-2.46,-9294.86,0.0,162.0,           ,1.0,1.0,56.0
10268,Matkailu,2019-12-17 00:15:09.473684196,2019-12-17,2019-12-17,2019-12-17,10.0,-12.1,-9306.96,0.0,103.0,           ,0.0,1.0,2.0
10269,Tulot,2019-12-17 23:14:31.578947352,2019-12-17,2019-12-17,2019-12-17,10.0,11.24,-9295.72,710.0,506.0,           ,1.0,1.0,228.0
10270,Tulot,2019-12-18 14:54:18.947368404,2019-12-18,2019-12-19,2019-12-18,10.0,90.52,-9205.2,710.0,506.0,           ,1.0,1.0,232.0
10271,Liikkuminen,2019-12-19 05:33:28.421052612,2019-12-19,2019-12-19,2019-12-19,10.0,-13.91,-9219.11,0.0,162.0,           ,1.0,1.0,170.0
10272,Lemmikit,2019-12-19 06:34:06.315789456,2019-12-19,2019-12-19,2019-12-19,10.0,-46.37,-9265.48,0.0,162.0,           ,1.0,1.0,163.0
10273,Ruoka_paivittaistavarakauppa,2019-12-19 22:13:53.684210508,2019-12-19,2019-12-19,2019-12-19,10.0,-21.6,-9287.08,0.0,162.0,           ,1.0,1.0,48.0
10274,Saastot_sijoitukset,2019-12-20 13:53:41.052631560,2019-12-20,2019-12-20,2019-12-20,10.0,-34.58,-9321.66,0.0,162.0,           ,1.0,1.0,111.0
10275,Liikkuminen,2019-12-23 04:32:50.526315768,2019-12-23,2019-12-23,2019-12-23,10.0,-6.0,-9327.66,0.0,162.0,           ,1.0,1.0,80.0
10276,Terveys,2019-12-23 12:53:03.157894716,2019-12-23,2019-12-23,2019-12-23,10.0,-15.07,-9342.73,0.0,162.0,           ,1.0,1.0,90.0
10277,Luottojen_maksut,2019-12-23 19:11:59.999999976,2019-12-23,2019-12-23,2019-12-23,10.0,-8.05,-9350.78,0.0,162.0,           ,1.0,1.0,75.0
10278,Hyvinvointijakauneus,2019-12-23 20:12:37.894736820,2019-12-23,2019-12-23,2019-12-23,10.0,-14.89,-9365.67,0.0,162.0,           ,1.0,1.0,113.0
10279,Matkailu,2019-12-23 21:13:15.789473664,2019-12-23,2019-12-25,2019-12-23,10.0,-4.22,-9369.89,0.0,162.0,           ,1.0,1.0,136.0
10280,Lemmikit,2019-12-24 11:52:25.263157872,2019-12-24,2019-12-24,2019-12-24,10.0,-2.47,-9372.36,0.0,162.0,           ,1.0,1.0,134.0
10281,Ravintolat_kahvilat,2019-12-25 03:32:12.631578924,2019-12-25,2019-12-25,2019-12-25,10.0,-1.43,-9373.79,0.0,162.0,           ,1.0,1.0,97.0
10282,Liikkuminen,2019-12-26 10:51:47.368421028,2019-12-26,2019-12-26,2019-12-26,10.0,-3.61,-9377.4,0.0,162.0,           ,1.0,1.0,97.0
10283,Tulot,2019-12-27 17:10:44.210526288,2019-12-23,2019-12-27,2019-12-27,10.0,40.0,-9337.4,0.0,506.0,           ,1.0,1.0,196.0
10284,Luokittelemattomat,2019-12-28 02:31:34.736842080,2019-12-28,2019-12-28,2019-12-28,10.0,-17.36,-9354.76,0.0,106.0,NDEAFIHH   ,0.0,0.0,37.0
10285,Luokittelemattomat,2019-12-28 18:11:22.105263132,2019-12-28,2019-12-28,2019-12-28,10.0,-111.09,-9465.85,0.0,106.0,DABAFIHH   ,0.0,0.0,20.0
10286,Liikkuminen,2019-12-30 01:30:56.842105236,2019-12-30,2019-12-30,2019-12-30,10.0,-10.98,-9476.83,0.0,162.0,           ,1.0,1.0,123.0
10287,Ravintolat_kahvilat,2019-12-30 08:50:31.578947340,2019-12-30,2019-12-30,2019-12-30,10.0,-2.89,-9479.72,0.0,162.0,           ,1.0,1.0,120.0
10288,Ruoka_paivittaistavarakauppa,2019-12-30 09:51:09.473684184,2019-12-30,2019-12-30,2020-01-03,10.0,-6.79,-9486.51,0.0,162.0,           ,1.0,1.0,145.0
10289,Lapset,2019-12-31 00:30:18.947368392,2019-12-31,2019-12-31,2019-12-31,10.0,-9.06,-9495.57,0.0,162.0,           ,1.0,1.0,102.0
10290,Hyvinvointijakauneus,2019-12-31 16:10:06.315789444,2019-12-31,2020-01-02,2019-12-31,10.0,-0.58,-9496.15,0.0,162.0,           ,1.0,1.0,144.0
10291,Tulot,2020-01-01 11:54:14.400000000,2020-01-01,2020-01-01,2020-01-01,10.0,620.11,-8876.04,701.0,520.0,           ,1.0,1.0,202.0
10292,Matkailu,2020-01-01 23:48:28.800000000,2020-01-01,2020-01-01,2020-01-01,10.0,-144.08,-9020.12,0.0,106.0,OKOYFIHH   ,1.0,0.0,18.0
10293,Luottojen_maksut,2020-01-02 11:42:43.200000000,2020-01-02,2020-01-02,2020-01-02,10.0,-97.7,-9117.82,0.0,106.0,OKOYFIHH   ,1.0,0.0,12.0
10294,Lemmikit,2020-01-02 23:36:57.600000000,2020-01-02,2020-01-02,2020-01-02,10.0,-20.16,-9137.98,0.0,106.0,OKOYFIHH   ,0.0,0.0,22.0
10295,Asuminen,2020-01-03 11:19:40.800000000,2020-01-03,2020-01-03,2020-01-03,10.0,-44.88,-9182.86,0.0,106.0,DABAFIHH   ,0.0,0.0,27.0
10296,Luottojen_maksut,2020-01-03 11:31:12.000000000,2020-01-03,2020-01-03,2020-01-03,10.0,-21.7,-9204.56,0.0,106.0,OKOYFIHH   ,1.0,0.0,44.0
10297,Lemmikit,2020-01-03 23:13:55.200000000,2020-01-03,2020-01-03,2020-01-02,10.0,-146.22,-9350.78,0.0,106.0,OKOYFIHH   ,0.0,0.0,43.0
10298,Lapset,2020-01-03 23:25:26.400000000,2020-01-03,2020-01-03,2020-01-03,10.0,-11.99,-9362.77,0.0,106.0,OKOYFIHH   ,0.0,0.0,35.0
10299,Ruoka_paivittaistavarakauppa,2020-01-06 10:56:38.400000000,2020-01-06,2020-01-06,2020-01-06,10.0,-3.26,-9366.03,0.0,162.0,           ,1.0,1.0,118.0
10300,Ruoka_paivittaistavarakauppa,2020-01-06 11:08:09.600000000,2020-01-06,2020-01-06,2020-01-06,10.0,-0.68,-9366.71,0.0,162.0,           ,1.0,1.0,47.0
10301,Liikkuminen,2020-01-06 22:50:52.800000000,2020-01-06,2020-01-06,2020-01-07,10.0,-162.86,-9529.57,0.0,106.0,OKOYFIHH   ,1.0,0.0,43.0
10302,Ruoka_paivittaistavarakauppa,2020-01-07 10:33:36.000000000,2020-01-07,2020-01-08,2020-01-07,10.0,-11.46,-9541.03,0.0,162.0,           ,1.0,1.0,134.0
10303,Luokittelemattomat,2020-01-07 10:45:07.200000000,2020-01-07,2020-01-07,2020-01-07,10.0,-5.97,-9547.0,0.0,162.0,           ,1.0,1.0,170.0
10304,Liikkuminen,2020-01-07 22:39:21.600000000,2020-01-07,2020-01-07,2020-01-07,10.0,-12.08,-9559.08,0.0,162.0,           ,1.0,1.0,160.0
10305,Muut,2020-01-07 23:02:24.000000000,2020-01-07,2020-01-07,2020-01-07,10.0,-6.26,-9565.34,0.0,162.0,           ,1.0,1.0,85.0
10306,Ruoka_paivittaistavarakauppa,2020-01-08 22:27:50.400000000,2020-01-08,2020-01-08,2020-01-08,10.0,-1.14,-9566.48,0.0,162.0,           ,1.0,1.0,125.0
10307,Ruoka_paivittaistavarakauppa,2020-01-09 10:22:04.800000000,2020-01-09,2020-01-10,2020-01-09,10.0,-2.69,-9569.17,0.0,162.0,           ,1.0,1.0,116.0
10308,Liikkuminen,2020-01-09 22:04:48.000000000,2020-01-09,2020-01-09,2020-01-09,10.0,-6.14,-9575.31,0.0,162.0,           ,1.0,1.0,119.0
10309,Muut,2020-01-09 22:16:19.200000000,2020-01-09,2020-01-09,2020-01-09,10.0,-10.6,-9585.91,0.0,163.0,           ,1.0,1.0,186.0
10310,Ruoka_paivittaistavarakauppa,2020-01-10 09:59:02.400000000,2020-01-10,2020-01-10,2020-01-10,10.0,-7.31,-9593.22,0.0,162.0,           ,1.0,1.0,136.0
10311,Ravintolat_kahvilat,2020-01-10 10:10:33.600000000,2020-01-10,2020-01-10,2020-01-10,10.0,-5.81,-9599.03,0.0,162.0,           ,1.0,1.0,47.0
10312,Liikkuminen,2020-01-10 21:53:16.800000000,2020-01-10,2020-01-10,2020-01-10,10.0,-5.52,-9604.55,0.0,162.0,           ,1.0,1.0,118.0
10313,Ruoka_paivittaistavarakauppa,2020-01-13 09:24:28.800000000,2020-01-13,2020-01-13,2020-01-13,10.0,-26.59,-9631.14,0.0,162.0,           ,1.0,1.0,156.0
10314,Hyvinvointijakauneus,2020-01-13 09:36:00.000000000,2020-01-13,2020-01-13,2020-01-13,10.0,-36.6,-9667.74,0.0,106.0,NDEAFIHH   ,0.0,0.0,43.0
10315,Luottojen_maksut,2020-01-13 09:47:31.200000000,2020-01-13,2020-01-13,2020-01-13,10.0,-272.52,-9940.26,0.0,172.0,           ,1.0,1.0,189.0
10316,Tulot,2020-01-13 21:18:43.200000000,2020-01-13,2020-01-13,2020-01-13,10.0,92.52,-9847.74,0.0,506.0,           ,1.0,1.0,197.0
10317,Ruoka_paivittaistavarakauppa,2020-01-13 21:30:14.400000000,2020-01-13,2020-01-13,2020-01-13,10.0,-6.83,-9854.57,0.0,162.0,           ,1.0,1.0,158.0
10318,Vakuutukset,2020-01-13 21:41:45.600000000,2020-01-13,2020-01-13,2020-01-13,10.0,-11.23,-9865.8,0.0,106.0,SBANFIHH   ,0.0,0.0,23.0
10319,Tulot,2020-01-15 09:12:57.600000000,2020-01-15,2020-01-15,2020-01-15,10.0,16.15,-9849.65,0.0,506.0,           ,1.0,1.0,196.0
10320,Ravintolat_kahvilat,2020-01-15 21:07:12.000000000,2020-01-15,2020-01-15,2020-01-15,10.0,-12.14,-9861.79,0.0,106.0,OKOYFIHH   ,0.0,0.0,33.0
10321,Ravintolat_kahvilat,2020-01-16 20:55:40.800000000,2020-01-16,2020-01-16,2020-01-16,10.0,-3.68,-9865.47,0.0,162.0,           ,1.0,1.0,52.0
10322,Tulot,2020-01-17 08:49:55.200000000,2020-01-17,2020-01-17,2020-01-17,10.0,21.89,-9843.58,0.0,506.0,           ,1.0,1.0,197.0
10323,Lemmikit,2020-01-17 09:01:26.400000000,2020-01-17,2020-01-17,2020-01-17,10.0,-10.66,-9854.24,0.0,162.0,           ,1.0,1.0,123.0
10324,Ruoka_paivittaistavarakauppa,2020-01-17 20:21:07.200000000,2020-01-17,2020-01-17,2020-01-17,10.0,-12.13,-9866.37,0.0,162.0,           ,1.0,1.0,147.0
10325,Liikkuminen,2020-01-17 20:44:09.600000000,2020-01-17,2020-01-17,2020-01-17,10.0,-23.73,-9890.1,0.0,106.0,NDEAFIHH   ,0.0,0.0,6.0
10326,Tulot,2020-01-20 08:15:21.600000000,2020-01-20,2020-01-20,2020-01-20,10.0,1162.1,-8728.0,710.0,506.0,           ,1.0,1.0,229.0
10327,Muut,2020-01-20 08:26:52.800000000,2020-01-20,2020-01-22,2020-01-20,10.0,-38.87,-8766.87,0.0,162.0,           ,1.0,1.0,108.0
10328,Ravintolat_kahvilat,2020-01-20 08:38:24.000000000,2020-01-20,2020-01-20,2020-01-20,10.0,-32.61,-8799.48,0.0,162.0,           ,1.0,1.0,95.0
10329,Liikkuminen,2020-01-20 19:58:04.800000000,2020-01-20,2020-01-24,2020-01-20,10.0,-171.4,-8970.88,0.0,106.0,OKOYFIHH   ,0.0,0.0,6.0
10330,Luokittelemattomat,2020-01-20 20:09:36.000000000,2020-01-20,2020-01-20,2020-01-20,10.0,-12.76,-8983.64,0.0,106.0,OKOYFIHH   ,0.0,0.0,19.0
10331,Ruoka_paivittaistavarakauppa,2020-01-20 20:32:38.400000000,2020-01-20,2020-01-20,2020-01-20,10.0,-18.18,-9001.82,0.0,162.0,           ,1.0,1.0,171.0
10332,Vakuutukset,2020-01-21 08:03:50.400000000,2020-01-21,2020-01-21,2020-01-21,10.0,-20.96,-9022.78,0.0,106.0,SBANFIHH   ,0.0,0.0,13.0
10333,Luottojen_maksut,2020-01-22 07:52:19.200000000,2020-01-22,2020-01-22,2020-01-22,10.0,-95.89,-9118.67,0.0,106.0,OKOYFIHH   ,0.0,0.0,6.0
10334,Muut,2020-01-22 19:23:31.200000000,2020-01-22,2020-01-22,2020-01-22,10.0,-134.5,-9253.17,0.0,106.0,OKOYFIHH   ,0.0,0.0,7.0
10335,Luokittelemattomat,2020-01-23 07:29:16.800000000,2020-01-23,2020-01-23,2020-01-23,10.0,-86.37,-9339.54,0.0,162.0,           ,1.0,1.0,136.0
10336,Lemmikit,2020-01-23 19:46:33.600000000,2020-01-23,2020-01-23,2020-01-23,10.0,-13.72,-9353.26,0.0,162.0,           ,1.0,1.0,46.0
10337,Liikkuminen,2020-01-24 07:17:45.600000000,2020-01-24,2020-01-24,2020-01-24,10.0,-144.93,-9498.19,0.0,106.0,OKOYFIHH   ,0.0,0.0,10.0
10338,Ruoka_paivittaistavarakauppa,2020-01-24 07:40:48.000000000,2020-01-24,2020-01-24,2020-01-24,10.0,-6.4,-9504.59,0.0,162.0,           ,1.0,1.0,145.0
10339,Ruoka_paivittaistavarakauppa,2020-01-24 19:35:02.400000000,2020-01-24,2020-01-24,2020-01-24,10.0,-26.56,-9531.15,0.0,162.0,           ,1.0,1.0,107.0
10340,Luottojen_maksut,2020-01-25 19:12:00.000000000,2020-01-25,2020-01-25,2020-01-25,10.0,-636.22,-10167.37,0.0,106.0,DABAFIHH   ,1.0,0.0,33.0
10341,Ruoka_paivittaistavarakauppa,2020-01-27 06:43:12.000000000,2020-01-27,2020-01-27,2020-01-27,10.0,-3.15,-10170.52,0.0,162.0,           ,1.0,1.0,154.0
10342,Ravintolat_kahvilat,2020-01-27 06:54:43.200000000,2020-01-27,2020-01-27,2020-01-27,10.0,-4.01,-10174.53,0.0,162.0,           ,1.0,1.0,121.0
10343,Liikkuminen,2020-01-27 07:06:14.400000000,2020-01-27,2020-01-27,2020-01-27,10.0,-5.53,-10180.06,0.0,162.0,           ,1.0,1.0,127.0
10344,Luottojen_maksut,2020-01-27 18:48:57.600000000,2020-01-27,2020-01-27,2020-01-27,10.0,-20.45,-10200.51,0.0,162.0,           ,1.0,1.0,134.0
10345,Muut,2020-01-27 19:00:28.800000000,2020-01-27,2020-01-27,2020-01-27,10.0,-12.05,-10212.56,0.0,162.0,           ,1.0,1.0,131.0
10346,Ruoka_paivittaistavarakauppa,2020-01-28 18:37:26.400000000,2020-01-28,2020-01-28,2020-01-28,10.0,-7.81,-10220.37,0.0,162.0,           ,1.0,1.0,164.0
10347,Tulot,2020-01-29 06:31:40.800000000,2020-01-29,2020-01-29,2020-01-29,10.0,116.34,-10104.03,0.0,506.0,           ,1.0,1.0,198.0
10348,Tulot,2020-01-29 18:25:55.200000000,2020-01-29,2020-01-29,2020-01-29,10.0,11.53,-10092.5,0.0,506.0,           ,1.0,1.0,196.0
10349,Hyvinvointijakauneus,2020-01-30 06:08:38.400000000,2020-01-30,2020-01-30,2020-01-30,10.0,-6.5,-10099.0,0.0,162.0,           ,1.0,1.0,97.0
10350,Liikkuminen,2020-01-30 06:20:09.600000000,2020-01-30,2020-01-30,2020-01-30,10.0,-2.58,-10101.58,0.0,162.0,           ,1.0,1.0,92.0
10351,Ruoka_paivittaistavarakauppa,2020-01-30 18:14:24.000000000,2020-01-30,2020-01-30,2020-01-30,10.0,-1.87,-10103.45,0.0,162.0,           ,1.0,1.0,54.0
10352,Ruoka_paivittaistavarakauppa,2020-01-31 18:02:52.800000000,2020-01-31,2020-01-31,2020-01-31,10.0,-0.28,-10103.73,0.0,162.0,           ,1.0,1.0,169.0
10353,Tulot,2020-02-03 01:18:32.727272727,2020-02-03,2020-02-03,2020-02-03,10.0,212.11,-9891.62,701.0,520.0,           ,1.0,1.0,202.0
10354,Hyvinvointi,2020-02-03 02:37:05.454545454,2020-02-03,2020-02-03,2020-02-03,10.0,-180.48,-10072.1,706.0,106.0,OKOYFIHH   ,0.0,0.0,209.0
10355,Liikkuminen,2020-02-03 05:14:10.909090908,2020-02-03,2020-02-03,2020-02-03,10.0,-27.06,-10099.16,0.0,162.0,           ,1.0,1.0,84.0
10356,Luokittelemattomat,2020-02-04 03:55:38.181818181,2020-02-04,2020-02-04,2020-02-04,10.0,-88.67,-10187.83,706.0,129.0,OKOYFIHH   ,0.0,0.0,216.0
10357,Hyvinvointijakauneus,2020-02-05 06:32:43.636363635,2020-02-05,2020-02-05,2020-02-05,10.0,-5.35,-10193.18,0.0,106.0,OKOYFIHH   ,0.0,0.0,25.0
10358,Luottojen_maksut,2020-02-07 07:51:16.363636362,2020-02-07,2020-02-07,2020-02-07,10.0,-13.61,-10206.79,0.0,106.0,OKOYFIHH   ,0.0,0.0,14.0
10359,Luokittelemattomat,2020-02-10 10:28:21.818181816,2020-02-10,2020-02-10,2020-02-10,10.0,-135.75,-10342.54,706.0,129.0,OKOYFIHH   ,0.0,0.0,223.0
10360,Ruoka_paivittaistavarakauppa,2020-02-10 11:46:54.545454543,2020-02-10,2020-02-10,2020-02-10,10.0,-43.13,-10385.67,0.0,162.0,           ,1.0,1.0,175.0
10361,Luottojen_maksut,2020-02-11 09:09:49.090909089,2020-02-11,2020-02-11,2020-02-11,10.0,-73.61,-10459.28,0.0,106.0,OKOYFIHH   ,0.0,0.0,6.0
10362,Ruoka_paivittaistavarakauppa,2020-02-11 13:05:27.272727270,2020-02-11,2020-02-11,2020-02-11,10.0,-8.93,-10468.21,0.0,162.0,           ,1.0,1.0,62.0
10363,Matkailu,2020-02-13 14:23:59.999999997,2020-02-13,2020-02-13,2020-02-13,10.0,-10.87,-10479.08,0.0,162.0,           ,1.0,1.0,154.0
10364,Ruoka_paivittaistavarakauppa,2020-02-13 15:42:32.727272724,2020-02-13,2020-02-13,2020-02-13,10.0,-9.64,-10488.72,0.0,162.0,           ,1.0,1.0,123.0
10365,Asuminen,2020-02-13 17:01:05.454545451,2020-02-13,2020-02-13,2020-02-13,10.0,-3.04,-10491.76,0.0,162.0,           ,1.0,1.0,143.0
10366,Muut,2020-02-13 18:19:38.181818178,2020-02-13,2020-02-13,2020-02-13,10.0,-9.77,-10501.53,706.0,106.0,OKOYFIHH   ,0.0,0.0,211.0
10367,Luokittelemattomat,2020-02-14 19:38:10.909090905,2020-02-14,2020-02-14,2020-02-14,10.0,-23.28,-10524.81,0.0,106.0,OKOYFIHH   ,1.0,0.0,8.0
10368,Liikkuminen,2020-02-17 20:56:43.636363632,2020-02-17,2020-02-17,2020-02-17,10.0,-103.61,-10628.42,0.0,106.0,OKOYFIHH   ,1.0,0.0,11.0
10369,Lemmikit,2020-02-18 22:15:16.363636359,2020-02-18,2020-02-18,2020-02-18,10.0,-3.4,-10631.82,0.0,162.0,           ,1.0,1.0,166.0
10370,Ruoka_paivittaistavarakauppa,2020-02-19 23:33:49.090909086,2020-02-19,2020-02-21,2020-02-19,10.0,-10.92,-10642.74,0.0,162.0,           ,1.0,1.0,65.0
10371,Muut,2020-02-20 00:52:21.818181813,2020-02-20,2020-02-20,2020-02-20,10.0,-97.47,-10740.21,0.0,162.0,           ,1.0,1.0,138.0
10372,Luokittelemattomat,2020-02-21 02:10:54.545454540,2020-02-21,2020-02-21,2020-02-21,10.0,-4.53,-10744.74,0.0,162.0,           ,1.0,1.0,70.0
10373,Ruoka_paivittaistavarakauppa,2020-02-24 03:29:27.272727267,2020-02-24,2020-02-24,2020-02-24,10.0,-3.28,-10748.02,0.0,162.0,           ,1.0,1.0,96.0
10374,Luottojen_maksut,2020-02-24 04:47:59.999999994,2020-02-24,2020-02-24,2020-02-24,10.0,-4.45,-10752.47,0.0,162.0,           ,1.0,1.0,158.0
10375,Asuminen,2020-02-26 06:06:32.727272721,2020-02-26,2020-02-26,2020-02-26,10.0,-588.54,-11341.01,706.0,106.0,OKOYFIHH   ,0.0,0.0,209.0
10376,Ruoka_paivittaistavarakauppa,2020-02-27 07:25:05.454545448,2020-02-27,2020-02-27,2020-02-27,10.0,-21.65,-11362.66,0.0,162.0,           ,1.0,1.0,123.0
10377,Ruoka_paivittaistavarakauppa,2020-02-27 08:43:38.181818175,2020-02-27,2020-02-28,2020-02-27,10.0,-4.86,-11367.52,0.0,162.0,           ,1.0,1.0,90.0
10378,Ruoka_paivittaistavarakauppa,2020-02-27 10:02:10.909090902,2020-02-27,2020-02-27,2020-02-27,10.0,-30.69,-11398.21,0.0,162.0,           ,1.0,1.0,167.0
10379,Ruoka_paivittaistavarakauppa,2020-02-27 11:20:43.636363629,2020-02-27,2020-02-27,2020-02-27,10.0,-21.38,-11419.59,0.0,162.0,           ,1.0,1.0,50.0
10380,Tulot,2020-03-03 22:51:25.714285714,2020-03-03,2020-03-03,2020-03-03,10.0,75.34,-11344.25,701.0,520.0,           ,1.0,1.0,201.0
10381,Kulttuuri_viihde,2020-03-04 21:42:51.428571428,2020-03-04,2020-03-04,2020-03-04,10.0,-15.44,-11359.69,0.0,162.0,           ,1.0,1.0,112.0
10382,Lapset,2020-03-09 20:34:17.142857142,2020-03-09,2020-03-09,2020-03-09,10.0,-6.41,-11366.1,0.0,106.0,OKOYFIHH   ,1.0,0.0,6.0
10383,Matkailu,2020-03-13 19:25:42.857142856,2020-03-13,2020-03-13,2020-03-12,10.0,-1.9,-11368.0,706.0,129.0,DABAFIHH   ,0.0,0.0,216.0
10384,Ruoka_paivittaistavarakauppa,2020-03-16 18:17:08.571428570,2020-03-16,2020-03-16,2020-03-16,10.0,-7.93,-11375.93,0.0,162.0,           ,1.0,1.0,125.0
10385,Asuminen,2020-03-18 15:59:59.999999998,2020-03-18,2020-03-18,2020-03-18,10.0,-158.27,-11534.2,0.0,162.0,           ,1.0,1.0,96.0
10386,Ruoka_paivittaistavarakauppa,2020-03-18 17:08:34.285714284,2020-03-18,2020-03-18,2020-03-18,10.0,-61.82,-11596.02,0.0,162.0,           ,1.0,1.0,165.0
10387,Ruoka_paivittaistavarakauppa,2020-03-23 14:51:25.714285712,2020-03-23,2020-03-23,2020-03-23,10.0,-5.52,-11601.54,0.0,162.0,           ,1.0,1.0,108.0
10388,Ruoka_paivittaistavarakauppa,2020-03-27 13:42:51.428571426,2020-03-27,2020-03-27,2020-03-27,10.0,-2.17,-11603.71,0.0,162.0,           ,1.0,1.0,82.0
10389,Luokittelemattomat,2020-03-30 12:34:17.142857140,2020-03-30,2020-03-30,2020-03-30,10.0,-14.55,-11618.26,0.0,162.0,           ,1.0,1.0,141.0
10390,Tulot,2020-04-02 11:07:19.024390243,2020-04-02,2020-04-02,2020-04-02,10.0,1263.93,-10354.33,701.0,520.0,           ,1.0,1.0,205.0
10391,Luottojen_maksut,2020-04-03 22:14:38.048780486,2020-04-03,2020-04-03,2020-04-03,10.0,-91.5,-10445.83,0.0,106.0,OKOYFIHH   ,0.0,0.0,9.0
10392,Luottojen_maksut,2020-04-04 09:21:57.073170729,2020-04-04,2020-04-04,2020-04-04,10.0,-1736.41,-12182.24,0.0,106.0,OKOYFIHH   ,1.0,0.0,34.0
10393,Ruoka_paivittaistavarakauppa,2020-04-06 20:29:16.097560972,2020-04-06,2020-04-06,2020-04-06,10.0,-2.17,-12184.41,0.0,162.0,           ,1.0,1.0,137.0
10394,Liikkuminen,2020-04-08 07:36:35.121951215,2020-04-08,2020-04-08,2020-04-08,10.0,-10.73,-12195.14,0.0,162.0,           ,1.0,1.0,150.0
10395,Luokittelemattomat,2020-04-09 18:43:54.146341458,2020-04-09,2020-04-09,2020-04-09,10.0,-36.48,-12231.62,706.0,129.0,OKOYFIHH   ,0.0,0.0,216.0
10396,Ruoka_paivittaistavarakauppa,2020-04-10 05:51:13.170731701,2020-04-10,2020-04-10,2020-04-09,10.0,-28.0,-12259.62,0.0,162.0,           ,1.0,1.0,153.0
10397,Vakuutukset,2020-04-13 16:58:32.195121944,2020-04-13,2020-04-13,2020-04-13,10.0,-20.48,-12280.1,706.0,106.0,OKOYFIHH   ,0.0,0.0,213.0
10398,Ruoka_paivittaistavarakauppa,2020-04-15 04:05:51.219512187,2020-04-15,2020-04-15,2020-04-15,10.0,-6.52,-12286.62,0.0,162.0,           ,1.0,1.0,144.0
10399,Ruoka_paivittaistavarakauppa,2020-04-16 02:20:29.268292673,2020-04-16,2020-04-16,2020-04-16,10.0,-6.56,-12293.18,0.0,162.0,           ,1.0,1.0,81.0
10400,Ruoka_paivittaistavarakauppa,2020-04-16 15:13:10.243902430,2020-04-16,2020-04-16,2020-04-16,10.0,-3.46,-12296.64,0.0,162.0,           ,1.0,1.0,155.0
10401,Ruoka_paivittaistavarakauppa,2020-04-17 13:27:48.292682916,2020-04-17,2020-04-17,2020-04-17,10.0,-4.78,-12301.42,0.0,162.0,           ,1.0,1.0,169.0
10402,Liikkuminen,2020-04-20 00:35:07.317073159,2020-04-20,2020-04-20,2020-04-20,10.0,-7.82,-12309.24,0.0,162.0,           ,1.0,1.0,100.0
10403,Ruoka_paivittaistavarakauppa,2020-04-21 11:42:26.341463402,2020-04-21,2020-04-21,2020-04-21,10.0,-5.99,-12315.23,0.0,162.0,           ,1.0,1.0,59.0
10404,Ruoka_paivittaistavarakauppa,2020-04-23 09:57:04.390243888,2020-04-23,2020-04-23,2020-04-23,10.0,-6.95,-12322.18,0.0,162.0,           ,1.0,1.0,123.0
10405,Muut,2020-04-23 22:49:45.365853645,2020-04-23,2020-04-23,2020-04-23,10.0,-22.75,-12344.93,0.0,163.0,           ,1.0,1.0,183.0
10406,Hyvinvointi,2020-04-27 08:11:42.439024374,2020-04-27,2020-04-27,2020-04-27,10.0,-97.26,-12442.19,706.0,129.0,OKOYFIHH   ,0.0,0.0,217.0
10407,Ruoka_paivittaistavarakauppa,2020-04-27 19:19:01.463414617,2020-04-27,2020-04-27,2020-04-27,10.0,-4.91,-12447.1,0.0,162.0,           ,1.0,1.0,140.0
10408,Luokittelemattomat,2020-04-27 21:04:23.414634131,2020-04-27,2020-04-27,2020-04-27,10.0,-1.23,-12448.33,0.0,162.0,           ,1.0,1.0,105.0
10409,Asuminen,2020-04-30 06:26:20.487804860,2020-04-30,2020-04-30,2020-04-30,10.0,-73.86,-12522.19,706.0,106.0,NDEAFIHH   ,0.0,0.0,214.0
10410,Tulot,2020-05-01 12:17:33.658536585,2020-05-01,2020-05-01,2020-05-01,10.0,32.48,-12489.71,0.0,576.0,           ,1.0,1.0,200.0
10411,Tulot,2020-05-04 00:35:07.317073170,2020-05-04,2020-05-04,2020-05-04,10.0,1313.64,-11176.07,701.0,520.0,           ,1.0,1.0,201.0
10412,Ravintolat_kahvilat,2020-05-05 12:52:40.975609755,2020-05-05,2020-05-05,2020-05-04,10.0,-5.98,-11182.05,0.0,162.0,           ,1.0,1.0,112.0
10413,Ruoka_paivittaistavarakauppa,2020-05-07 01:10:14.634146340,2020-05-07,2020-05-07,2020-05-07,10.0,-10.77,-11192.82,0.0,162.0,           ,1.0,1.0,145.0
10414,Tulot,2020-05-08 13:27:48.292682925,2020-05-08,2020-05-08,2020-05-08,10.0,8.01,-11184.81,0.0,505.0,           ,1.0,1.0,194.0
10415,Hyvinvointijakauneus,2020-05-11 01:45:21.951219510,2020-05-11,2020-05-11,2020-05-11,10.0,-10.54,-11195.35,0.0,162.0,           ,1.0,1.0,128.0
10416,Ruoka_paivittaistavarakauppa,2020-05-11 14:02:55.609756095,2020-05-11,2020-05-11,2020-05-11,10.0,-7.68,-11203.03,0.0,162.0,           ,1.0,1.0,137.0
10417,Ruoka_paivittaistavarakauppa,2020-05-13 14:38:02.926829265,2020-05-13,2020-05-13,2020-05-13,10.0,-0.54,-11203.57,0.0,162.0,           ,1.0,1.0,153.0
10418,Liikkuminen,2020-05-14 02:55:36.585365850,2020-05-14,2020-05-14,2020-05-14,10.0,-5.83,-11209.4,0.0,162.0,           ,1.0,1.0,145.0
10419,Luottojen_maksut,2020-05-15 02:20:29.268292680,2020-05-15,2020-05-15,2020-05-15,10.0,-158.95,-11368.35,706.0,129.0,OKOYFIHH   ,1.0,0.0,221.0
10420,Lemmikit,2020-05-18 15:13:10.243902435,2020-05-18,2020-05-18,2020-05-18,10.0,-5.43,-11373.78,0.0,162.0,           ,1.0,1.0,117.0
10421,Ruoka_paivittaistavarakauppa,2020-05-19 03:30:43.902439020,2020-05-19,2020-05-19,2020-05-19,10.0,-42.25,-11416.03,0.0,162.0,           ,1.0,1.0,131.0
10422,Asuminen,2020-05-19 15:48:17.560975605,2020-05-19,2020-05-19,2020-05-19,10.0,-18.67,-11434.7,706.0,129.0,OKOYFIHH   ,0.0,0.0,220.0
10423,Asuminen,2020-05-21 04:05:51.219512190,2020-05-21,2020-05-21,2020-05-21,10.0,-34.96,-11469.66,706.0,129.0,NDEAFIHH   ,0.0,0.0,219.0
10424,Lemmikit,2020-05-22 16:23:24.878048775,2020-05-22,2020-05-22,2020-05-22,10.0,-9.37,-11479.03,0.0,162.0,           ,1.0,1.0,156.0
10425,Luottojen_maksut,2020-05-25 04:40:58.536585360,2020-05-25,2020-05-25,2020-05-25,10.0,-218.91,-11697.94,706.0,129.0,OKOYFIHH   ,0.0,0.0,218.0
10426,Ruoka_paivittaistavarakauppa,2020-05-26 16:58:32.195121945,2020-05-26,2020-05-26,2020-05-26,10.0,-2.94,-11700.88,0.0,162.0,           ,1.0,1.0,143.0
10427,Ruoka_paivittaistavarakauppa,2020-05-28 05:16:05.853658530,2020-05-28,2020-05-28,2020-05-28,10.0,-0.99,-11701.87,0.0,162.0,           ,1.0,1.0,101.0
10428,Ruoka_paivittaistavarakauppa,2020-05-29 05:51:13.170731700,2020-05-29,2020-05-29,2020-05-29,10.0,-4.69,-11706.56,0.0,162.0,           ,1.0,1.0,145.0
10429,Asuminen,2020-05-29 17:33:39.512195115,2020-05-29,2020-05-29,2020-05-29,10.0,-30.08,-11736.64,706.0,129.0,OKOYFIHH   ,0.0,0.0,216.0
10430,Muut,2020-06-04 12:42:21.176470588,2020-06-04,2020-06-04,2020-06-04,10.0,-17.53,-11754.17,0.0,163.0,           ,1.0,1.0,183.0
10431,Lemmikit,2020-06-08 01:24:42.352941176,2020-06-08,2020-06-08,2020-06-08,10.0,-20.29,-11774.46,0.0,162.0,           ,1.0,1.0,97.0
10432,Tulot,2020-06-11 14:07:03.529411764,2020-06-11,2020-06-11,2020-06-11,10.0,980.47,-10793.99,701.0,520.0,           ,1.0,1.0,202.0
10433,Ruoka_paivittaistavarakauppa,2020-06-15 02:49:24.705882352,2020-06-15,2020-06-15,2020-06-15,10.0,-31.65,-10825.64,0.0,162.0,           ,1.0,1.0,47.0
10434,Liikkuminen,2020-06-18 15:31:45.882352940,2020-06-18,2020-06-18,2020-06-18,10.0,-12.77,-10838.41,0.0,106.0,OKOYFIHH   ,0.0,0.0,22.0
10435,Ruoka_paivittaistavarakauppa,2020-06-22 04:14:07.058823528,2020-06-22,2020-06-22,2020-06-22,10.0,-17.7,-10856.11,0.0,162.0,           ,1.0,1.0,90.0
10436,Lemmikit,2020-06-25 16:56:28.235294116,2020-06-25,2020-06-25,2020-06-25,10.0,-1.06,-10857.17,0.0,162.0,           ,1.0,1.0,96.0
10437,Liikkuminen,2020-06-29 05:38:49.411764704,2020-06-29,2020-06-29,2020-06-29,10.0,-11.93,-10869.1,0.0,162.0,           ,1.0,1.0,84.0
10438,Tulot,2020-07-03 07:06:40.000000000,2020-07-03,2020-07-03,2020-07-03,10.0,150.52,-10718.58,701.0,520.0,           ,1.0,1.0,204.0
10439,Saastot_sijoitukset,2020-07-06 14:13:20.000000000,2020-07-06,2020-07-06,2020-07-06,10.0,-1.58,-10720.16,0.0,162.0,           ,1.0,1.0,127.0
10440,Lemmikit,2020-07-07 21:20:00.000000000,2020-07-07,2020-07-07,2020-07-07,10.0,-16.74,-10736.9,0.0,162.0,           ,1.0,1.0,107.0
10441,Hyvinvointijakauneus,2020-07-10 04:26:40.000000000,2020-07-10,2020-07-10,2020-07-10,10.0,-38.42,-10775.32,706.0,106.0,OKOYFIHH   ,0.0,0.0,211.0
10442,Asuminen,2020-07-13 11:33:20.000000000,2020-07-13,2020-07-13,2020-07-13,10.0,-37.53,-10812.85,706.0,106.0,OKOYFIHH   ,0.0,0.0,210.0
10443,Terveys,2020-07-14 18:40:00.000000000,2020-07-14,2020-07-14,2020-07-14,10.0,-253.51,-11066.36,706.0,129.0,OKOYFIHH   ,0.0,0.0,221.0
10444,Vakuutukset,2020-07-15 01:46:40.000000000,2020-07-15,2020-07-15,2020-07-15,10.0,-9.49,-11075.85,706.0,129.0,OKOYFIHH   ,0.0,0.0,220.0
10445,Muut,2020-07-18 08:53:20.000000000,2020-07-18,2020-07-18,2020-07-18,10.0,-83.13,-11158.98,0.0,163.0,           ,1.0,1.0,183.0
10446,Ruoka_paivittaistavarakauppa,2020-07-20 16:00:00.000000000,2020-07-20,2020-07-20,2020-07-20,10.0,-15.34,-11174.32,0.0,162.0,           ,1.0,1.0,171.0
10447,Ruoka_paivittaistavarakauppa,2020-07-24 23:06:40.000000000,2020-07-24,2020-07-24,2020-07-24,10.0,-62.98,-11237.3,0.0,162.0,           ,1.0,1.0,125.0
10448,Ruoka_paivittaistavarakauppa,2020-07-27 06:13:20.000000000,2020-07-27,2020-07-27,2020-07-27,10.0,-8.43,-11245.73,0.0,162.0,           ,1.0,1.0,143.0
10449,Liikkuminen,2020-07-29 20:26:40.000000000,2020-07-29,2020-07-29,2020-07-29,10.0,-14.08,-11259.81,0.0,162.0,           ,1.0,1.0,164.0
10450,Ruoka_paivittaistavarakauppa,2020-07-30 13:20:00.000000000,2020-07-30,2020-07-30,2020-07-30,10.0,-5.12,-11264.93,0.0,162.0,           ,1.0,1.0,134.0
10451,Tulot,2020-08-03 16:12:58.378378378,2020-08-03,2020-08-03,2020-08-03,10.0,36.49,-11228.44,701.0,520.0,           ,1.0,1.0,203.0
10452,Asuminen,2020-08-04 08:25:56.756756756,2020-08-04,2020-08-04,2020-08-04,10.0,-64.14,-11292.58,706.0,129.0,OKOYFIHH   ,0.0,0.0,216.0
10453,Asuminen,2020-08-05 00:38:55.135135134,2020-08-05,2020-08-05,2020-08-05,10.0,-40.32,-11332.9,706.0,129.0,OKOYFIHH   ,0.0,0.0,217.0
10454,Ruoka_paivittaistavarakauppa,2020-08-07 16:51:53.513513512,2020-08-07,2020-08-07,2020-08-07,10.0,-6.32,-11339.22,0.0,162.0,           ,1.0,1.0,129.0
10455,Matkailu,2020-08-10 01:17:50.270270268,2020-08-10,2020-08-10,2020-08-10,10.0,-496.43,-11835.65,706.0,129.0,OKOYFIHH   ,1.0,0.0,217.0
10456,Ruoka_paivittaistavarakauppa,2020-08-10 09:04:51.891891890,2020-08-10,2020-08-10,2020-08-10,10.0,-5.09,-11840.74,0.0,162.0,           ,1.0,1.0,176.0
10457,Lapset,2020-08-11 17:30:48.648648646,2020-08-11,2020-08-11,2020-08-11,10.0,-14.72,-11855.46,0.0,162.0,           ,1.0,1.0,115.0
10458,Muut,2020-08-14 09:43:47.027027024,2020-08-14,2020-08-14,2020-08-14,10.0,-16.06,-11871.52,0.0,163.0,           ,1.0,1.0,183.0
10459,Tulot,2020-08-17 01:56:45.405405402,2020-08-17,2020-08-17,2020-08-17,10.0,618.01,-11253.51,701.0,520.0,           ,1.0,1.0,205.0
10460,Muut,2020-08-17 18:09:43.783783780,2020-08-17,2020-08-17,2020-08-17,10.0,-2.31,-11255.82,0.0,162.0,           ,1.0,1.0,121.0
10461,Muut,2020-08-19 10:22:42.162162158,2020-08-19,2020-08-19,2020-08-19,10.0,-34.41,-11290.23,706.0,129.0,DABAFIHH   ,0.0,0.0,219.0
10462,Ruoka_paivittaistavarakauppa,2020-08-21 02:35:40.540540536,2020-08-21,2020-08-21,2020-08-21,10.0,-12.43,-11302.66,0.0,162.0,           ,1.0,1.0,129.0
10463,Ruoka_paivittaistavarakauppa,2020-08-24 11:01:37.297297292,2020-08-24,2020-08-25,2020-08-24,10.0,-4.47,-11307.13,0.0,162.0,           ,1.0,1.0,124.0
10464,Ruoka_paivittaistavarakauppa,2020-08-24 18:48:38.918918914,2020-08-24,2020-08-24,2020-08-24,10.0,-15.35,-11322.48,0.0,162.0,           ,1.0,1.0,146.0
10465,Ravintolat_kahvilat,2020-08-26 03:14:35.675675670,2020-08-26,2020-08-26,2020-08-26,10.0,-7.54,-11330.02,0.0,162.0,           ,1.0,1.0,164.0
10466,Asuminen,2020-08-27 19:27:34.054054048,2020-08-27,2020-08-27,2020-08-27,10.0,-23.37,-11353.39,706.0,129.0,OKOYFIHH   ,0.0,0.0,222.0
10467,Luokittelemattomat,2020-08-28 11:40:32.432432426,2020-08-28,2020-08-28,2020-08-28,10.0,-118.56,-11471.95,706.0,129.0,OKOYFIHH   ,0.0,0.0,216.0
10468,Ruoka_paivittaistavarakauppa,2020-08-31 03:53:30.810810804,2020-08-31,2020-08-31,2020-08-31,10.0,-4.44,-11476.39,0.0,162.0,           ,1.0,1.0,145.0
10469,Tulot,2020-09-03 01:39:18.620689655,2020-09-03,2020-09-03,2020-09-03,10.0,350.41,-11125.98,701.0,520.0,           ,1.0,1.0,201.0
10470,Ruoka_paivittaistavarakauppa,2020-09-03 03:18:37.241379310,2020-09-03,2020-09-03,2020-09-03,10.0,-4.16,-11130.14,0.0,162.0,           ,1.0,1.0,123.0
10471,Matkailu,2020-09-07 04:57:55.862068965,2020-09-07,2020-09-07,2020-09-07,10.0,-23.56,-11153.7,706.0,106.0,DABAFIHH   ,0.0,0.0,209.0
10472,Ruoka_paivittaistavarakauppa,2020-09-07 06:37:14.482758620,2020-09-07,2020-09-07,2020-09-07,10.0,-17.91,-11171.61,0.0,162.0,           ,1.0,1.0,159.0
10473,Ruoka_paivittaistavarakauppa,2020-09-11 08:16:33.103448275,2020-09-11,2020-09-11,2020-09-11,10.0,-8.83,-11180.44,0.0,162.0,           ,1.0,1.0,157.0
10474,Luottojen_maksut,2020-09-11 09:55:51.724137930,2020-09-11,2020-09-11,2020-09-11,10.0,-228.99,-11409.43,706.0,106.0,DABAFIHH   ,0.0,0.0,210.0
10475,Hyvinvointi,2020-09-14 11:35:10.344827585,2020-09-14,2020-09-14,2020-09-14,10.0,-9.23,-11418.66,0.0,162.0,           ,1.0,1.0,48.0
10476,Muut,2020-09-18 13:14:28.965517240,2020-09-18,2020-09-18,2020-09-18,10.0,-9.27,-11427.93,0.0,163.0,           ,1.0,1.0,183.0
10477,Terveys,2020-09-18 14:53:47.586206895,2020-09-18,2020-09-18,2020-09-18,10.0,-14.0,-11441.93,0.0,162.0,           ,1.0,1.0,134.0
10478,Harrastukset,2020-09-21 16:33:06.206896550,2020-09-21,2020-09-21,2020-09-21,10.0,-1.4,-11443.33,0.0,162.0,           ,1.0,1.0,102.0
10479,Ruoka_paivittaistavarakauppa,2020-09-23 18:12:24.827586205,2020-09-23,2020-09-23,2020-09-23,10.0,-17.41,-11460.74,0.0,162.0,           ,1.0,1.0,150.0
10480,Lapset,2020-09-25 19:51:43.448275860,2020-09-25,2020-09-25,2020-09-25,10.0,-5.34,-11466.08,0.0,162.0,           ,1.0,1.0,159.0
10481,Tulot,2020-09-25 21:31:02.068965515,2020-09-25,2020-09-25,2020-09-25,10.0,135.44,-11330.64,710.0,506.0,           ,1.0,1.0,227.0
10482,Vakuutukset,2020-09-28 23:10:20.689655170,2020-09-28,2020-09-28,2020-09-28,10.0,-44.12,-11374.76,706.0,106.0,OKOYFIHH   ,0.0,0.0,210.0
10483,Tulot,2020-10-02 18:30:51.428571428,2020-10-02,2020-10-02,2020-10-02,10.0,231.81,-11142.95,701.0,520.0,           ,1.0,1.0,203.0
10484,Ruoka_paivittaistavarakauppa,2020-10-05 13:01:42.857142856,2020-10-05,2020-10-05,2020-10-05,10.0,-11.72,-11154.67,0.0,162.0,           ,1.0,1.0,83.0
10485,Luokittelemattomat,2020-10-06 07:32:34.285714284,2020-10-06,2020-10-06,2020-10-06,10.0,-11.05,-11165.72,706.0,106.0,OKOYFIHH   ,1.0,0.0,212.0
10486,Harrastukset,2020-10-07 02:03:25.714285712,2020-10-07,2020-10-07,2020-10-07,10.0,-2.65,-11168.37,0.0,162.0,           ,1.0,1.0,108.0
10487,Muut,2020-10-09 15:05:08.571428568,2020-10-09,2020-10-09,2020-10-09,10.0,-60.99,-11229.36,0.0,163.0,           ,1.0,1.0,184.0
10488,Ruoka_paivittaistavarakauppa,2020-10-09 20:34:17.142857140,2020-10-09,2020-10-09,2020-10-09,10.0,-17.45,-11246.81,0.0,162.0,           ,1.0,1.0,54.0
10489,Asuminen,2020-10-12 09:35:59.999999996,2020-10-12,2020-10-12,2020-10-12,10.0,-24.61,-11271.42,706.0,106.0,OKOYFIHH   ,0.0,0.0,209.0
10490,Ravintolat_kahvilat,2020-10-14 04:06:51.428571424,2020-10-14,2020-10-14,2020-10-14,10.0,-1.79,-11273.21,0.0,162.0,           ,1.0,1.0,149.0
10491,Vakuutukset,2020-10-16 22:37:42.857142852,2020-10-16,2020-10-16,2020-10-16,10.0,-46.69,-11319.9,706.0,106.0,NDEAFIHH   ,0.0,0.0,215.0
10492,Asuminen,2020-10-20 11:39:25.714285708,2020-10-20,2020-10-23,2020-10-20,10.0,-1.65,-11321.55,0.0,162.0,           ,1.0,1.0,173.0
10493,Luottojen_maksut,2020-10-20 17:08:34.285714280,2020-10-20,2020-10-20,2020-10-20,10.0,-111.99,-11433.54,706.0,106.0,NDEAFIHH   ,1.0,0.0,210.0
10494,Ruoka_paivittaistavarakauppa,2020-10-23 00:41:08.571428564,2020-10-23,2020-10-23,2020-10-23,10.0,-4.13,-11437.67,0.0,162.0,           ,1.0,1.0,135.0
10495,Tulot,2020-10-23 06:10:17.142857136,2020-10-23,2020-10-23,2020-10-23,10.0,698.4,-10739.27,0.0,506.0,           ,1.0,1.0,198.0
10496,Ruoka_paivittaistavarakauppa,2020-10-26 19:11:59.999999992,2020-10-26,2020-10-26,2020-10-26,10.0,-15.34,-10754.61,0.0,162.0,           ,1.0,1.0,95.0
10497,Ruoka_paivittaistavarakauppa,2020-10-27 08:13:42.857142848,2020-10-27,2020-10-27,2020-10-27,10.0,-10.11,-10764.72,0.0,162.0,           ,1.0,1.0,120.0
10498,Ruoka_paivittaistavarakauppa,2020-10-27 13:42:51.428571420,2020-10-27,2020-10-27,2020-10-27,10.0,-4.41,-10769.13,0.0,162.0,           ,1.0,1.0,112.0
10499,Ruoka_paivittaistavarakauppa,2020-10-29 02:44:34.285714276,2020-10-29,2020-10-29,2020-10-29,10.0,-4.31,-10773.44,0.0,162.0,           ,1.0,1.0,110.0
10500,Tulot,2020-11-02 22:27:05.806451612,2020-11-02,2020-11-02,2020-11-02,10.0,163.12,-10610.32,701.0,520.0,           ,1.0,1.0,203.0
10501,Luokittelemattomat,2020-11-04 20:54:11.612903224,2020-11-04,2020-11-04,2020-11-04,10.0,-4.18,-10614.5,706.0,106.0,NDEAFIHH   ,0.0,0.0,209.0
10502,Vakuutukset,2020-11-06 19:21:17.419354836,2020-11-06,2020-11-06,2020-11-06,10.0,-43.89,-10658.39,706.0,106.0,OKOYFIHH   ,0.0,0.0,212.0
10503,Luottojen_maksut,2020-11-09 17:48:23.225806448,2020-11-09,2020-11-09,2020-11-09,10.0,-1838.7,-12497.09,706.0,106.0,OKOYFIHH   ,1.0,0.0,214.0
10504,Saastot_sijoitukset,2020-11-10 16:15:29.032258060,2020-11-10,2020-11-10,2020-11-10,10.0,-7.84,-12504.93,0.0,162.0,           ,1.0,1.0,123.0
10505,Ruoka_paivittaistavarakauppa,2020-11-12 14:42:34.838709672,2020-11-12,2020-11-12,2020-11-12,10.0,-13.56,-12518.49,0.0,162.0,           ,1.0,1.0,58.0
10506,Ravintolat_kahvilat,2020-11-16 13:09:40.645161284,2020-11-16,2020-11-16,2020-11-16,10.0,-10.1,-12528.59,0.0,162.0,           ,1.0,1.0,144.0
10507,Muut,2020-11-17 11:36:46.451612896,2020-11-17,2020-11-17,2020-11-17,10.0,-26.49,-12555.08,0.0,163.0,           ,1.0,1.0,183.0
10508,Lapset,2020-11-18 10:03:52.258064508,2020-11-18,2020-11-19,2020-11-18,10.0,-5.34,-12560.42,0.0,162.0,           ,1.0,1.0,85.0
10509,Liikkuminen,2020-11-20 08:30:58.064516120,2020-11-20,2020-11-20,2020-11-20,10.0,-24.56,-12584.98,0.0,162.0,           ,1.0,1.0,109.0
10510,Ruoka_paivittaistavarakauppa,2020-11-23 06:58:03.870967732,2020-11-23,2020-11-23,2020-11-23,10.0,-16.62,-12601.6,0.0,162.0,           ,1.0,1.0,48.0
10511,Luokittelemattomat,2020-11-24 05:25:09.677419344,2020-11-24,2020-11-24,2020-11-24,10.0,-28.6,-12630.2,706.0,106.0,DABAFIHH   ,1.0,0.0,209.0
10512,Ruoka_paivittaistavarakauppa,2020-11-25 03:52:15.483870956,2020-11-25,2020-11-25,2020-11-25,10.0,-20.33,-12650.53,0.0,162.0,           ,1.0,1.0,47.0
10513,Liikkuminen,2020-11-26 02:19:21.290322568,2020-11-26,2020-11-26,2020-11-26,10.0,-28.62,-12679.15,0.0,162.0,           ,1.0,1.0,156.0
10514,Ravintolat_kahvilat,2020-11-30 00:46:27.096774180,2020-11-30,2020-11-30,2020-11-30,10.0,-0.86,-12680.01,0.0,162.0,           ,1.0,1.0,126.0
10515,Tulot,2020-12-02 16:12:58.378378378,2020-12-02,2020-12-02,2020-12-02,10.0,80.38,-12599.63,701.0,520.0,           ,1.0,1.0,201.0
10516,Hyvinvointijakauneus,2020-12-04 00:38:55.135135134,2020-12-04,2020-12-04,2020-12-04,10.0,-19.13,-12618.76,706.0,129.0,DABAFIHH   ,0.0,0.0,220.0
10517,Muut,2020-12-04 08:25:56.756756756,2020-12-04,2020-12-04,2020-12-04,10.0,-191.89,-12810.65,706.0,106.0,OKOYFIHH   ,0.0,0.0,209.0
10518,Muut,2020-12-07 16:51:53.513513512,2020-12-07,2020-12-07,2020-12-07,10.0,-3.36,-12814.01,0.0,162.0,           ,1.0,1.0,92.0
10519,Ruoka_paivittaistavarakauppa,2020-12-10 09:04:51.891891890,2020-12-10,2020-12-10,2020-12-10,10.0,-8.1,-12822.11,0.0,162.0,           ,1.0,1.0,130.0
10520,Shoppailu,2020-12-11 01:17:50.270270268,2020-12-11,2020-12-11,2020-12-11,10.0,-848.74,-13670.85,706.0,106.0,OKOYFIHH   ,0.0,0.0,212.0
10521,Ruoka_paivittaistavarakauppa,2020-12-11 17:30:48.648648646,2020-12-11,2020-12-11,2020-12-11,10.0,-17.19,-13688.04,0.0,162.0,           ,1.0,1.0,113.0
10522,Ruoka_paivittaistavarakauppa,2020-12-14 09:43:47.027027024,2020-12-14,2020-12-14,2020-12-14,10.0,-11.68,-13699.72,0.0,162.0,           ,1.0,1.0,56.0
10523,Matkailu,2020-12-15 01:56:45.405405402,2020-12-15,2020-12-15,2020-12-15,10.0,-6.65,-13706.37,0.0,162.0,           ,1.0,1.0,165.0
10524,Ravintolat_kahvilat,2020-12-16 18:09:43.783783780,2020-12-16,2020-12-16,2020-12-16,10.0,-6.64,-13713.01,0.0,162.0,           ,1.0,1.0,77.0
10525,Luokittelemattomat,2020-12-19 10:22:42.162162158,2020-12-19,2020-12-19,2020-12-19,10.0,-22.85,-13735.86,0.0,106.0,OKOYFIHH   ,1.0,0.0,17.0
10526,Lemmikit,2020-12-21 02:35:40.540540536,2020-12-21,2020-12-21,2020-12-21,10.0,-33.95,-13769.81,0.0,162.0,           ,1.0,1.0,67.0
10527,Luottojen_maksut,2020-12-22 18:48:38.918918914,2020-12-22,2020-12-22,2020-12-22,10.0,-2251.52,-16021.33,706.0,106.0,OKOYFIHH   ,0.0,0.0,211.0
10528,Muut,2020-12-24 11:01:37.297297292,2020-12-24,2020-12-24,2020-12-24,10.0,-33.0,-16054.33,0.0,164.0,           ,1.0,1.0,188.0
10529,Ravintolat_kahvilat,2020-12-28 03:14:35.675675670,2020-12-28,2020-12-30,2020-12-28,10.0,-12.79,-16067.12,0.0,162.0,           ,1.0,1.0,67.0
10530,Ravintolat_kahvilat,2020-12-28 19:27:34.054054048,2020-12-28,2020-12-28,2020-12-28,10.0,-3.2,-16070.32,0.0,162.0,           ,1.0,1.0,112.0
10531,Muut,2020-12-29 11:40:32.432432426,2020-12-29,2020-12-29,2020-12-29,10.0,-10.93,-16081.25,0.0,163.0,           ,1.0,1.0,185.0
10532,Hyvinvointijakauneus,2020-12-31 03:53:30.810810804,2020-12-31,2020-12-31,2020-12-31,10.0,-11.95,-16093.2,0.0,162.0,           ,1.0,1.0,81.0
10533,Terveys,2019-01-01 00:00:00.000000000,2019-01-01,2019-01-01,2019-01-01,11.0,-32.57,4950.58,0.0,162.0,           ,1.0,1.0,106.0
10534,Luokittelemattomat,2019-01-08 15:16:21.818181818,2019-01-08,2019-01-08,2019-01-08,11.0,-329.74,4620.84,0.0,106.0,NDEAFIHH   ,0.0,0.0,8.0
10535,Tulot,2019-01-14 06:32:43.636363636,2019-01-14,2019-01-14,2019-01-14,11.0,1483.57,6104.41,701.0,510.0,           ,1.0,1.0,141.0
10536,Ravintolat_kahvilat,2019-01-18 21:49:05.454545454,2019-01-18,2019-01-18,2019-01-18,11.0,-12.25,6092.16,0.0,162.0,           ,1.0,1.0,67.0
10537,Ruoka_paivittaistavarakauppa,2019-01-24 13:05:27.272727272,2019-01-24,2019-01-25,2019-01-24,11.0,-87.15,6005.01,0.0,162.0,           ,1.0,1.0,79.0
10538,Ravintolat_kahvilat,2019-01-28 04:21:49.090909090,2019-01-28,2019-01-28,2019-01-28,11.0,-70.5,5934.51,0.0,162.0,           ,1.0,1.0,110.0
10539,Ruoka_paivittaistavarakauppa,2019-02-12 04:48:00.000000000,2019-02-12,2019-02-12,2019-02-12,11.0,-20.51,5914.0,0.0,162.0,           ,1.0,1.0,100.0
10540,Luottojen_maksut,2019-02-22 09:36:00.000000000,2019-02-22,2019-02-22,2019-02-22,11.0,-55.17,5858.83,0.0,162.0,           ,1.0,1.0,51.0
10541,Ruoka_paivittaistavarakauppa,2019-03-07 21:20:00.000000000,2019-03-07,2019-03-07,2019-03-07,11.0,-4.75,5854.08,0.0,162.0,           ,1.0,1.0,120.0
10542,Liikkuminen,2019-03-14 18:40:00.000000000,2019-03-14,2019-03-14,2019-03-14,11.0,-29.51,5824.57,0.0,162.0,           ,1.0,1.0,64.0
10543,Harrastukset,2019-03-22 16:00:00.000000000,2019-03-22,2019-03-22,2019-03-22,11.0,-4.9,5819.67,0.0,162.0,           ,1.0,1.0,66.0
10544,Luottojen_maksut,2019-03-28 13:20:00.000000000,2019-03-28,2019-03-28,2019-03-27,11.0,-32.94,5786.73,0.0,162.0,           ,1.0,1.0,42.0
10545,Tulot,2019-05-10 20:34:17.142857142,2019-05-10,2019-05-10,2019-05-10,11.0,92.78,5879.51,701.0,524.0,           ,1.0,1.0,146.0
10546,Matkailu,2019-05-20 17:08:34.285714284,2019-05-20,2019-05-21,2019-05-20,11.0,-39.25,5840.26,0.0,162.0,           ,1.0,1.0,101.0
10547,Asuminen,2019-05-27 13:42:51.428571426,2019-05-27,2019-05-27,2019-05-27,11.0,-77.1,5763.16,0.0,162.0,           ,1.0,1.0,17.0
10548,Terveys,2019-06-07 16:00:00.000000000,2019-06-07,2019-06-07,2019-06-07,11.0,-219.85,5543.31,0.0,162.0,           ,1.0,1.0,81.0
10549,Ruoka_paivittaistavarakauppa,2019-06-13 08:00:00.000000000,2019-06-13,2019-06-13,2019-06-13,11.0,-74.44,5468.87,0.0,162.0,           ,1.0,1.0,82.0
10550,Ravintolat_kahvilat,2019-06-21 00:00:00.000000000,2019-06-21,2019-06-21,2019-06-21,11.0,-6.22,5462.65,0.0,162.0,           ,1.0,1.0,46.0
10551,Ruoka_paivittaistavarakauppa,2019-06-27 16:00:00.000000000,2019-06-27,2019-06-27,2019-06-27,11.0,-11.83,5450.82,0.0,162.0,           ,1.0,1.0,15.0
10552,Tulot,2019-07-06 20:34:17.142857142,2019-07-06,2019-07-06,2019-07-06,11.0,5.03,5455.85,0.0,563.0,           ,1.0,1.0,140.0
10553,Matkailu,2019-07-18 17:08:34.285714284,2019-07-18,2019-07-18,2019-07-17,11.0,-24.26,5431.59,0.0,162.0,           ,1.0,1.0,104.0
10554,Ruoka_paivittaistavarakauppa,2019-07-25 13:42:51.428571426,2019-07-25,2019-07-25,2019-07-25,11.0,-6.77,5424.82,0.0,162.0,           ,1.0,1.0,43.0
10555,Muut,2019-08-09 20:34:17.142857142,2019-08-09,2019-08-09,2019-08-09,11.0,-11.93,5412.89,0.0,162.0,           ,1.0,1.0,37.0
10556,Ruoka_paivittaistavarakauppa,2019-08-19 17:08:34.285714284,2019-08-19,2019-08-19,2019-08-19,11.0,-2.08,5410.81,0.0,162.0,           ,1.0,1.0,103.0
10557,Luokittelemattomat,2019-08-27 13:42:51.428571426,2019-08-27,2019-08-27,2019-08-27,11.0,-10.2,5400.61,0.0,162.0,           ,1.0,1.0,95.0
10558,Ruoka_paivittaistavarakauppa,2019-09-03 20:34:17.142857142,2019-09-03,2019-09-05,2019-09-03,11.0,-13.76,5386.85,0.0,162.0,           ,1.0,1.0,51.0
10559,Ravintolat_kahvilat,2019-09-05 17:08:34.285714284,2019-09-05,2019-09-05,2019-09-05,11.0,-10.4,5376.45,0.0,162.0,           ,1.0,1.0,107.0
10560,Shoppailu,2019-09-09 13:42:51.428571426,2019-09-09,2019-09-09,2019-09-09,11.0,-23.19,5353.26,0.0,162.0,           ,1.0,1.0,34.0
10561,Ruoka_paivittaistavarakauppa,2019-09-12 10:17:08.571428568,2019-09-12,2019-09-12,2019-09-12,11.0,-34.6,5318.66,0.0,162.0,           ,1.0,1.0,48.0
10562,Muut,2019-09-16 06:51:25.714285710,2019-09-16,2019-09-16,2019-09-16,11.0,-12.65,5306.01,0.0,162.0,           ,1.0,1.0,74.0
10563,Ruoka_paivittaistavarakauppa,2019-09-18 03:25:42.857142852,2019-09-18,2019-09-18,2019-09-18,11.0,-9.18,5296.83,0.0,162.0,           ,1.0,1.0,37.0
10564,Lemmikit,2019-09-20 23:59:59.999999994,2019-09-20,2019-09-20,2019-09-20,11.0,-111.33,5185.5,0.0,162.0,           ,1.0,1.0,86.0
10565,Ruoka_paivittaistavarakauppa,2019-09-23 20:34:17.142857136,2019-09-23,2019-09-23,2019-09-23,11.0,-3.95,5181.55,0.0,162.0,           ,1.0,1.0,125.0
10566,Tulot,2019-09-25 17:08:34.285714278,2019-09-25,2019-09-25,2019-09-25,11.0,7.46,5189.01,0.0,506.0,           ,1.0,1.0,138.0
10567,Liikkuminen,2019-09-30 13:42:51.428571420,2019-09-30,2019-09-30,2019-09-30,11.0,-15.37,5173.64,0.0,162.0,           ,1.0,1.0,76.0
10568,Ruoka_paivittaistavarakauppa,2019-10-09 20:34:17.142857142,2019-10-09,2019-10-09,2019-10-08,11.0,-21.58,5152.06,0.0,162.0,           ,1.0,1.0,73.0
10569,Ruoka_paivittaistavarakauppa,2019-10-18 17:08:34.285714284,2019-10-18,2019-10-18,2019-10-18,11.0,-23.24,5128.82,0.0,162.0,           ,1.0,1.0,45.0
10570,Liikkuminen,2019-10-29 13:42:51.428571426,2019-10-29,2019-10-29,2019-10-29,11.0,-37.33,5091.49,0.0,162.0,           ,1.0,1.0,51.0
10571,Ruoka_paivittaistavarakauppa,2019-11-21 00:00:00.000000000,2019-11-21,2019-11-21,2019-11-21,11.0,-29.87,5061.62,0.0,162.0,           ,1.0,1.0,82.0
10572,Muut,2019-12-05 21:42:51.428571428,2019-12-05,2019-12-05,2019-12-05,11.0,-17.54,5044.08,0.0,156.0,           ,1.0,1.0,14.0
10573,Tulot,2019-12-05 22:51:25.714285714,2019-12-05,2019-12-05,2019-12-05,11.0,5.87,5049.95,0.0,563.0,           ,1.0,1.0,140.0
10574,Muut,2019-12-09 20:34:17.142857142,2019-12-09,2019-12-09,2019-12-09,11.0,-63.84,4986.11,0.0,163.0,           ,1.0,1.0,127.0
10575,Liikkuminen,2019-12-12 19:25:42.857142856,2019-12-12,2019-12-12,2019-12-12,11.0,-92.51,4893.6,0.0,162.0,           ,1.0,1.0,30.0
10576,Ruoka_paivittaistavarakauppa,2019-12-16 18:17:08.571428570,2019-12-16,2019-12-16,2019-12-16,11.0,-46.25,4847.35,0.0,162.0,           ,1.0,1.0,45.0
10577,Ruoka_paivittaistavarakauppa,2019-12-18 17:08:34.285714284,2019-12-18,2019-12-18,2019-12-18,11.0,-2.67,4844.68,0.0,162.0,           ,1.0,1.0,82.0
10578,Lapset,2019-12-20 15:59:59.999999998,2019-12-20,2019-12-20,2019-12-20,11.0,-41.1,4803.58,0.0,162.0,           ,1.0,1.0,117.0
10579,Luokittelemattomat,2019-12-23 14:51:25.714285712,2019-12-23,2019-12-23,2019-12-23,11.0,-3.36,4800.22,0.0,162.0,           ,1.0,1.0,113.0
10580,Kulttuuri_viihde,2019-12-27 13:42:51.428571426,2019-12-27,2019-12-27,2019-12-27,11.0,-86.85,4713.37,706.0,147.0,OKOYFIHH   ,0.0,0.0,154.0
10581,Ravintolat_kahvilat,2019-12-30 12:34:17.142857140,2019-12-30,2019-12-31,2019-12-30,11.0,-42.72,4670.65,0.0,162.0,           ,1.0,1.0,113.0
10582,Ruoka_paivittaistavarakauppa,2020-01-02 16:12:58.378378378,2020-01-02,2020-01-02,2020-01-02,11.0,-6.9,4663.75,0.0,162.0,           ,1.0,1.0,88.0
10583,Ruoka_paivittaistavarakauppa,2020-01-03 08:25:56.756756756,2020-01-03,2020-01-03,2020-01-03,11.0,-7.05,4656.7,0.0,162.0,           ,1.0,1.0,54.0
10584,Liikkuminen,2020-01-06 00:38:55.135135134,2020-01-06,2020-01-06,2020-01-06,11.0,-20.76,4635.94,0.0,162.0,           ,1.0,1.0,82.0
10585,Ravintolat_kahvilat,2020-01-07 16:51:53.513513512,2020-01-07,2020-01-07,2020-01-07,11.0,-87.0,4548.94,0.0,162.0,           ,1.0,1.0,76.0
10586,Ruoka_paivittaistavarakauppa,2020-01-09 09:04:51.891891890,2020-01-09,2020-01-09,2020-01-09,11.0,-68.44,4480.5,0.0,162.0,           ,1.0,1.0,71.0
10587,Ruoka_paivittaistavarakauppa,2020-01-10 01:17:50.270270268,2020-01-10,2020-01-10,2020-01-10,11.0,-9.04,4471.46,0.0,162.0,           ,1.0,1.0,71.0
10588,Matkailu,2020-01-12 17:30:48.648648646,2020-01-12,2020-01-12,2020-01-12,11.0,-49.29,4422.17,0.0,106.0,OKOYFIHH   ,1.0,0.0,10.0
10589,Shoppailu,2020-01-14 09:43:47.027027024,2020-01-14,2020-01-14,2020-01-14,11.0,-30.65,4391.52,0.0,162.0,           ,1.0,1.0,77.0
10590,Luottojen_maksut,2020-01-16 01:56:45.405405402,2020-01-16,2020-01-16,2020-01-16,11.0,-13.06,4378.46,0.0,162.0,           ,1.0,1.0,69.0
10591,Tulot,2020-01-17 18:09:43.783783780,2020-01-17,2020-01-17,2020-01-17,11.0,35.87,4414.33,710.0,506.0,           ,1.0,1.0,159.0
10592,Ruoka_paivittaistavarakauppa,2020-01-20 02:35:40.540540536,2020-01-20,2020-01-20,2020-01-20,11.0,-35.42,4378.91,0.0,162.0,           ,1.0,1.0,52.0
10593,Ravintolat_kahvilat,2020-01-20 10:22:42.162162158,2020-01-20,2020-01-20,2020-01-20,11.0,-4.66,4374.25,0.0,162.0,           ,1.0,1.0,33.0
10594,Ravintolat_kahvilat,2020-01-21 18:48:38.918918914,2020-01-21,2020-01-21,2020-01-21,11.0,-7.8,4366.45,0.0,162.0,           ,1.0,1.0,30.0
10595,Muut,2020-01-24 11:01:37.297297292,2020-01-24,2020-01-24,2020-01-24,11.0,-144.29,4222.16,0.0,162.0,           ,1.0,1.0,49.0
10596,Liikkuminen,2020-01-27 03:14:35.675675670,2020-01-27,2020-01-29,2020-01-27,11.0,-3.34,4218.82,0.0,162.0,           ,1.0,1.0,20.0
10597,Matkailu,2020-01-27 19:27:34.054054048,2020-01-27,2020-01-27,2020-01-27,11.0,-88.39,4130.43,0.0,162.0,           ,1.0,1.0,105.0
10598,Matkailu,2020-01-30 03:53:30.810810804,2020-01-30,2020-01-30,2020-01-30,11.0,-305.76,3824.67,0.0,162.0,           ,1.0,1.0,104.0
10599,Ruoka_paivittaistavarakauppa,2020-01-30 11:40:32.432432426,2020-01-30,2020-01-30,2020-01-30,11.0,-18.28,3806.39,0.0,162.0,           ,1.0,1.0,50.0
10600,Tulot,2020-02-03 08:22:19.534883720,2020-02-03,2020-02-03,2020-02-03,11.0,601.31,4407.7,710.0,506.0,           ,1.0,1.0,156.0
10601,Ruoka_paivittaistavarakauppa,2020-02-03 16:44:39.069767440,2020-02-03,2020-02-03,2020-02-03,11.0,-4.61,4403.09,0.0,162.0,           ,1.0,1.0,45.0
10602,Ruoka_paivittaistavarakauppa,2020-02-04 01:06:58.604651160,2020-02-04,2020-02-04,2020-02-04,11.0,-115.0,4288.09,0.0,162.0,           ,1.0,1.0,33.0
10603,Shoppailu,2020-02-04 09:29:18.139534880,2020-02-04,2020-02-04,2020-02-04,11.0,-2.49,4285.6,0.0,162.0,           ,1.0,1.0,16.0
10604,Ravintolat_kahvilat,2020-02-07 17:51:37.674418600,2020-02-07,2020-02-07,2020-02-07,11.0,-58.5,4227.1,0.0,162.0,           ,1.0,1.0,51.0
10605,Shoppailu,2020-02-10 02:13:57.209302320,2020-02-10,2020-02-10,2020-02-10,11.0,-26.34,4200.76,0.0,162.0,           ,1.0,1.0,79.0
10606,Ruoka_paivittaistavarakauppa,2020-02-10 10:36:16.744186040,2020-02-10,2020-02-10,2020-02-10,11.0,-10.85,4189.91,0.0,162.0,           ,1.0,1.0,58.0
10607,Ruoka_paivittaistavarakauppa,2020-02-11 18:58:36.279069760,2020-02-11,2020-02-11,2020-02-11,11.0,-14.98,4174.93,0.0,162.0,           ,1.0,1.0,16.0
10608,Liikkuminen,2020-02-14 03:20:55.813953480,2020-02-14,2020-02-14,2020-02-14,11.0,-3.67,4171.26,0.0,162.0,           ,1.0,1.0,41.0
10609,Tulot,2020-02-14 11:43:15.348837200,2020-02-14,2020-02-14,2020-02-14,11.0,69.05,4240.31,710.0,506.0,           ,1.0,1.0,158.0
10610,Tulot,2020-02-15 20:05:34.883720920,2020-02-15,2020-02-15,2020-02-15,11.0,3062.82,7303.13,0.0,505.0,           ,1.0,1.0,132.0
10611,Muut,2020-02-17 04:27:54.418604640,2020-02-17,2020-02-17,2020-02-17,11.0,-30.92,7272.21,0.0,163.0,           ,1.0,1.0,126.0
10612,Ruoka_paivittaistavarakauppa,2020-02-18 12:50:13.953488360,2020-02-18,2020-02-18,2020-02-18,11.0,-29.09,7243.12,0.0,162.0,           ,1.0,1.0,26.0
10613,Ruoka_paivittaistavarakauppa,2020-02-19 21:12:33.488372080,2020-02-19,2020-02-19,2020-02-19,11.0,-6.84,7236.28,0.0,162.0,           ,1.0,1.0,70.0
10614,Ravintolat_kahvilat,2020-02-20 05:34:53.023255800,2020-02-20,2020-02-20,2020-02-20,11.0,-110.63,7125.65,0.0,162.0,           ,1.0,1.0,99.0
10615,Ravintolat_kahvilat,2020-02-20 13:57:12.558139520,2020-02-20,2020-02-20,2020-02-20,11.0,-31.48,7094.17,0.0,162.0,           ,1.0,1.0,105.0
10616,Ruoka_paivittaistavarakauppa,2020-02-24 06:41:51.627906960,2020-02-24,2020-02-24,2020-02-24,11.0,-21.6,7072.57,0.0,162.0,           ,1.0,1.0,112.0
10617,Liikkuminen,2020-02-24 22:19:32.093023240,2020-02-24,2020-02-24,2020-02-24,11.0,-14.46,7058.11,0.0,162.0,           ,1.0,1.0,45.0
10618,Tulot,2020-02-27 15:04:11.162790680,2020-02-27,2020-02-27,2020-02-27,11.0,451.77,7509.88,0.0,505.0,           ,1.0,1.0,134.0
10619,Ruoka_paivittaistavarakauppa,2020-02-27 23:26:30.697674400,2020-02-27,2020-02-27,2020-02-27,11.0,-76.32,7433.56,0.0,162.0,           ,1.0,1.0,65.0
10620,Ruoka_paivittaistavarakauppa,2020-02-28 07:48:50.232558120,2020-02-28,2020-02-28,2020-02-28,11.0,-41.26,7392.3,0.0,162.0,           ,1.0,1.0,73.0
10621,Luokittelemattomat,2020-03-02 06:03:38.181818180,2020-03-02,2020-03-02,2020-03-02,11.0,-32.43,7359.87,0.0,162.0,           ,1.0,1.0,66.0
10622,Tulot,2020-03-02 15:01:49.090909090,2020-03-02,2020-03-03,2020-03-02,11.0,278.06,7637.93,0.0,505.0,           ,1.0,1.0,133.0
10623,Muut,2020-03-02 21:05:27.272727270,2020-03-02,2020-03-02,2020-03-02,11.0,-37.9,7600.03,0.0,163.0,           ,1.0,1.0,127.0
10624,Terveys,2020-03-03 12:07:16.363636360,2020-03-03,2020-03-03,2020-03-03,11.0,-13.11,7586.92,0.0,162.0,           ,1.0,1.0,90.0
10625,Tulot,2020-03-04 03:09:05.454545450,2020-03-04,2020-03-05,2020-03-04,11.0,687.85,8274.77,710.0,506.0,           ,1.0,1.0,161.0
10626,Muut,2020-03-04 18:10:54.545454540,2020-03-04,2020-03-04,2020-03-04,11.0,-62.99,8211.78,0.0,101.0,           ,1.0,1.0,0.0
10627,Ruoka_paivittaistavarakauppa,2020-03-05 09:12:43.636363630,2020-03-05,2020-03-05,2020-03-05,11.0,-13.86,8197.92,0.0,162.0,           ,1.0,1.0,66.0
10628,Ruoka_paivittaistavarakauppa,2020-03-05 21:19:59.999999990,2020-03-05,2020-03-05,2020-03-05,11.0,-19.51,8178.41,0.0,162.0,           ,1.0,1.0,46.0
10629,Tulot,2020-03-06 00:14:32.727272720,2020-03-06,2020-03-06,2020-03-06,11.0,2655.29,10833.7,710.0,506.0,           ,1.0,1.0,161.0
10630,Terveys,2020-03-06 15:16:21.818181810,2020-03-06,2020-03-06,2020-03-06,11.0,-20.12,10813.58,0.0,106.0,OKOYFIHH   ,0.0,0.0,3.0
10631,Ravintolat_kahvilat,2020-03-09 03:23:38.181818170,2020-03-09,2020-03-12,2020-03-09,11.0,-10.8,10802.78,0.0,162.0,           ,1.0,1.0,55.0
10632,Ruoka_paivittaistavarakauppa,2020-03-09 06:18:10.909090900,2020-03-09,2020-03-11,2020-03-09,11.0,-5.16,10797.62,0.0,162.0,           ,1.0,1.0,111.0
10633,Shoppailu,2020-03-09 18:25:27.272727260,2020-03-09,2020-03-09,2020-03-09,11.0,-62.42,10735.2,0.0,162.0,           ,1.0,1.0,24.0
10634,Ruoka_paivittaistavarakauppa,2020-03-10 09:27:16.363636350,2020-03-10,2020-03-10,2020-03-10,11.0,-12.47,10722.73,0.0,162.0,           ,1.0,1.0,46.0
10635,Ruoka_paivittaistavarakauppa,2020-03-10 12:21:49.090909080,2020-03-10,2020-03-10,2020-03-10,11.0,-19.68,10703.05,0.0,162.0,           ,1.0,1.0,120.0
10636,Shoppailu,2020-03-11 15:30:54.545454530,2020-03-11,2020-03-11,2020-03-11,11.0,-22.95,10680.1,0.0,162.0,           ,1.0,1.0,68.0
10637,Ruoka_paivittaistavarakauppa,2020-03-12 00:29:05.454545440,2020-03-12,2020-03-13,2020-03-12,11.0,-7.2,10672.9,0.0,162.0,           ,1.0,1.0,100.0
10638,Liikkuminen,2020-03-12 06:32:43.636363620,2020-03-12,2020-03-13,2020-03-12,11.0,-10.77,10662.13,0.0,162.0,           ,1.0,1.0,82.0
10639,Terveys,2020-03-12 21:34:32.727272710,2020-03-12,2020-03-12,2020-03-12,11.0,-474.7,10187.43,0.0,162.0,           ,1.0,1.0,67.0
10640,Lapset,2020-03-13 03:38:10.909090890,2020-03-13,2020-03-13,2020-03-13,11.0,-13.44,10173.99,0.0,162.0,           ,1.0,1.0,51.0
10641,Liikkuminen,2020-03-13 09:41:49.090909070,2020-03-13,2020-03-13,2020-03-13,11.0,-14.07,10159.92,0.0,162.0,           ,1.0,1.0,30.0
10642,Kulttuuri_viihde,2020-03-13 12:36:21.818181800,2020-03-13,2020-03-13,2020-03-13,11.0,-43.25,10116.67,0.0,162.0,           ,1.0,1.0,80.0
10643,Liikkuminen,2020-03-16 00:43:38.181818160,2020-03-16,2020-03-16,2020-03-16,11.0,-29.04,10087.63,0.0,162.0,           ,1.0,1.0,27.0
10644,Luokittelemattomat,2020-03-16 06:47:16.363636340,2020-03-16,2020-03-16,2020-03-16,11.0,-19.88,10067.75,0.0,162.0,           ,1.0,1.0,124.0
10645,Ruoka_paivittaistavarakauppa,2020-03-16 15:45:27.272727250,2020-03-16,2020-03-16,2020-03-16,11.0,-73.31,9994.44,0.0,162.0,           ,1.0,1.0,59.0
10646,Ruoka_paivittaistavarakauppa,2020-03-16 18:39:59.999999980,2020-03-16,2020-03-16,2020-03-16,11.0,-2.28,9992.16,0.0,162.0,           ,1.0,1.0,46.0
10647,Muut,2020-03-17 21:49:05.454545430,2020-03-17,2020-03-17,2020-03-17,11.0,-134.02,9858.14,0.0,163.0,           ,1.0,1.0,126.0
10648,Liikkuminen,2020-03-18 12:50:54.545454520,2020-03-18,2020-03-18,2020-03-18,11.0,-124.98,9733.16,0.0,162.0,           ,1.0,1.0,37.0
10649,Ravintolat_kahvilat,2020-03-19 03:52:43.636363610,2020-03-19,2020-03-19,2020-03-19,11.0,-4.36,9728.8,0.0,162.0,           ,1.0,1.0,51.0
10650,Liikkuminen,2020-03-19 18:54:32.727272700,2020-03-19,2020-03-19,2020-03-19,11.0,-17.32,9711.48,0.0,162.0,           ,1.0,1.0,123.0
10651,Liikkuminen,2020-03-20 00:58:10.909090880,2020-03-20,2020-03-20,2020-03-20,11.0,-103.09,9608.39,0.0,162.0,           ,1.0,1.0,101.0
10652,Muut,2020-03-20 09:56:21.818181790,2020-03-20,2020-03-20,2020-03-20,11.0,-173.68,9434.71,0.0,163.0,           ,1.0,1.0,126.0
10653,Ruoka_paivittaistavarakauppa,2020-03-20 15:59:59.999999970,2020-03-20,2020-03-20,2020-03-20,11.0,-3.43,9431.28,0.0,162.0,           ,1.0,1.0,94.0
10654,Ruoka_paivittaistavarakauppa,2020-03-23 04:07:16.363636330,2020-03-23,2020-03-23,2020-03-23,11.0,-69.75,9361.53,0.0,162.0,           ,1.0,1.0,16.0
10655,Ravintolat_kahvilat,2020-03-23 07:01:49.090909060,2020-03-23,2020-03-23,2020-03-23,11.0,-9.17,9352.36,0.0,162.0,           ,1.0,1.0,96.0
10656,Tulot,2020-03-23 13:05:27.272727240,2020-03-23,2020-03-23,2020-03-23,11.0,1789.08,11141.44,0.0,505.0,           ,1.0,1.0,132.0
10657,Ruoka_paivittaistavarakauppa,2020-03-23 19:09:05.454545420,2020-03-23,2020-03-23,2020-03-23,11.0,-29.49,11111.95,0.0,162.0,           ,1.0,1.0,57.0
10658,Lemmikit,2020-03-23 22:03:38.181818150,2020-03-23,2020-03-23,2020-03-23,11.0,-18.22,11093.73,0.0,162.0,           ,1.0,1.0,61.0
10659,Ruoka_paivittaistavarakauppa,2020-03-26 01:12:43.636363600,2020-03-26,2020-03-26,2020-03-26,11.0,-27.54,11066.19,0.0,162.0,           ,1.0,1.0,119.0
10660,Terveys,2020-03-26 10:10:54.545454510,2020-03-26,2020-03-26,2020-03-26,11.0,-11.84,11054.35,0.0,162.0,           ,1.0,1.0,86.0
10661,Tulot,2020-03-26 16:14:32.727272690,2020-03-26,2020-03-26,2020-03-26,11.0,372.87,11427.22,710.0,506.0,           ,1.0,1.0,157.0
10662,Ravintolat_kahvilat,2020-03-27 07:16:21.818181780,2020-03-27,2020-03-27,2020-03-27,11.0,-44.15,11383.07,0.0,162.0,           ,1.0,1.0,32.0
10663,Liikkuminen,2020-03-27 22:18:10.909090870,2020-03-27,2020-03-27,2020-03-27,11.0,-3.28,11379.79,0.0,162.0,           ,1.0,1.0,37.0
10664,Ruoka_paivittaistavarakauppa,2020-03-30 01:27:16.363636320,2020-03-30,2020-03-30,2020-03-30,11.0,-28.63,11351.16,0.0,162.0,           ,1.0,1.0,22.0
10665,Ruoka_paivittaistavarakauppa,2020-03-30 04:21:49.090909050,2020-03-30,2020-03-30,2020-03-30,11.0,-5.66,11345.5,0.0,162.0,           ,1.0,1.0,107.0
10666,Ruoka_paivittaistavarakauppa,2020-03-30 13:19:59.999999960,2020-03-30,2020-03-30,2020-03-30,11.0,-27.34,11318.16,0.0,162.0,           ,1.0,1.0,38.0
10667,Muut,2020-03-31 10:25:27.272727230,2020-03-31,2020-03-31,2020-03-31,11.0,-125.44,11192.72,0.0,163.0,           ,1.0,1.0,126.0
10668,Tulot,2020-03-31 16:29:05.454545410,2020-03-31,2020-03-31,2020-03-31,11.0,3618.97,14811.69,710.0,506.0,           ,1.0,1.0,158.0
10669,Asuminen,2020-03-31 19:23:38.181818140,2020-03-31,2020-03-31,2020-03-31,11.0,-43.37,14768.32,0.0,162.0,           ,1.0,1.0,24.0
10670,Liikkuminen,2020-04-02 11:07:19.024390243,2020-04-02,2020-04-02,2020-04-02,11.0,-53.64,14714.68,0.0,162.0,           ,1.0,1.0,97.0
10671,Tulot,2020-04-03 09:21:57.073170729,2020-04-03,2020-04-03,2020-04-03,11.0,252.1,14966.78,710.0,506.0,           ,1.0,1.0,160.0
10672,Shoppailu,2020-04-03 22:14:38.048780486,2020-04-03,2020-04-03,2020-04-03,11.0,-10.26,14956.52,0.0,162.0,           ,1.0,1.0,82.0
10673,Saastot_sijoitukset,2020-04-06 20:29:16.097560972,2020-04-06,2020-04-06,2020-04-06,11.0,-141.6,14814.92,0.0,162.0,           ,1.0,1.0,48.0
10674,Tulot,2020-04-09 05:51:13.170731701,2020-04-09,2020-04-09,2020-04-09,11.0,670.82,15485.74,710.0,506.0,           ,1.0,1.0,158.0
10675,Muut,2020-04-09 07:36:35.121951215,2020-04-09,2020-04-09,2020-04-09,11.0,-38.19,15447.55,0.0,162.0,           ,1.0,1.0,101.0
10676,Ruoka_paivittaistavarakauppa,2020-04-09 18:43:54.146341458,2020-04-09,2020-04-09,2020-04-09,11.0,-14.63,15432.92,0.0,162.0,           ,1.0,1.0,94.0
10677,Ruoka_paivittaistavarakauppa,2020-04-13 04:05:51.219512187,2020-04-13,2020-04-13,2020-04-13,11.0,-16.25,15416.67,0.0,162.0,           ,1.0,1.0,26.0
10678,Ravintolat_kahvilat,2020-04-13 16:58:32.195121944,2020-04-13,2020-04-13,2020-04-13,11.0,-13.05,15403.62,0.0,162.0,           ,1.0,1.0,51.0
10679,Lemmikit,2020-04-15 15:13:10.243902430,2020-04-15,2020-04-15,2020-04-15,11.0,-19.7,15383.92,0.0,162.0,           ,1.0,1.0,66.0
10680,Tulot,2020-04-17 02:20:29.268292673,2020-04-17,2020-04-17,2020-04-15,11.0,6.15,15390.07,710.0,506.0,           ,1.0,1.0,155.0
10681,Terveys,2020-04-20 00:35:07.317073159,2020-04-20,2020-04-20,2020-04-20,11.0,-31.61,15358.46,0.0,162.0,           ,1.0,1.0,57.0
10682,Ruoka_paivittaistavarakauppa,2020-04-20 11:42:26.341463402,2020-04-20,2020-04-20,2020-04-20,11.0,-84.11,15274.35,0.0,162.0,           ,1.0,1.0,42.0
10683,Terveys,2020-04-20 13:27:48.292682916,2020-04-20,2020-04-20,2020-04-20,11.0,781.29,16055.64,0.0,500.0,OKOYFIHH   ,1.0,0.0,131.0
10684,Ruoka_paivittaistavarakauppa,2020-04-20 22:49:45.365853645,2020-04-20,2020-04-20,2020-04-20,11.0,-11.89,16043.75,0.0,162.0,           ,1.0,1.0,123.0
10685,Hyvinvointijakauneus,2020-04-24 09:57:04.390243888,2020-04-24,2020-04-24,2020-04-24,11.0,-84.95,15958.8,0.0,162.0,           ,1.0,1.0,40.0
10686,Tulot,2020-04-24 19:19:01.463414617,2020-04-24,2020-04-24,2020-04-24,11.0,202.88,16161.68,701.0,522.0,           ,1.0,1.0,145.0
10687,Tulot,2020-04-25 21:04:23.414634131,2020-04-25,2020-04-25,2020-04-25,11.0,3020.39,19182.07,0.0,505.0,           ,1.0,1.0,132.0
10688,Muut,2020-04-27 08:11:42.439024374,2020-04-27,2020-04-27,2020-04-27,11.0,-12.07,19170.0,0.0,162.0,           ,1.0,1.0,52.0
10689,Ruoka_paivittaistavarakauppa,2020-04-30 06:26:20.487804860,2020-04-30,2020-04-30,2020-04-30,11.0,-44.62,19125.38,0.0,162.0,           ,1.0,1.0,70.0
10690,Liikkuminen,2020-05-04 09:23:28.695652172,2020-05-04,2020-05-04,2020-05-04,11.0,-8.83,19116.55,0.0,162.0,           ,1.0,1.0,33.0
10691,Luottojen_maksut,2020-05-04 16:41:44.347826086,2020-05-04,2020-05-04,2020-05-04,11.0,-29.99,19086.56,0.0,162.0,           ,1.0,1.0,53.0
10692,Ruoka_paivittaistavarakauppa,2020-05-08 02:05:13.043478258,2020-05-08,2020-05-08,2020-05-08,11.0,-7.29,19079.27,0.0,162.0,           ,1.0,1.0,68.0
10693,Ruoka_paivittaistavarakauppa,2020-05-11 18:46:57.391304344,2020-05-11,2020-05-12,2020-05-11,11.0,-47.67,19031.6,0.0,162.0,           ,1.0,1.0,39.0
10694,Muut,2020-05-14 11:28:41.739130430,2020-05-14,2020-05-14,2020-05-14,11.0,-9.44,19022.16,0.0,162.0,           ,1.0,1.0,97.0
10695,Liikkuminen,2020-05-18 04:10:26.086956516,2020-05-18,2020-05-18,2020-05-18,11.0,-44.08,18978.08,0.0,162.0,           ,1.0,1.0,31.0
10696,Liikkuminen,2020-05-19 20:52:10.434782602,2020-05-19,2020-05-19,2020-05-19,11.0,-6.02,18972.06,0.0,162.0,           ,1.0,1.0,84.0
10697,Kulttuuri_viihde,2020-05-21 13:33:54.782608688,2020-05-21,2020-05-21,2020-05-21,11.0,-135.92,18836.14,0.0,162.0,           ,1.0,1.0,94.0
10698,Tulot,2020-05-25 06:15:39.130434774,2020-05-25,2020-05-25,2020-05-25,11.0,1304.12,20140.26,710.0,506.0,           ,1.0,1.0,155.0
10699,Luokittelemattomat,2020-05-27 22:57:23.478260860,2020-05-27,2020-05-27,2020-05-27,11.0,-8.23,20132.03,0.0,162.0,           ,1.0,1.0,58.0
10700,Tulot,2020-05-30 15:39:07.826086946,2020-05-30,2020-05-30,2020-05-30,11.0,4453.3,24585.33,0.0,505.0,           ,1.0,1.0,132.0
10701,Ruoka_paivittaistavarakauppa,2020-06-03 05:20:00.000000000,2020-06-03,2020-06-03,2020-06-03,11.0,-32.29,24553.04,0.0,162.0,           ,1.0,1.0,54.0
10702,Terveys,2020-06-05 10:40:00.000000000,2020-06-05,2020-06-05,2020-06-05,11.0,-44.69,24508.35,0.0,162.0,           ,1.0,1.0,78.0
10703,Liikkuminen,2020-06-08 16:00:00.000000000,2020-06-08,2020-06-08,2020-06-08,11.0,-129.54,24378.81,0.0,162.0,           ,1.0,1.0,111.0
10704,Asuminen,2020-06-09 21:20:00.000000000,2020-06-09,2020-06-09,2020-06-09,11.0,-7.05,24371.76,0.0,162.0,           ,1.0,1.0,59.0
10705,Luokittelemattomat,2020-06-12 02:40:00.000000000,2020-06-12,2020-06-12,2020-06-12,11.0,-118.97,24252.79,0.0,162.0,           ,1.0,1.0,87.0
10706,Tulot,2020-06-14 08:00:00.000000000,2020-06-14,2020-06-14,2020-06-14,11.0,511.83,24764.62,0.0,506.0,           ,1.0,1.0,138.0
10707,Luokittelemattomat,2020-06-16 13:20:00.000000000,2020-06-16,2020-06-18,2020-06-16,11.0,-24.45,24740.17,0.0,162.0,           ,1.0,1.0,71.0
10708,Ravintolat_kahvilat,2020-06-18 18:40:00.000000000,2020-06-18,2020-06-18,2020-06-18,11.0,-54.81,24685.36,0.0,162.0,           ,1.0,1.0,72.0
10709,Ravintolat_kahvilat,2020-06-22 00:00:00.000000000,2020-06-22,2020-06-22,2020-06-22,11.0,-30.86,24654.5,0.0,162.0,           ,1.0,1.0,15.0
10710,Saastot_sijoitukset,2020-06-23 05:20:00.000000000,2020-06-23,2020-06-23,2020-06-23,11.0,-36.85,24617.65,0.0,162.0,           ,1.0,1.0,57.0
10711,Ruoka_paivittaistavarakauppa,2020-06-25 10:40:00.000000000,2020-06-25,2020-06-25,2020-06-25,11.0,-4.29,24613.36,0.0,162.0,           ,1.0,1.0,44.0
10712,Tulot,2020-06-26 16:00:00.000000000,2020-06-26,2020-06-26,2020-06-26,11.0,11.41,24624.77,710.0,506.0,           ,1.0,1.0,161.0
10713,Ruoka_paivittaistavarakauppa,2020-06-29 21:20:00.000000000,2020-06-29,2020-06-29,2020-06-29,11.0,-18.2,24606.57,0.0,162.0,           ,1.0,1.0,62.0
10714,Ruoka_paivittaistavarakauppa,2020-07-02 01:13:13.220338983,2020-07-02,2020-07-02,2020-07-01,11.0,-55.56,24551.01,0.0,162.0,           ,1.0,1.0,16.0
10715,Luokittelemattomat,2020-07-02 03:39:39.661016949,2020-07-02,2020-07-02,2020-07-02,11.0,-15.49,24535.52,0.0,162.0,           ,1.0,1.0,46.0
10716,Tulot,2020-07-03 02:26:26.440677966,2020-07-03,2020-07-03,2020-07-03,11.0,11.88,24547.4,0.0,505.0,           ,1.0,1.0,135.0
10717,Tulot,2020-07-06 06:06:06.101694915,2020-07-06,2020-07-06,2020-07-06,11.0,-20.53,24526.87,0.0,162.0,           ,1.0,1.0,85.0
10718,Asuminen,2020-07-07 04:52:52.881355932,2020-07-07,2020-07-07,2020-07-07,11.0,-242.91,24283.96,0.0,162.0,           ,1.0,1.0,29.0
10719,Ruoka_paivittaistavarakauppa,2020-07-07 07:19:19.322033898,2020-07-07,2020-07-07,2020-07-07,11.0,-4.89,24279.07,0.0,162.0,           ,1.0,1.0,91.0
10720,Tulot,2020-07-08 08:32:32.542372881,2020-07-08,2020-07-08,2020-07-08,11.0,1279.41,25558.48,0.0,505.0,           ,1.0,1.0,136.0
10721,Liikkuminen,2020-07-08 10:58:58.983050847,2020-07-08,2020-07-08,2020-07-08,11.0,-171.55,25386.93,0.0,162.0,           ,1.0,1.0,43.0
10722,Muut,2020-07-09 09:45:45.762711864,2020-07-09,2020-07-09,2020-07-09,11.0,-44.63,25342.3,0.0,162.0,           ,1.0,1.0,86.0
10723,Liikkuminen,2020-07-10 12:12:12.203389830,2020-07-10,2020-07-10,2020-07-10,11.0,-13.32,25328.98,0.0,162.0,           ,1.0,1.0,16.0
10724,Ruoka_paivittaistavarakauppa,2020-07-13 13:25:25.423728813,2020-07-13,2020-07-13,2020-07-13,11.0,-9.56,25319.42,0.0,162.0,           ,1.0,1.0,47.0
10725,Matkailu,2020-07-13 14:38:38.644067796,2020-07-13,2020-07-13,2020-07-13,11.0,-57.61,25261.81,0.0,162.0,           ,1.0,1.0,48.0
10726,Ruoka_paivittaistavarakauppa,2020-07-13 18:18:18.305084745,2020-07-13,2020-07-13,2020-07-13,11.0,-59.13,25202.68,0.0,162.0,           ,1.0,1.0,60.0
10727,Liikkuminen,2020-07-14 15:51:51.864406779,2020-07-14,2020-07-14,2020-07-14,11.0,-22.16,25180.52,0.0,162.0,           ,1.0,1.0,51.0
10728,Asuminen,2020-07-14 17:05:05.084745762,2020-07-14,2020-07-14,2020-07-14,11.0,-271.92,24908.6,0.0,162.0,           ,1.0,1.0,71.0
10729,Luottojen_maksut,2020-07-17 19:31:31.525423728,2020-07-17,2020-07-17,2020-07-17,11.0,-7.05,24901.55,0.0,162.0,           ,1.0,1.0,15.0
10730,Tulot,2020-07-17 20:44:44.745762711,2020-07-17,2020-07-17,2020-07-17,11.0,155.54,25057.09,0.0,505.0,           ,1.0,1.0,132.0
10731,Terveys,2020-07-20 00:24:24.406779660,2020-07-20,2020-07-20,2020-07-20,11.0,-37.42,25019.67,0.0,162.0,           ,1.0,1.0,54.0
10732,Muut,2020-07-20 23:11:11.186440677,2020-07-20,2020-07-20,2020-07-20,11.0,-520.12,24499.55,0.0,162.0,           ,1.0,1.0,16.0
10733,Ruoka_paivittaistavarakauppa,2020-07-21 21:57:57.966101694,2020-07-21,2020-07-21,2020-07-21,11.0,-53.38,24446.17,0.0,162.0,           ,1.0,1.0,16.0
10734,Ruoka_paivittaistavarakauppa,2020-07-22 01:37:37.627118643,2020-07-22,2020-07-22,2020-07-22,11.0,-2.81,24443.36,0.0,162.0,           ,1.0,1.0,64.0
10735,Liikkuminen,2020-07-24 02:50:50.847457626,2020-07-24,2020-07-24,2020-07-24,11.0,-27.02,24416.34,0.0,162.0,           ,1.0,1.0,69.0
10736,Ruoka_paivittaistavarakauppa,2020-07-27 04:04:04.067796609,2020-07-27,2020-07-27,2020-07-27,11.0,-15.11,24401.23,0.0,162.0,           ,1.0,1.0,120.0
10737,Liikkuminen,2020-07-27 05:17:17.288135592,2020-07-27,2020-07-27,2020-07-27,11.0,-67.54,24333.69,0.0,162.0,           ,1.0,1.0,16.0
10738,Tulot,2020-07-27 06:30:30.508474575,2020-07-27,2020-07-27,2020-07-27,11.0,834.57,25168.26,0.0,505.0,           ,1.0,1.0,136.0
10739,Liikkuminen,2020-07-27 08:56:56.949152541,2020-07-27,2020-07-27,2020-07-27,11.0,-104.99,25063.27,0.0,162.0,           ,1.0,1.0,92.0
10740,Ruoka_paivittaistavarakauppa,2020-07-29 07:43:43.728813558,2020-07-29,2020-07-31,2020-07-29,11.0,-11.53,25051.74,0.0,162.0,           ,1.0,1.0,120.0
10741,Ravintolat_kahvilat,2020-07-30 10:10:10.169491524,2020-07-30,2020-07-30,2020-07-30,11.0,-46.22,25005.52,0.0,162.0,           ,1.0,1.0,21.0
10742,Ravintolat_kahvilat,2020-07-30 11:23:23.389830507,2020-07-30,2020-07-30,2020-07-30,11.0,-22.53,24982.99,0.0,162.0,           ,1.0,1.0,100.0
10743,Liikkuminen,2020-08-04 03:12:00.000000000,2020-08-04,2020-08-04,2020-08-04,11.0,-8.86,24974.13,0.0,162.0,           ,1.0,1.0,55.0
10744,Tulot,2020-08-10 06:24:00.000000000,2020-08-10,2020-08-10,2020-08-10,11.0,425.74,25399.87,0.0,505.0,           ,1.0,1.0,132.0
10745,Hyvinvointijakauneus,2020-08-13 09:36:00.000000000,2020-08-13,2020-08-13,2020-08-13,11.0,-7.84,25392.03,0.0,162.0,           ,1.0,1.0,80.0
10746,Ruoka_paivittaistavarakauppa,2020-08-17 12:48:00.000000000,2020-08-17,2020-08-17,2020-08-17,11.0,-50.53,25341.5,0.0,162.0,           ,1.0,1.0,17.0
10747,Ravintolat_kahvilat,2020-08-21 16:00:00.000000000,2020-08-21,2020-08-21,2020-08-21,11.0,-13.93,25327.57,0.0,162.0,           ,1.0,1.0,30.0
10748,Ravintolat_kahvilat,2020-08-24 19:12:00.000000000,2020-08-24,2020-08-24,2020-08-24,11.0,-1.93,25325.64,0.0,162.0,           ,1.0,1.0,16.0
10749,Ruoka_paivittaistavarakauppa,2020-08-28 22:24:00.000000000,2020-08-28,2020-08-28,2020-08-28,11.0,-5.36,25320.28,0.0,162.0,           ,1.0,1.0,78.0
10750,Liikkuminen,2020-09-01 04:07:33.868194842,2020-09-01,2020-09-01,2020-09-01,11.0,-29.9,25290.38,0.0,162.0,           ,1.0,1.0,101.0
10751,Muut,2020-09-01 08:15:07.736389684,2020-09-01,2020-09-01,2020-09-01,11.0,-4.09,25286.29,0.0,162.0,           ,1.0,1.0,17.0
10752,Saastot_sijoitukset,2020-09-01 16:30:15.472779368,2020-09-01,2020-09-01,2020-09-01,11.0,470.03,25756.32,0.0,505.0,           ,1.0,1.0,132.0
10753,Ravintolat_kahvilat,2020-09-02 00:45:23.209169052,2020-09-02,2020-09-02,2020-09-01,11.0,-91.38,25664.94,0.0,162.0,           ,1.0,1.0,42.0
10754,Ruoka_paivittaistavarakauppa,2020-09-02 04:52:57.077363894,2020-09-02,2020-09-02,2020-09-02,11.0,-17.25,25647.69,0.0,162.0,           ,1.0,1.0,52.0
10755,Luottojen_maksut,2020-09-02 09:00:30.945558736,2020-09-02,2020-09-02,2020-09-02,11.0,-3.08,25644.61,0.0,162.0,           ,1.0,1.0,43.0
10756,Shoppailu,2020-09-02 12:22:41.604584526,2020-09-02,2020-09-02,2020-09-02,11.0,-16.65,25627.96,0.0,162.0,           ,1.0,1.0,82.0
10757,Ravintolat_kahvilat,2020-09-02 13:08:04.813753578,2020-09-02,2020-09-02,2020-09-02,11.0,-33.94,25594.02,0.0,162.0,           ,1.0,1.0,85.0
10758,Tulot,2020-09-02 17:15:38.681948420,2020-09-02,2020-09-02,2020-09-02,11.0,997.5,26591.52,0.0,505.0,           ,1.0,1.0,132.0
10759,Liikkuminen,2020-09-02 20:37:49.340974210,2020-09-02,2020-09-02,2020-09-02,11.0,-67.52,26524.0,0.0,162.0,           ,1.0,1.0,38.0
10760,Muut,2020-09-02 21:23:12.550143262,2020-09-02,2020-09-02,2020-09-02,11.0,-210.68,26313.32,0.0,163.0,           ,1.0,1.0,126.0
10761,Ruoka_paivittaistavarakauppa,2020-09-03 01:30:46.418338104,2020-09-03,2020-09-03,2020-09-03,11.0,-40.28,26273.04,0.0,162.0,           ,1.0,1.0,24.0
10762,Ruoka_paivittaistavarakauppa,2020-09-03 05:38:20.286532946,2020-09-03,2020-09-03,2020-09-03,11.0,-29.43,26243.61,0.0,162.0,           ,1.0,1.0,30.0
10763,Harrastukset,2020-09-03 09:45:54.154727788,2020-09-03,2020-09-03,2020-09-03,11.0,-105.01,26138.6,0.0,162.0,           ,1.0,1.0,16.0
10764,Liikkuminen,2020-09-03 13:53:28.022922630,2020-09-03,2020-09-03,2020-09-03,11.0,-12.76,26125.84,0.0,162.0,           ,1.0,1.0,50.0
10765,Asuminen,2020-09-03 18:01:01.891117472,2020-09-03,2020-09-03,2020-09-03,11.0,-2274.65,23851.19,0.0,162.0,           ,1.0,1.0,73.0
10766,Ruoka_paivittaistavarakauppa,2020-09-03 19:31:48.309455576,2020-09-03,2020-09-03,2020-09-03,11.0,-63.75,23787.44,0.0,162.0,           ,1.0,1.0,74.0
10767,Tulot,2020-09-03 22:08:35.759312314,2020-09-03,2020-09-03,2020-09-03,11.0,1528.98,25316.42,0.0,505.0,           ,1.0,1.0,137.0
10768,Muut,2020-09-04 02:16:09.627507156,2020-09-04,2020-09-04,2020-09-04,11.0,-17.79,25298.63,0.0,162.0,           ,1.0,1.0,33.0
10769,Tulot,2020-09-04 03:01:32.836676208,2020-09-04,2020-09-04,2020-09-04,11.0,215.59,25514.22,0.0,505.0,           ,1.0,1.0,133.0
10770,Tulot,2020-09-04 06:23:43.495701998,2020-09-04,2020-09-04,2020-09-04,11.0,902.06,26416.28,0.0,505.0,           ,1.0,1.0,135.0
10771,Ravintolat_kahvilat,2020-09-04 07:09:06.704871050,2020-09-04,2020-09-04,2020-09-04,11.0,-0.95,26415.33,0.0,162.0,           ,1.0,1.0,79.0
10772,Ruoka_paivittaistavarakauppa,2020-09-04 10:31:17.363896840,2020-09-04,2020-09-04,2020-09-04,11.0,-53.79,26361.54,0.0,162.0,           ,1.0,1.0,67.0
10773,Ruoka_paivittaistavarakauppa,2020-09-04 11:16:40.573065892,2020-09-04,2020-09-04,2020-09-04,11.0,-26.33,26335.21,0.0,162.0,           ,1.0,1.0,75.0
10774,Ruoka_paivittaistavarakauppa,2020-09-04 14:38:51.232091682,2020-09-04,2020-09-04,2020-09-04,11.0,-5.46,26329.75,0.0,162.0,           ,1.0,1.0,91.0
10775,Ravintolat_kahvilat,2020-09-04 15:24:14.441260734,2020-09-04,2020-09-04,2020-09-04,11.0,-68.86,26260.89,0.0,162.0,           ,1.0,1.0,58.0
10776,Liikkuminen,2020-09-04 18:46:25.100286524,2020-09-04,2020-09-04,2020-09-04,11.0,-62.08,26198.81,0.0,162.0,           ,1.0,1.0,68.0
10777,Ruoka_paivittaistavarakauppa,2020-09-04 22:53:58.968481366,2020-09-04,2020-09-04,2020-09-04,11.0,-7.44,26191.37,0.0,162.0,           ,1.0,1.0,112.0
10778,Tulot,2020-09-06 20:17:11.518624628,2020-09-06,2020-09-06,2020-09-06,11.0,506.77,26698.14,0.0,505.0,           ,1.0,1.0,133.0
10779,Ruoka_paivittaistavarakauppa,2020-09-07 00:24:45.386819470,2020-09-07,2020-09-07,2020-09-07,11.0,-26.2,26671.94,0.0,162.0,           ,1.0,1.0,93.0
10780,Asuminen,2020-09-07 03:46:56.045845260,2020-09-07,2020-09-07,2020-09-04,11.0,-181.26,26490.68,0.0,162.0,           ,1.0,1.0,122.0
10781,Tulot,2020-09-07 04:32:19.255014312,2020-09-07,2020-09-07,2020-09-07,11.0,505.66,26996.34,710.0,588.0,           ,0.0,1.0,162.0
10782,Matkailu,2020-09-07 07:54:29.914040102,2020-09-07,2020-09-07,2020-09-07,11.0,-145.52,26850.82,0.0,162.0,           ,1.0,1.0,30.0
10783,Terveys,2020-09-07 08:39:53.123209154,2020-09-07,2020-09-07,2020-09-07,11.0,-77.12,26773.7,0.0,162.0,           ,1.0,1.0,104.0
10784,Ruoka_paivittaistavarakauppa,2020-09-07 12:02:03.782234944,2020-09-07,2020-09-07,2020-09-07,11.0,-160.02,26613.68,0.0,162.0,           ,1.0,1.0,87.0
10785,Liikkuminen,2020-09-07 12:47:26.991403996,2020-09-07,2020-09-07,2020-09-07,11.0,-15.1,26598.58,0.0,162.0,           ,1.0,1.0,46.0
10786,Shoppailu,2020-09-07 13:32:50.200573048,2020-09-07,2020-09-07,2020-09-07,11.0,-7.06,26591.52,706.0,129.0,OKOYFIHH   ,0.0,0.0,153.0
10787,Muut,2020-09-07 16:09:37.650429786,2020-09-07,2020-09-07,2020-09-07,11.0,-24.38,26567.14,0.0,162.0,           ,1.0,1.0,52.0
10788,Luottojen_maksut,2020-09-07 16:55:00.859598838,2020-09-07,2020-09-07,2020-09-07,11.0,-20.7,26546.44,0.0,162.0,           ,1.0,1.0,70.0
10789,Luokittelemattomat,2020-09-07 17:40:24.068767890,2020-09-07,2020-09-07,2020-09-07,11.0,-47.26,26499.18,0.0,106.0,OKOYFIHH   ,0.0,0.0,11.0
10790,Liikkuminen,2020-09-07 21:02:34.727793680,2020-09-07,2020-09-07,2020-09-07,11.0,-177.79,26321.39,0.0,162.0,           ,1.0,1.0,118.0
10791,Ruoka_paivittaistavarakauppa,2020-09-07 23:39:22.177650418,2020-09-07,2020-09-07,2020-09-07,11.0,-3.88,26317.51,0.0,162.0,           ,1.0,1.0,21.0
10792,Ravintolat_kahvilat,2020-09-08 01:10:08.595988522,2020-09-08,2020-09-08,2020-09-08,11.0,-85.26,26232.25,0.0,162.0,           ,1.0,1.0,67.0
10793,Ruoka_paivittaistavarakauppa,2020-09-08 05:17:42.464183364,2020-09-08,2020-09-08,2020-09-08,11.0,-14.82,26217.43,0.0,162.0,           ,1.0,1.0,39.0
10794,Ravintolat_kahvilat,2020-09-08 09:25:16.332378206,2020-09-08,2020-09-08,2020-09-08,11.0,-10.27,26207.16,0.0,162.0,           ,1.0,1.0,118.0
10795,Ruoka_paivittaistavarakauppa,2020-09-08 22:33:21.146131784,2020-09-08,2020-09-08,2020-09-08,11.0,-11.17,26195.99,0.0,162.0,           ,1.0,1.0,58.0
10796,Ruoka_paivittaistavarakauppa,2020-09-09 01:55:31.805157574,2020-09-09,2020-09-09,2020-09-09,11.0,-23.47,26172.52,0.0,162.0,           ,1.0,1.0,38.0
10797,Ruoka_paivittaistavarakauppa,2020-09-09 14:18:13.409742100,2020-09-09,2020-09-09,2020-09-09,11.0,-118.31,26054.21,0.0,162.0,           ,1.0,1.0,53.0
10798,Muut,2020-09-09 20:41:56.905444098,2020-09-09,2020-09-09,2020-09-09,11.0,-9.64,26044.57,0.0,162.0,           ,1.0,1.0,107.0
10799,Muut,2020-09-09 21:47:57.936962732,2020-09-09,2020-09-09,2020-09-09,11.0,-213.64,25830.93,0.0,163.0,           ,1.0,1.0,128.0
10800,Ruoka_paivittaistavarakauppa,2020-09-10 02:40:55.014326626,2020-09-10,2020-09-10,2020-09-10,11.0,-88.09,25742.84,0.0,162.0,           ,1.0,1.0,52.0
10801,Ravintolat_kahvilat,2020-09-10 06:48:28.882521468,2020-09-10,2020-09-11,2020-09-10,11.0,-12.42,25730.42,0.0,162.0,           ,1.0,1.0,33.0
10802,Ruoka_paivittaistavarakauppa,2020-09-10 10:10:39.541547258,2020-09-10,2020-09-10,2020-09-10,11.0,-6.36,25724.06,0.0,162.0,           ,1.0,1.0,70.0
10803,Ruoka_paivittaistavarakauppa,2020-09-10 15:03:36.618911152,2020-09-10,2020-09-10,2020-09-10,11.0,-11.45,25712.61,0.0,162.0,           ,1.0,1.0,84.0
10804,Kulttuuri_viihde,2020-09-10 18:25:47.277936942,2020-09-10,2020-09-10,2020-09-10,11.0,-13.72,25698.89,0.0,162.0,           ,1.0,1.0,91.0
10805,Muut,2020-09-10 19:56:33.696275046,2020-09-10,2020-09-11,2020-09-09,11.0,-80.6,25618.29,0.0,106.0,OKOYFIHH   ,0.0,0.0,5.0
10806,Tulot,2020-09-10 23:18:44.355300836,2020-09-10,2020-09-10,2020-09-10,11.0,789.7,26407.99,0.0,505.0,           ,1.0,1.0,133.0
10807,Ruoka_paivittaistavarakauppa,2020-09-11 03:26:18.223495678,2020-09-11,2020-09-11,2020-09-11,11.0,-70.91,26337.08,0.0,162.0,           ,1.0,1.0,36.0
10808,Ruoka_paivittaistavarakauppa,2020-09-11 06:03:05.673352416,2020-09-11,2020-09-11,2020-09-11,11.0,-82.62,26254.46,0.0,162.0,           ,1.0,1.0,56.0
10809,Liikkuminen,2020-09-11 07:33:52.091690520,2020-09-11,2020-09-11,2020-09-11,11.0,-34.47,26219.99,0.0,162.0,           ,1.0,1.0,30.0
10810,Liikkuminen,2020-09-11 10:56:02.750716310,2020-09-11,2020-09-11,2020-09-11,11.0,-15.8,26204.19,0.0,162.0,           ,1.0,1.0,82.0
10811,Ravintolat_kahvilat,2020-09-11 11:41:25.959885362,2020-09-11,2020-09-11,2020-09-11,11.0,-5.66,26198.53,0.0,162.0,           ,1.0,1.0,93.0
10812,Ruoka_paivittaistavarakauppa,2020-09-11 12:26:49.169054414,2020-09-11,2020-09-11,2020-09-11,11.0,-23.74,26174.79,0.0,162.0,           ,1.0,1.0,87.0
10813,Ruoka_paivittaistavarakauppa,2020-09-11 13:12:12.378223466,2020-09-11,2020-09-11,2020-09-11,11.0,-3.73,26171.06,0.0,162.0,           ,1.0,1.0,60.0
10814,Ruoka_paivittaistavarakauppa,2020-09-11 15:48:59.828080204,2020-09-11,2020-09-11,2020-09-11,11.0,-8.06,26163.0,0.0,162.0,           ,1.0,1.0,53.0
10815,Lemmikit,2020-09-11 16:34:23.037249256,2020-09-11,2020-09-11,2020-09-11,11.0,-10.37,26152.63,0.0,162.0,           ,1.0,1.0,109.0
10816,Liikkuminen,2020-09-11 19:11:10.487105994,2020-09-11,2020-09-11,2020-09-11,11.0,-111.85,26040.78,0.0,162.0,           ,1.0,1.0,87.0
10817,Matkailu,2020-09-12 00:04:07.564469888,2020-09-12,2020-09-12,2020-09-12,11.0,-2010.74,24030.04,0.0,106.0,OKOYFIHH   ,0.0,0.0,7.0
10818,Luokittelemattomat,2020-09-13 04:11:41.432664730,2020-09-13,2020-09-13,2020-09-13,11.0,-107.87,23922.17,0.0,106.0,OKOYFIHH   ,0.0,0.0,4.0
10819,Liikkuminen,2020-09-13 08:19:15.300859572,2020-09-13,2020-09-13,2020-09-13,11.0,-1120.89,22801.28,0.0,106.0,NDEAFIHH   ,1.0,0.0,12.0
10820,Ravintolat_kahvilat,2020-09-14 00:49:30.773638940,2020-09-14,2020-09-14,2020-09-14,11.0,-4.75,22796.53,0.0,162.0,           ,1.0,1.0,98.0
10821,Asuminen,2020-09-14 01:34:53.982807992,2020-09-14,2020-09-14,2020-09-14,11.0,-22.79,22773.74,0.0,162.0,           ,1.0,1.0,55.0
10822,Lemmikit,2020-09-14 04:57:04.641833782,2020-09-14,2020-09-14,2020-09-14,11.0,-8.6,22765.14,0.0,162.0,           ,1.0,1.0,82.0
10823,Asuminen,2020-09-14 05:42:27.851002834,2020-09-14,2020-09-14,2020-09-14,11.0,-9.04,22756.1,0.0,162.0,           ,1.0,1.0,90.0
10824,Terveys,2020-09-14 09:04:38.510028624,2020-09-14,2020-09-16,2020-09-14,11.0,-48.34,22707.76,0.0,162.0,           ,1.0,1.0,39.0
10825,Ruoka_paivittaistavarakauppa,2020-09-14 09:50:01.719197676,2020-09-14,2020-09-14,2020-09-14,11.0,-14.35,22693.41,0.0,162.0,           ,1.0,1.0,83.0
10826,Asuminen,2020-09-14 13:57:35.587392518,2020-09-14,2020-09-14,2020-09-14,11.0,-95.86,22597.55,706.0,129.0,NDEAFIHH   ,0.0,0.0,152.0
10827,Hyvinvointi,2020-09-14 14:42:58.796561570,2020-09-14,2020-09-14,2020-09-14,11.0,-6.52,22591.03,0.0,162.0,           ,1.0,1.0,66.0
10828,Liikkuminen,2020-09-14 17:19:46.246418308,2020-09-14,2020-09-14,2020-09-14,11.0,-170.38,22420.65,0.0,162.0,           ,1.0,1.0,67.0
10829,Liikkuminen,2020-09-14 18:05:09.455587360,2020-09-14,2020-09-15,2020-09-14,11.0,-28.13,22392.52,0.0,162.0,           ,1.0,1.0,74.0
10830,Saastot_sijoitukset,2020-09-14 21:27:20.114613150,2020-09-14,2020-09-14,2020-09-14,11.0,-54.35,22338.17,0.0,162.0,           ,1.0,1.0,86.0
10831,Ravintolat_kahvilat,2020-09-14 22:12:43.323782202,2020-09-14,2020-09-14,2020-09-14,11.0,-9.88,22328.29,0.0,162.0,           ,1.0,1.0,116.0
